county,precinct,office,district,party,candidate,mail,early_voting,election_day,votes
Waller,101,President,,DEM,Michael Bennet,0,2,0,2
Waller,101,President,,DEM,Marianne Williamson,0,0,0,0
Waller,101,President,,DEM,Cory Booker,0,0,0,0
Waller,101,President,,DEM,Bernie Sanders,2,8,22,32
Waller,101,President,,DEM,Tulsi Gabbard,0,0,1,1
Waller,101,President,,DEM,Deval Patrick,0,0,0,0
Waller,101,President,,DEM,Amy Klobuchar,1,2,0,3
Waller,101,President,,DEM,Julián Castro,0,0,2,2
Waller,101,President,,DEM,Elizabeth Warren,0,3,3,6
Waller,101,President,,DEM,John K. Delaney,0,0,1,1
Waller,101,President,,DEM,Robby Wells,0,0,0,0
Waller,101,President,,DEM,"Roque ""Rocky"" De La Fuente",0,0,0,0
Waller,101,President,,DEM,Andrew Yang,0,0,0,0
Waller,101,President,,DEM,Joseph R. Biden,4,12,37,53
Waller,101,President,,DEM,Michael R. Bloomberg,3,6,5,14
Waller,101,President,,DEM,Tom Steyer,0,1,0,1
Waller,101,President,,DEM,Pete Buttigieg,1,1,0,2
Waller,101,President,,DEM,Ballots Cast,11,35,71,117
Waller,101,President,,DEM,Under Votes,0,1,3,4
Waller,101,President,,DEM,Over Votes,1,0,0,1
Waller,101,U.S. Senate,,DEM,Royce West,0,7,5,12
Waller,101,U.S. Senate,,DEM,"Annie ""Mamá"" Garcia",3,4,9,16
Waller,101,U.S. Senate,,DEM,D. R. Hunter,0,1,0,1
Waller,101,U.S. Senate,,DEM,Sema Hernandez,0,0,8,8
Waller,101,U.S. Senate,,DEM,Adrian Ocegueda,0,2,1,3
Waller,101,U.S. Senate,,DEM,Chris Bell,2,7,19,28
Waller,101,U.S. Senate,,DEM,Cristina Tzintzun Ramirez,2,1,4,7
Waller,101,U.S. Senate,,DEM,Jack Daniel Foster Jr,0,0,1,1
Waller,101,U.S. Senate,,DEM,Amanda K. Edwards,3,1,2,6
Waller,101,U.S. Senate,,DEM,Victor Hugo Harris,0,0,0,0
Waller,101,U.S. Senate,,DEM,"Mary ""MJ"" Hegar",2,8,5,15
Waller,101,U.S. Senate,,DEM,Michael Cooper,0,2,1,3
Waller,101,U.S. Senate,,DEM,Ballots Cast,12,33,55,100
Waller,101,U.S. Senate,,DEM,Under Votes,0,3,19,22
Waller,101,U.S. Senate,,DEM,Over Votes,0,0,0,0
Waller,101,U.S. House,10,DEM,Mike Siegel,3,16,32,51
Waller,101,U.S. House,10,DEM,Shannon Hutcheson,4,8,17,29
Waller,101,U.S. House,10,DEM,Pritesh Gandhi,5,10,11,26
Waller,101,U.S. House,10,DEM,Ballots Cast,12,34,60,106
Waller,101,U.S. House,10,DEM,Under Votes,0,2,14,16
Waller,101,U.S. House,10,DEM,Over Votes,0,0,0,0
Waller,101,Railroad Commissioner,,DEM,"Roberto R. ""Beto"" Alonzo",1,9,21,31
Waller,101,Railroad Commissioner,,DEM,Chrysta Castañeda,4,11,8,23
Waller,101,Railroad Commissioner,,DEM,Mark Watson,5,9,7,21
Waller,101,Railroad Commissioner,,DEM,Kelly Stone,1,6,18,25
Waller,101,Railroad Commissioner,,DEM,Ballots Cast,11,35,54,100
Waller,101,Railroad Commissioner,,DEM,Under Votes,1,1,20,22
Waller,101,Railroad Commissioner,,DEM,Over Votes,0,0,0,0
Waller,101,"Chief Justice, Supreme Court",,DEM,Jerry Zimmerer,3,10,17,30
Waller,101,"Chief Justice, Supreme Court",,DEM,Amy Clark Meachum,9,23,37,69
Waller,101,"Chief Justice, Supreme Court",,DEM,Ballots Cast,12,33,54,99
Waller,101,"Chief Justice, Supreme Court",,DEM,Under Votes,0,3,20,23
Waller,101,"Chief Justice, Supreme Court",,DEM,Over Votes,0,0,0,0
Waller,101,"Justice, Supreme Court, Place 6 Unexpired Term",,DEM,Kathy Cheng,8,22,37,67
Waller,101,"Justice, Supreme Court, Place 6 Unexpired Term",,DEM,Larry Praeger,4,10,17,31
Waller,101,"Justice, Supreme Court, Place 6 Unexpired Term",,DEM,Ballots Cast,12,32,54,98
Waller,101,"Justice, Supreme Court, Place 6 Unexpired Term",,DEM,Under Votes,0,4,20,24
Waller,101,"Justice, Supreme Court, Place 6 Unexpired Term",,DEM,Over Votes,0,0,0,0
Waller,101,"Justice, Supreme Court, Place 7",,DEM,Staci Williams,8,23,39,70
Waller,101,"Justice, Supreme Court, Place 7",,DEM,Brandy Voss,4,6,15,25
Waller,101,"Justice, Supreme Court, Place 7",,DEM,Ballots Cast,12,29,54,95
Waller,101,"Justice, Supreme Court, Place 7",,DEM,Under Votes,0,7,20,27
Waller,101,"Justice, Supreme Court, Place 7",,DEM,Over Votes,0,0,0,0
Waller,101,"Justice, Supreme Court, Place 8",,DEM,Gisela D. Triana,5,19,37,61
Waller,101,"Justice, Supreme Court, Place 8",,DEM,Peter Kelly,7,10,16,33
Waller,101,"Justice, Supreme Court, Place 8",,DEM,Ballots Cast,12,29,53,94
Waller,101,"Justice, Supreme Court, Place 8",,DEM,Under Votes,0,7,21,28
Waller,101,"Justice, Supreme Court, Place 8",,DEM,Over Votes,0,0,0,0
Waller,101,"Judge, Court of Criminal Appeals, Place 3",,DEM,Elizabeth Davis Frizell,9,21,39,69
Waller,101,"Judge, Court of Criminal Appeals, Place 3",,DEM,William Pieratt Demond,0,3,4,7
Waller,101,"Judge, Court of Criminal Appeals, Place 3",,DEM,Dan Wood,3,8,10,21
Waller,101,"Judge, Court of Criminal Appeals, Place 3",,DEM,Ballots Cast,12,32,53,97
Waller,101,"Judge, Court of Criminal Appeals, Place 3",,DEM,Under Votes,0,4,21,25
Waller,101,"Judge, Court of Criminal Appeals, Place 3",,DEM,Over Votes,0,0,0,0
Waller,101,"Judge, Court of Criminal Appeals, Place 4",,DEM,Steven Miears,3,5,18,26
Waller,101,"Judge, Court of Criminal Appeals, Place 4",,DEM,Tina Clinton,9,27,35,71
Waller,101,"Judge, Court of Criminal Appeals, Place 4",,DEM,Ballots Cast,12,32,53,97
Waller,101,"Judge, Court of Criminal Appeals, Place 4",,DEM,Under Votes,0,4,21,25
Waller,101,"Judge, Court of Criminal Appeals, Place 4",,DEM,Over Votes,0,0,0,0
Waller,101,"Judge, Court of Criminal Appeals, Place 9",,DEM,Brandon Birmingham,10,27,49,86
Waller,101,"Judge, Court of Criminal Appeals, Place 9",,DEM,Ballots Cast,10,27,49,86
Waller,101,"Judge, Court of Criminal Appeals, Place 9",,DEM,Under Votes,2,9,25,36
Waller,101,"Judge, Court of Criminal Appeals, Place 9",,DEM,Over Votes,0,0,0,0
Waller,101,"Member, State Board of Education, District 10",,DEM,Stephen Wyman,1,9,11,21
Waller,101,"Member, State Board of Education, District 10",,DEM,Marsha Burnett-Webster,11,21,42,74
Waller,101,"Member, State Board of Education, District 10",,DEM,Ballots Cast,12,30,53,95
Waller,101,"Member, State Board of Education, District 10",,DEM,Under Votes,0,6,21,27
Waller,101,"Member, State Board of Education, District 10",,DEM,Over Votes,0,0,0,0
Waller,101,State Senate,18,DEM,Michael Antalan,10,27,50,87
Waller,101,State Senate,18,DEM,Ballots Cast,10,27,50,87
Waller,101,State Senate,18,DEM,Under Votes,2,9,24,35
Waller,101,State Senate,18,DEM,Over Votes,0,0,0,0
Waller,101,State Representative,3,DEM,Martin Shupp,10,26,50,86
Waller,101,State Representative,3,DEM,Ballots Cast,10,26,50,86
Waller,101,State Representative,3,DEM,Under Votes,2,10,24,36
Waller,101,State Representative,3,DEM,Over Votes,0,0,0,0
Waller,101,"Chief Justice, 14th Court of Appeals District",,DEM,Jane Robinson,11,24,42,77
Waller,101,"Chief Justice, 14th Court of Appeals District",,DEM,Jim Evans,1,5,10,16
Waller,101,"Chief Justice, 14th Court of Appeals District",,DEM,Ballots Cast,12,29,52,93
Waller,101,"Chief Justice, 14th Court of Appeals District",,DEM,Under Votes,0,7,22,29
Waller,101,"Chief Justice, 14th Court of Appeals District",,DEM,Over Votes,0,0,0,0
Waller,101,"Justice, 1st Court of Appeals District, Place 3",,DEM,Jim Sharp,2,8,16,26
Waller,101,"Justice, 1st Court of Appeals District, Place 3",,DEM,Dinesh Singhal,0,5,10,15
Waller,101,"Justice, 1st Court of Appeals District, Place 3",,DEM,Veronica Rivas-Molloy,9,16,29,54
Waller,101,"Justice, 1st Court of Appeals District, Place 3",,DEM,Ballots Cast,11,29,55,95
Waller,101,"Justice, 1st Court of Appeals District, Place 3",,DEM,Under Votes,1,7,19,27
Waller,101,"Justice, 1st Court of Appeals District, Place 3",,DEM,Over Votes,0,0,0,0
Waller,101,"Justice, 1st Court of Appeals District, Place 5",,DEM,Tim Hootman,4,13,19,36
Waller,101,"Justice, 1st Court of Appeals District, Place 5",,DEM,Amparo Monique Guerra,6,14,35,55
Waller,101,"Justice, 1st Court of Appeals District, Place 5",,DEM,Ballots Cast,10,27,54,91
Waller,101,"Justice, 1st Court of Appeals District, Place 5",,DEM,Under Votes,2,9,20,31
Waller,101,"Justice, 1st Court of Appeals District, Place 5",,DEM,Over Votes,0,0,0,0
Waller,101,"Justice, 14th Court of Appeals District, Place 7",,DEM,"Tamika ""Tami"" Craft",5,14,20,39
Waller,101,"Justice, 14th Court of Appeals District, Place 7",,DEM,Wally Kronzer,2,0,2,4
Waller,101,"Justice, 14th Court of Appeals District, Place 7",,DEM,V.R. Faulkner,0,4,3,7
Waller,101,"Justice, 14th Court of Appeals District, Place 7",,DEM,Cheri Thomas,2,7,16,25
Waller,101,"Justice, 14th Court of Appeals District, Place 7",,DEM,Dominic J. Merino,1,1,8,10
Waller,101,"Justice, 14th Court of Appeals District, Place 7",,DEM,Lennon C. Wright,0,3,3,6
Waller,101,"Justice, 14th Court of Appeals District, Place 7",,DEM,Ballots Cast,10,29,52,91
Waller,101,"Justice, 14th Court of Appeals District, Place 7",,DEM,Under Votes,2,7,22,31
Waller,101,"Justice, 14th Court of Appeals District, Place 7",,DEM,Over Votes,0,0,0,0
Waller,101,Sheriff,,DEM,Cedric D. Watson,11,28,47,86
Waller,101,Sheriff,,DEM,Ballots Cast,11,28,47,86
Waller,101,Sheriff,,DEM,Under Votes,1,8,27,36
Waller,101,Sheriff,,DEM,Over Votes,0,0,0,0
Waller,101,"County Commissioner, Precinct 1",,DEM,Jacqueline Reynolds,6,14,35,55
Waller,101,"County Commissioner, Precinct 1",,DEM,Mildred Jefferson,4,13,24,41
Waller,101,"County Commissioner, Precinct 1",,DEM,Ballots Cast,10,27,59,96
Waller,101,"County Commissioner, Precinct 1",,DEM,Under Votes,2,9,15,26
Waller,101,"County Commissioner, Precinct 1",,DEM,Over Votes,0,0,0,0
Waller,101,County Chairman,,DEM,Rosa Patlan Harris,11,26,51,88
Waller,101,County Chairman,,DEM,Ballots Cast,11,26,51,88
Waller,101,County Chairman,,DEM,Under Votes,1,10,23,34
Waller,101,County Chairman,,DEM,Over Votes,0,0,0,0
Waller,101,President,,REP,Donald J. Trump,22,254,150,426
Waller,101,President,,REP,Joe Walsh,0,4,0,4
Waller,101,President,,REP,Bob Ely,0,0,0,0
Waller,101,President,,REP,"Roque ""Rocky"" De La Fuente Guerra",0,0,0,0
Waller,101,President,,REP,Zoltan G. Istvan,0,0,0,0
Waller,101,President,,REP,Matthew John Matern,0,1,0,1
Waller,101,President,,REP,Bill Weld,0,0,5,5
Waller,101,President,,REP,Uncommitted,0,10,4,14
Waller,101,President,,REP,Ballots Cast,22,269,159,450
Waller,101,President,,REP,Under Votes,0,6,0,6
Waller,101,President,,REP,Over Votes,0,0,0,0
Waller,101,U.S. Senate,,REP,Dwayne Stovall,1,31,38,70
Waller,101,U.S. Senate,,REP,Mark Yancey,0,12,10,22
Waller,101,U.S. Senate,,REP,Virgil Bierschwale,0,2,1,3
Waller,101,U.S. Senate,,REP,John Anthony Castro,0,10,3,13
Waller,101,U.S. Senate,,REP,John Cornyn,20,185,87,292
Waller,101,U.S. Senate,,REP,Ballots Cast,21,240,139,400
Waller,101,U.S. Senate,,REP,Under Votes,1,35,20,56
Waller,101,U.S. Senate,,REP,Over Votes,0,0,0,0
Waller,101,U.S. House,10,REP,Michael McCaul,22,246,135,403
Waller,101,U.S. House,10,REP,Ballots Cast,22,246,135,403
Waller,101,U.S. House,10,REP,Under Votes,0,29,24,53
Waller,101,U.S. House,10,REP,Over Votes,0,0,0,0
Waller,101,Railroad Commissioner,,REP,Ryan Sitton,16,127,66,209
Waller,101,Railroad Commissioner,,REP,"James ""Jim"" Wright",5,90,64,159
Waller,101,Railroad Commissioner,,REP,Ballots Cast,21,217,130,368
Waller,101,Railroad Commissioner,,REP,Under Votes,1,58,29,88
Waller,101,Railroad Commissioner,,REP,Over Votes,0,0,0,0
Waller,101,"Chief Justice, Supreme Court",,REP,Nathan Hecht,22,219,127,368
Waller,101,"Chief Justice, Supreme Court",,REP,Ballots Cast,22,219,127,368
Waller,101,"Chief Justice, Supreme Court",,REP,Under Votes,0,56,32,88
Waller,101,"Chief Justice, Supreme Court",,REP,Over Votes,0,0,0,0
Waller,101,"Justice, Supreme Court, Place 6 Unexpired Term",,REP,Jane Bland,22,214,125,361
Waller,101,"Justice, Supreme Court, Place 6 Unexpired Term",,REP,Ballots Cast,22,214,125,361
Waller,101,"Justice, Supreme Court, Place 6 Unexpired Term",,REP,Under Votes,0,61,34,95
Waller,101,"Justice, Supreme Court, Place 6 Unexpired Term",,REP,Over Votes,0,0,0,0
Waller,101,"Justice, Supreme Court, Place 7",,REP,Jeff Boyd,21,215,127,363
Waller,101,"Justice, Supreme Court, Place 7",,REP,Ballots Cast,21,215,127,363
Waller,101,"Justice, Supreme Court, Place 7",,REP,Under Votes,1,60,32,93
Waller,101,"Justice, Supreme Court, Place 7",,REP,Over Votes,0,0,0,0
Waller,101,"Justice, Supreme Court, Place 8",,REP,Brett Busby,21,212,128,361
Waller,101,"Justice, Supreme Court, Place 8",,REP,Ballots Cast,21,212,128,361
Waller,101,"Justice, Supreme Court, Place 8",,REP,Under Votes,1,63,31,95
Waller,101,"Justice, Supreme Court, Place 8",,REP,Over Votes,0,0,0,0
Waller,101,"Judge, Court of Criminal Appeals, Place 3",,REP,Gina Parker,10,99,56,165
Waller,101,"Judge, Court of Criminal Appeals, Place 3",,REP,Bert Richardson,10,101,65,176
Waller,101,"Judge, Court of Criminal Appeals, Place 3",,REP,Ballots Cast,20,200,121,341
Waller,101,"Judge, Court of Criminal Appeals, Place 3",,REP,Under Votes,2,75,38,115
Waller,101,"Judge, Court of Criminal Appeals, Place 3",,REP,Over Votes,0,0,0,0
Waller,101,"Judge, Court of Criminal Appeals, Place 4",,REP,Kevin Patrick Yeary,22,212,127,361
Waller,101,"Judge, Court of Criminal Appeals, Place 4",,REP,Ballots Cast,22,212,127,361
Waller,101,"Judge, Court of Criminal Appeals, Place 4",,REP,Under Votes,0,63,32,95
Waller,101,"Judge, Court of Criminal Appeals, Place 4",,REP,Over Votes,0,0,0,0
Waller,101,"Judge, Court of Criminal Appeals, Place 9",,REP,David Newell,22,212,125,359
Waller,101,"Judge, Court of Criminal Appeals, Place 9",,REP,Ballots Cast,22,212,125,359
Waller,101,"Judge, Court of Criminal Appeals, Place 9",,REP,Under Votes,0,63,34,97
Waller,101,"Judge, Court of Criminal Appeals, Place 9",,REP,Over Votes,0,0,0,0
Waller,101,"Member, State Board of Education, District 10",,REP,Tom Maynard,20,215,124,359
Waller,101,"Member, State Board of Education, District 10",,REP,Ballots Cast,20,215,124,359
Waller,101,"Member, State Board of Education, District 10",,REP,Under Votes,2,60,35,97
Waller,101,"Member, State Board of Education, District 10",,REP,Over Votes,0,0,0,0
Waller,101,State Senate,18,REP,Lois W. Kolkhorst,21,232,136,389
Waller,101,State Senate,18,REP,Ballots Cast,21,232,136,389
Waller,101,State Senate,18,REP,Under Votes,1,43,23,67
Waller,101,State Senate,18,REP,Over Votes,0,0,0,0
Waller,101,State Representative,3,REP,Cecil Bell Jr,20,231,132,383
Waller,101,State Representative,3,REP,Ballots Cast,20,231,132,383
Waller,101,State Representative,3,REP,Under Votes,2,44,27,73
Waller,101,State Representative,3,REP,Over Votes,0,0,0,0
Waller,101,"Chief Justice, 14th Court of Appeals District",,REP,Tracy Elizabeth Christopher,19,213,124,356
Waller,101,"Chief Justice, 14th Court of Appeals District",,REP,Ballots Cast,19,213,124,356
Waller,101,"Chief Justice, 14th Court of Appeals District",,REP,Under Votes,3,62,35,100
Waller,101,"Chief Justice, 14th Court of Appeals District",,REP,Over Votes,0,0,0,0
Waller,101,"Justice, 1st Court of Appeals District, Place 3",,REP,Russell Lloyd,20,213,125,358
Waller,101,"Justice, 1st Court of Appeals District, Place 3",,REP,Ballots Cast,20,213,125,358
Waller,101,"Justice, 1st Court of Appeals District, Place 3",,REP,Under Votes,2,62,34,98
Waller,101,"Justice, 1st Court of Appeals District, Place 3",,REP,Over Votes,0,0,0,0
Waller,101,"Justice, 1st Court of Appeals District, Place 5",,REP,Chad Bridges,7,110,47,164
Waller,101,"Justice, 1st Court of Appeals District, Place 5",,REP,James Lombardino,1,25,9,35
Waller,101,"Justice, 1st Court of Appeals District, Place 5",,REP,Levi J. Benton,1,19,14,34
Waller,101,"Justice, 1st Court of Appeals District, Place 5",,REP,Terry Adams,11,50,44,105
Waller,101,"Justice, 1st Court of Appeals District, Place 5",,REP,Ballots Cast,20,204,114,338
Waller,101,"Justice, 1st Court of Appeals District, Place 5",,REP,Under Votes,2,71,45,118
Waller,101,"Justice, 1st Court of Appeals District, Place 5",,REP,Over Votes,0,0,0,0
Waller,101,"Justice, 14th Court of Appeals District, Place 7",,REP,Ken Wise,21,208,123,352
Waller,101,"Justice, 14th Court of Appeals District, Place 7",,REP,Ballots Cast,21,208,123,352
Waller,101,"Justice, 14th Court of Appeals District, Place 7",,REP,Under Votes,1,67,36,104
Waller,101,"Justice, 14th Court of Appeals District, Place 7",,REP,Over Votes,0,0,0,0
Waller,101,"District Judge, 506th Judicial District",,REP,Gary W. Chaney,21,229,131,381
Waller,101,"District Judge, 506th Judicial District",,REP,Ballots Cast,21,229,131,381
Waller,101,"District Judge, 506th Judicial District",,REP,Under Votes,1,46,28,75
Waller,101,"District Judge, 506th Judicial District",,REP,Over Votes,0,0,0,0
Waller,101,Sheriff,,REP,Dan Porter,3,17,6,26
Waller,101,Sheriff,,REP,R. Glenn Smith,14,169,88,271
Waller,101,Sheriff,,REP,Troy Guidry,5,87,62,154
Waller,101,Sheriff,,REP,Ballots Cast,22,273,156,451
Waller,101,Sheriff,,REP,Under Votes,0,2,3,5
Waller,101,Sheriff,,REP,Over Votes,0,0,0,0
Waller,101,County Tax Assessor-Collector,,REP,Ellen Contreras Shelburne,11,156,90,257
Waller,101,County Tax Assessor-Collector,,REP,Carolyn Miedke,10,107,61,178
Waller,101,County Tax Assessor-Collector,,REP,Ballots Cast,21,263,151,435
Waller,101,County Tax Assessor-Collector,,REP,Under Votes,1,12,8,21
Waller,101,County Tax Assessor-Collector,,REP,Over Votes,0,0,0,0
Waller,101,"County Commissioner, Precinct 1",,REP,John Allen Amsler,20,231,136,387
Waller,101,"County Commissioner, Precinct 1",,REP,Ballots Cast,20,231,136,387
Waller,101,"County Commissioner, Precinct 1",,REP,Under Votes,2,44,23,69
Waller,101,"County Commissioner, Precinct 1",,REP,Over Votes,0,0,0,0
Waller,101,"Constable, Precinct 1",,REP,Bo Hashaw,20,229,139,388
Waller,101,"Constable, Precinct 1",,REP,Ballots Cast,20,229,139,388
Waller,101,"Constable, Precinct 1",,REP,Under Votes,2,46,20,68
Waller,101,"Constable, Precinct 1",,REP,Over Votes,0,0,0,0
Waller,101,County Chairman,,REP,David W. Luther,21,215,123,359
Waller,101,County Chairman,,REP,Ballots Cast,21,215,123,359
Waller,101,County Chairman,,REP,Under Votes,1,60,36,97
Waller,101,County Chairman,,REP,Over Votes,0,0,0,0
Waller,101,Proposition #1,,DEM,Yes,11,36,65,112
Waller,101,Proposition #1,,DEM,No,0,0,0,0
Waller,101,Proposition #1,,DEM,Ballots Cast,11,36,65,112
Waller,101,Proposition #1,,DEM,Under Votes,1,0,9,10
Waller,101,Proposition #1,,DEM,Over Votes,0,0,0,0
Waller,101,Proposition #2,,DEM,Yes,12,34,65,111
Waller,101,Proposition #2,,DEM,No,0,0,1,1
Waller,101,Proposition #2,,DEM,Ballots Cast,12,34,66,112
Waller,101,Proposition #2,,DEM,Under Votes,0,2,8,10
Waller,101,Proposition #2,,DEM,Over Votes,0,0,0,0
Waller,101,Proposition #3,,DEM,Yes,12,36,64,112
Waller,101,Proposition #3,,DEM,No,0,0,1,1
Waller,101,Proposition #3,,DEM,Ballots Cast,12,36,65,113
Waller,101,Proposition #3,,DEM,Under Votes,0,0,9,9
Waller,101,Proposition #3,,DEM,Over Votes,0,0,0,0
Waller,101,Proposition #4,,DEM,Yes,12,35,64,111
Waller,101,Proposition #4,,DEM,No,0,0,2,2
Waller,101,Proposition #4,,DEM,Ballots Cast,12,35,66,113
Waller,101,Proposition #4,,DEM,Under Votes,0,1,8,9
Waller,101,Proposition #4,,DEM,Over Votes,0,0,0,0
Waller,101,Proposition #5,,DEM,Yes,12,35,66,113
Waller,101,Proposition #5,,DEM,No,0,0,0,0
Waller,101,Proposition #5,,DEM,Ballots Cast,12,35,66,113
Waller,101,Proposition #5,,DEM,Under Votes,0,1,8,9
Waller,101,Proposition #5,,DEM,Over Votes,0,0,0,0
Waller,101,Proposition #6,,DEM,Yes,12,35,62,109
Waller,101,Proposition #6,,DEM,No,0,0,2,2
Waller,101,Proposition #6,,DEM,Ballots Cast,12,35,64,111
Waller,101,Proposition #6,,DEM,Under Votes,0,1,10,11
Waller,101,Proposition #6,,DEM,Over Votes,0,0,0,0
Waller,101,Proposition #7,,DEM,Yes,12,35,61,108
Waller,101,Proposition #7,,DEM,No,0,0,3,3
Waller,101,Proposition #7,,DEM,Ballots Cast,12,35,64,111
Waller,101,Proposition #7,,DEM,Under Votes,0,1,10,11
Waller,101,Proposition #7,,DEM,Over Votes,0,0,0,0
Waller,101,Proposition #8,,DEM,Yes,12,32,64,108
Waller,101,Proposition #8,,DEM,No,0,2,2,4
Waller,101,Proposition #8,,DEM,Ballots Cast,12,34,66,112
Waller,101,Proposition #8,,DEM,Under Votes,0,2,8,10
Waller,101,Proposition #8,,DEM,Over Votes,0,0,0,0
Waller,101,Proposition #9,,DEM,Yes,12,34,62,108
Waller,101,Proposition #9,,DEM,No,0,1,2,3
Waller,101,Proposition #9,,DEM,Ballots Cast,12,35,64,111
Waller,101,Proposition #9,,DEM,Under Votes,0,1,10,11
Waller,101,Proposition #9,,DEM,Over Votes,0,0,0,0
Waller,101,Proposition #10,,DEM,Yes,12,31,62,105
Waller,101,Proposition #10,,DEM,No,0,3,4,7
Waller,101,Proposition #10,,DEM,Ballots Cast,12,34,66,112
Waller,101,Proposition #10,,DEM,Under Votes,0,2,8,10
Waller,101,Proposition #10,,DEM,Over Votes,0,0,0,0
Waller,101,Proposition #11,,DEM,Yes,11,32,60,103
Waller,101,Proposition #11,,DEM,No,1,2,6,9
Waller,101,Proposition #11,,DEM,Ballots Cast,12,34,66,112
Waller,101,Proposition #11,,DEM,Under Votes,0,2,8,10
Waller,101,Proposition #11,,DEM,Over Votes,0,0,0,0
Waller,101,Proposition 1,,REP,Yes,18,229,134,381
Waller,101,Proposition 1,,REP,No,3,37,21,61
Waller,101,Proposition 1,,REP,Ballots Cast,21,266,155,442
Waller,101,Proposition 1,,REP,Under Votes,1,9,4,14
Waller,101,Proposition 1,,REP,Over Votes,0,0,0,0
Waller,101,Proposition 2,,REP,Yes,17,218,136,371
Waller,101,Proposition 2,,REP,No,5,44,19,68
Waller,101,Proposition 2,,REP,Ballots Cast,22,262,155,439
Waller,101,Proposition 2,,REP,Under Votes,0,13,4,17
Waller,101,Proposition 2,,REP,Over Votes,0,0,0,0
Waller,101,Proposition 3,,REP,Yes,21,244,138,403
Waller,101,Proposition 3,,REP,No,1,17,13,31
Waller,101,Proposition 3,,REP,Ballots Cast,22,261,151,434
Waller,101,Proposition 3,,REP,Under Votes,0,14,8,22
Waller,101,Proposition 3,,REP,Over Votes,0,0,0,0
Waller,101,Proposition 4,,REP,Yes,22,240,145,407
Waller,101,Proposition 4,,REP,No,0,17,7,24
Waller,101,Proposition 4,,REP,Ballots Cast,22,257,152,431
Waller,101,Proposition 4,,REP,Under Votes,0,18,7,25
Waller,101,Proposition 4,,REP,Over Votes,0,0,0,0
Waller,101,Proposition 5,,REP,Yes,20,240,142,402
Waller,101,Proposition 5,,REP,No,2,19,12,33
Waller,101,Proposition 5,,REP,Ballots Cast,22,259,154,435
Waller,101,Proposition 5,,REP,Under Votes,0,16,5,21
Waller,101,Proposition 5,,REP,Over Votes,0,0,0,0
Waller,101,Proposition 6,,REP,Yes,21,248,144,413
Waller,101,Proposition 6,,REP,No,1,12,8,21
Waller,101,Proposition 6,,REP,Ballots Cast,22,260,152,434
Waller,101,Proposition 6,,REP,Under Votes,0,15,7,22
Waller,101,Proposition 6,,REP,Over Votes,0,0,0,0
Waller,101,Proposition 7,,REP,Yes,21,258,151,430
Waller,101,Proposition 7,,REP,No,0,2,3,5
Waller,101,Proposition 7,,REP,Ballots Cast,21,260,154,435
Waller,101,Proposition 7,,REP,Under Votes,1,15,5,21
Waller,101,Proposition 7,,REP,Over Votes,0,0,0,0
Waller,101,Proposition 8,,REP,Yes,22,256,152,430
Waller,101,Proposition 8,,REP,No,0,4,3,7
Waller,101,Proposition 8,,REP,Ballots Cast,22,260,155,437
Waller,101,Proposition 8,,REP,Under Votes,0,15,4,19
Waller,101,Proposition 8,,REP,Over Votes,0,0,0,0
Waller,101,Proposition 9,,REP,Yes,21,252,151,424
Waller,101,Proposition 9,,REP,No,1,8,5,14
Waller,101,Proposition 9,,REP,Ballots Cast,22,260,156,438
Waller,101,Proposition 9,,REP,Under Votes,0,15,3,18
Waller,101,Proposition 9,,REP,Over Votes,0,0,0,0
Waller,101,Proposition 10,,REP,Yes,22,230,149,401
Waller,101,Proposition 10,,REP,No,0,26,7,33
Waller,101,Proposition 10,,REP,Ballots Cast,22,256,156,434
Waller,101,Proposition 10,,REP,Under Votes,0,19,3,22
Waller,101,Proposition 10,,REP,Over Votes,0,0,0,0
Waller,102,President,,DEM,Michael Bennet,0,3,2,5
Waller,102,President,,DEM,Marianne Williamson,0,1,0,1
Waller,102,President,,DEM,Cory Booker,0,2,0,2
Waller,102,President,,DEM,Bernie Sanders,3,15,14,32
Waller,102,President,,DEM,Tulsi Gabbard,0,0,1,1
Waller,102,President,,DEM,Deval Patrick,0,0,0,0
Waller,102,President,,DEM,Amy Klobuchar,0,2,0,2
Waller,102,President,,DEM,Julián Castro,0,0,1,1
Waller,102,President,,DEM,Elizabeth Warren,2,3,3,8
Waller,102,President,,DEM,John K. Delaney,0,0,1,1
Waller,102,President,,DEM,Robby Wells,0,0,0,0
Waller,102,President,,DEM,"Roque ""Rocky"" De La Fuente",0,0,0,0
Waller,102,President,,DEM,Andrew Yang,0,0,0,0
Waller,102,President,,DEM,Joseph R. Biden,13,21,60,94
Waller,102,President,,DEM,Michael R. Bloomberg,9,9,6,24
Waller,102,President,,DEM,Tom Steyer,0,0,0,0
Waller,102,President,,DEM,Pete Buttigieg,1,3,0,4
Waller,102,President,,DEM,Ballots Cast,28,59,88,175
Waller,102,President,,DEM,Under Votes,0,5,2,7
Waller,102,President,,DEM,Over Votes,2,0,0,2
Waller,102,U.S. Senate,,DEM,Royce West,8,17,14,39
Waller,102,U.S. Senate,,DEM,"Annie ""Mamá"" Garcia",1,2,15,18
Waller,102,U.S. Senate,,DEM,D. R. Hunter,0,3,2,5
Waller,102,U.S. Senate,,DEM,Sema Hernandez,1,1,1,3
Waller,102,U.S. Senate,,DEM,Adrian Ocegueda,0,2,0,2
Waller,102,U.S. Senate,,DEM,Chris Bell,13,14,23,50
Waller,102,U.S. Senate,,DEM,Cristina Tzintzun Ramirez,0,3,8,11
Waller,102,U.S. Senate,,DEM,Jack Daniel Foster Jr,0,0,2,2
Waller,102,U.S. Senate,,DEM,Amanda K. Edwards,2,4,3,9
Waller,102,U.S. Senate,,DEM,Victor Hugo Harris,0,1,0,1
Waller,102,U.S. Senate,,DEM,"Mary ""MJ"" Hegar",3,2,6,11
Waller,102,U.S. Senate,,DEM,Michael Cooper,1,4,5,10
Waller,102,U.S. Senate,,DEM,Ballots Cast,29,53,79,161
Waller,102,U.S. Senate,,DEM,Under Votes,1,11,11,23
Waller,102,U.S. Senate,,DEM,Over Votes,0,0,0,0
Waller,102,U.S. House,10,DEM,Mike Siegel,21,33,41,95
Waller,102,U.S. House,10,DEM,Shannon Hutcheson,3,16,23,42
Waller,102,U.S. House,10,DEM,Pritesh Gandhi,4,7,15,26
Waller,102,U.S. House,10,DEM,Ballots Cast,28,56,79,163
Waller,102,U.S. House,10,DEM,Under Votes,2,8,11,21
Waller,102,U.S. House,10,DEM,Over Votes,0,0,0,0
Waller,102,Railroad Commissioner,,DEM,"Roberto R. ""Beto"" Alonzo",9,19,20,48
Waller,102,Railroad Commissioner,,DEM,Chrysta Castañeda,7,7,13,27
Waller,102,Railroad Commissioner,,DEM,Mark Watson,6,15,27,48
Waller,102,Railroad Commissioner,,DEM,Kelly Stone,4,13,13,30
Waller,102,Railroad Commissioner,,DEM,Ballots Cast,26,54,73,153
Waller,102,Railroad Commissioner,,DEM,Under Votes,4,10,17,31
Waller,102,Railroad Commissioner,,DEM,Over Votes,0,0,0,0
Waller,102,"Chief Justice, Supreme Court",,DEM,Jerry Zimmerer,11,11,16,38
Waller,102,"Chief Justice, Supreme Court",,DEM,Amy Clark Meachum,15,42,50,107
Waller,102,"Chief Justice, Supreme Court",,DEM,Ballots Cast,26,53,66,145
Waller,102,"Chief Justice, Supreme Court",,DEM,Under Votes,4,11,24,39
Waller,102,"Chief Justice, Supreme Court",,DEM,Over Votes,0,0,0,0
Waller,102,"Justice, Supreme Court, Place 6 Unexpired Term",,DEM,Kathy Cheng,18,41,58,117
Waller,102,"Justice, Supreme Court, Place 6 Unexpired Term",,DEM,Larry Praeger,9,12,12,33
Waller,102,"Justice, Supreme Court, Place 6 Unexpired Term",,DEM,Ballots Cast,27,53,70,150
Waller,102,"Justice, Supreme Court, Place 6 Unexpired Term",,DEM,Under Votes,3,11,20,34
Waller,102,"Justice, Supreme Court, Place 6 Unexpired Term",,DEM,Over Votes,0,0,0,0
Waller,102,"Justice, Supreme Court, Place 7",,DEM,Staci Williams,25,41,44,110
Waller,102,"Justice, Supreme Court, Place 7",,DEM,Brandy Voss,1,12,25,38
Waller,102,"Justice, Supreme Court, Place 7",,DEM,Ballots Cast,26,53,69,148
Waller,102,"Justice, Supreme Court, Place 7",,DEM,Under Votes,4,11,21,36
Waller,102,"Justice, Supreme Court, Place 7",,DEM,Over Votes,0,0,0,0
Waller,102,"Justice, Supreme Court, Place 8",,DEM,Gisela D. Triana,17,29,35,81
Waller,102,"Justice, Supreme Court, Place 8",,DEM,Peter Kelly,10,21,33,64
Waller,102,"Justice, Supreme Court, Place 8",,DEM,Ballots Cast,27,50,68,145
Waller,102,"Justice, Supreme Court, Place 8",,DEM,Under Votes,3,14,22,39
Waller,102,"Justice, Supreme Court, Place 8",,DEM,Over Votes,0,0,0,0
Waller,102,"Judge, Court of Criminal Appeals, Place 3",,DEM,Elizabeth Davis Frizell,22,35,41,98
Waller,102,"Judge, Court of Criminal Appeals, Place 3",,DEM,William Pieratt Demond,1,6,10,17
Waller,102,"Judge, Court of Criminal Appeals, Place 3",,DEM,Dan Wood,4,10,19,33
Waller,102,"Judge, Court of Criminal Appeals, Place 3",,DEM,Ballots Cast,27,51,70,148
Waller,102,"Judge, Court of Criminal Appeals, Place 3",,DEM,Under Votes,3,13,20,36
Waller,102,"Judge, Court of Criminal Appeals, Place 3",,DEM,Over Votes,0,0,0,0
Waller,102,"Judge, Court of Criminal Appeals, Place 4",,DEM,Steven Miears,7,10,21,38
Waller,102,"Judge, Court of Criminal Appeals, Place 4",,DEM,Tina Clinton,19,43,48,110
Waller,102,"Judge, Court of Criminal Appeals, Place 4",,DEM,Ballots Cast,26,53,69,148
Waller,102,"Judge, Court of Criminal Appeals, Place 4",,DEM,Under Votes,4,11,21,36
Waller,102,"Judge, Court of Criminal Appeals, Place 4",,DEM,Over Votes,0,0,0,0
Waller,102,"Judge, Court of Criminal Appeals, Place 9",,DEM,Brandon Birmingham,25,50,59,134
Waller,102,"Judge, Court of Criminal Appeals, Place 9",,DEM,Ballots Cast,25,50,59,134
Waller,102,"Judge, Court of Criminal Appeals, Place 9",,DEM,Under Votes,5,14,31,50
Waller,102,"Judge, Court of Criminal Appeals, Place 9",,DEM,Over Votes,0,0,0,0
Waller,102,"Member, State Board of Education, District 10",,DEM,Stephen Wyman,2,7,12,21
Waller,102,"Member, State Board of Education, District 10",,DEM,Marsha Burnett-Webster,22,48,60,130
Waller,102,"Member, State Board of Education, District 10",,DEM,Ballots Cast,24,55,72,151
Waller,102,"Member, State Board of Education, District 10",,DEM,Under Votes,6,9,18,33
Waller,102,"Member, State Board of Education, District 10",,DEM,Over Votes,0,0,0,0
Waller,102,State Senate,18,DEM,Michael Antalan,22,50,62,134
Waller,102,State Senate,18,DEM,Ballots Cast,22,50,62,134
Waller,102,State Senate,18,DEM,Under Votes,8,14,28,50
Waller,102,State Senate,18,DEM,Over Votes,0,0,0,0
Waller,102,State Representative,3,DEM,Martin Shupp,23,50,63,136
Waller,102,State Representative,3,DEM,Ballots Cast,23,50,63,136
Waller,102,State Representative,3,DEM,Under Votes,7,14,27,48
Waller,102,State Representative,3,DEM,Over Votes,0,0,0,0
Waller,102,"Chief Justice, 14th Court of Appeals District",,DEM,Jane Robinson,20,43,57,120
Waller,102,"Chief Justice, 14th Court of Appeals District",,DEM,Jim Evans,7,10,15,32
Waller,102,"Chief Justice, 14th Court of Appeals District",,DEM,Ballots Cast,27,53,72,152
Waller,102,"Chief Justice, 14th Court of Appeals District",,DEM,Under Votes,3,11,18,32
Waller,102,"Chief Justice, 14th Court of Appeals District",,DEM,Over Votes,0,0,0,0
Waller,102,"Justice, 1st Court of Appeals District, Place 3",,DEM,Jim Sharp,8,19,22,49
Waller,102,"Justice, 1st Court of Appeals District, Place 3",,DEM,Dinesh Singhal,4,12,16,32
Waller,102,"Justice, 1st Court of Appeals District, Place 3",,DEM,Veronica Rivas-Molloy,14,22,33,69
Waller,102,"Justice, 1st Court of Appeals District, Place 3",,DEM,Ballots Cast,26,53,71,150
Waller,102,"Justice, 1st Court of Appeals District, Place 3",,DEM,Under Votes,4,11,19,34
Waller,102,"Justice, 1st Court of Appeals District, Place 3",,DEM,Over Votes,0,0,0,0
Waller,102,"Justice, 1st Court of Appeals District, Place 5",,DEM,Tim Hootman,10,21,37,68
Waller,102,"Justice, 1st Court of Appeals District, Place 5",,DEM,Amparo Monique Guerra,17,28,31,76
Waller,102,"Justice, 1st Court of Appeals District, Place 5",,DEM,Ballots Cast,27,49,68,144
Waller,102,"Justice, 1st Court of Appeals District, Place 5",,DEM,Under Votes,3,15,22,40
Waller,102,"Justice, 1st Court of Appeals District, Place 5",,DEM,Over Votes,0,0,0,0
Waller,102,"Justice, 14th Court of Appeals District, Place 7",,DEM,"Tamika ""Tami"" Craft",14,24,34,72
Waller,102,"Justice, 14th Court of Appeals District, Place 7",,DEM,Wally Kronzer,1,2,1,4
Waller,102,"Justice, 14th Court of Appeals District, Place 7",,DEM,V.R. Faulkner,3,1,6,10
Waller,102,"Justice, 14th Court of Appeals District, Place 7",,DEM,Cheri Thomas,5,14,14,33
Waller,102,"Justice, 14th Court of Appeals District, Place 7",,DEM,Dominic J. Merino,1,4,8,13
Waller,102,"Justice, 14th Court of Appeals District, Place 7",,DEM,Lennon C. Wright,2,6,7,15
Waller,102,"Justice, 14th Court of Appeals District, Place 7",,DEM,Ballots Cast,26,51,70,147
Waller,102,"Justice, 14th Court of Appeals District, Place 7",,DEM,Under Votes,4,13,20,37
Waller,102,"Justice, 14th Court of Appeals District, Place 7",,DEM,Over Votes,0,0,0,0
Waller,102,Sheriff,,DEM,Cedric D. Watson,23,55,73,151
Waller,102,Sheriff,,DEM,Ballots Cast,23,55,73,151
Waller,102,Sheriff,,DEM,Under Votes,7,9,17,33
Waller,102,Sheriff,,DEM,Over Votes,0,0,0,0
Waller,102,"County Commissioner, Precinct 1",,DEM,Jacqueline Reynolds,9,21,35,65
Waller,102,"County Commissioner, Precinct 1",,DEM,Mildred Jefferson,17,39,49,105
Waller,102,"County Commissioner, Precinct 1",,DEM,Ballots Cast,26,60,84,170
Waller,102,"County Commissioner, Precinct 1",,DEM,Under Votes,4,4,6,14
Waller,102,"County Commissioner, Precinct 1",,DEM,Over Votes,0,0,0,0
Waller,102,County Chairman,,DEM,Rosa Patlan Harris,24,51,67,142
Waller,102,County Chairman,,DEM,Ballots Cast,24,51,67,142
Waller,102,County Chairman,,DEM,Under Votes,6,13,23,42
Waller,102,County Chairman,,DEM,Over Votes,0,0,0,0
Waller,102,President,,REP,Donald J. Trump,7,146,78,231
Waller,102,President,,REP,Joe Walsh,0,3,1,4
Waller,102,President,,REP,Bob Ely,0,0,0,0
Waller,102,President,,REP,"Roque ""Rocky"" De La Fuente Guerra",0,1,0,1
Waller,102,President,,REP,Zoltan G. Istvan,0,0,0,0
Waller,102,President,,REP,Matthew John Matern,0,0,0,0
Waller,102,President,,REP,Bill Weld,0,0,1,1
Waller,102,President,,REP,Uncommitted,0,11,5,16
Waller,102,President,,REP,Ballots Cast,7,161,85,253
Waller,102,President,,REP,Under Votes,0,1,2,3
Waller,102,President,,REP,Over Votes,0,0,0,0
Waller,102,U.S. Senate,,REP,Dwayne Stovall,1,30,22,53
Waller,102,U.S. Senate,,REP,Mark Yancey,0,7,7,14
Waller,102,U.S. Senate,,REP,Virgil Bierschwale,0,0,1,1
Waller,102,U.S. Senate,,REP,John Anthony Castro,0,8,5,13
Waller,102,U.S. Senate,,REP,John Cornyn,6,108,46,160
Waller,102,U.S. Senate,,REP,Ballots Cast,7,153,81,241
Waller,102,U.S. Senate,,REP,Under Votes,0,9,6,15
Waller,102,U.S. Senate,,REP,Over Votes,0,0,0,0
Waller,102,U.S. House,10,REP,Michael McCaul,7,148,77,232
Waller,102,U.S. House,10,REP,Ballots Cast,7,148,77,232
Waller,102,U.S. House,10,REP,Under Votes,0,14,10,24
Waller,102,U.S. House,10,REP,Over Votes,0,0,0,0
Waller,102,Railroad Commissioner,,REP,Ryan Sitton,5,79,47,131
Waller,102,Railroad Commissioner,,REP,"James ""Jim"" Wright",1,62,24,87
Waller,102,Railroad Commissioner,,REP,Ballots Cast,6,141,71,218
Waller,102,Railroad Commissioner,,REP,Under Votes,1,21,16,38
Waller,102,Railroad Commissioner,,REP,Over Votes,0,0,0,0
Waller,102,"Chief Justice, Supreme Court",,REP,Nathan Hecht,7,137,73,217
Waller,102,"Chief Justice, Supreme Court",,REP,Ballots Cast,7,137,73,217
Waller,102,"Chief Justice, Supreme Court",,REP,Under Votes,0,25,14,39
Waller,102,"Chief Justice, Supreme Court",,REP,Over Votes,0,0,0,0
Waller,102,"Justice, Supreme Court, Place 6 Unexpired Term",,REP,Jane Bland,7,129,75,211
Waller,102,"Justice, Supreme Court, Place 6 Unexpired Term",,REP,Ballots Cast,7,129,75,211
Waller,102,"Justice, Supreme Court, Place 6 Unexpired Term",,REP,Under Votes,0,33,12,45
Waller,102,"Justice, Supreme Court, Place 6 Unexpired Term",,REP,Over Votes,0,0,0,0
Waller,102,"Justice, Supreme Court, Place 7",,REP,Jeff Boyd,7,134,74,215
Waller,102,"Justice, Supreme Court, Place 7",,REP,Ballots Cast,7,134,74,215
Waller,102,"Justice, Supreme Court, Place 7",,REP,Under Votes,0,28,13,41
Waller,102,"Justice, Supreme Court, Place 7",,REP,Over Votes,0,0,0,0
Waller,102,"Justice, Supreme Court, Place 8",,REP,Brett Busby,7,135,74,216
Waller,102,"Justice, Supreme Court, Place 8",,REP,Ballots Cast,7,135,74,216
Waller,102,"Justice, Supreme Court, Place 8",,REP,Under Votes,0,27,13,40
Waller,102,"Justice, Supreme Court, Place 8",,REP,Over Votes,0,0,0,0
Waller,102,"Judge, Court of Criminal Appeals, Place 3",,REP,Gina Parker,3,80,41,124
Waller,102,"Judge, Court of Criminal Appeals, Place 3",,REP,Bert Richardson,4,61,29,94
Waller,102,"Judge, Court of Criminal Appeals, Place 3",,REP,Ballots Cast,7,141,70,218
Waller,102,"Judge, Court of Criminal Appeals, Place 3",,REP,Under Votes,0,21,17,38
Waller,102,"Judge, Court of Criminal Appeals, Place 3",,REP,Over Votes,0,0,0,0
Waller,102,"Judge, Court of Criminal Appeals, Place 4",,REP,Kevin Patrick Yeary,7,134,72,213
Waller,102,"Judge, Court of Criminal Appeals, Place 4",,REP,Ballots Cast,7,134,72,213
Waller,102,"Judge, Court of Criminal Appeals, Place 4",,REP,Under Votes,0,28,15,43
Waller,102,"Judge, Court of Criminal Appeals, Place 4",,REP,Over Votes,0,0,0,0
Waller,102,"Judge, Court of Criminal Appeals, Place 9",,REP,David Newell,7,133,73,213
Waller,102,"Judge, Court of Criminal Appeals, Place 9",,REP,Ballots Cast,7,133,73,213
Waller,102,"Judge, Court of Criminal Appeals, Place 9",,REP,Under Votes,0,29,14,43
Waller,102,"Judge, Court of Criminal Appeals, Place 9",,REP,Over Votes,0,0,0,0
Waller,102,"Member, State Board of Education, District 10",,REP,Tom Maynard,6,136,72,214
Waller,102,"Member, State Board of Education, District 10",,REP,Ballots Cast,6,136,72,214
Waller,102,"Member, State Board of Education, District 10",,REP,Under Votes,1,26,15,42
Waller,102,"Member, State Board of Education, District 10",,REP,Over Votes,0,0,0,0
Waller,102,State Senate,18,REP,Lois W. Kolkhorst,6,144,77,227
Waller,102,State Senate,18,REP,Ballots Cast,6,144,77,227
Waller,102,State Senate,18,REP,Under Votes,1,18,10,29
Waller,102,State Senate,18,REP,Over Votes,0,0,0,0
Waller,102,State Representative,3,REP,Cecil Bell Jr,6,143,76,225
Waller,102,State Representative,3,REP,Ballots Cast,6,143,76,225
Waller,102,State Representative,3,REP,Under Votes,1,19,11,31
Waller,102,State Representative,3,REP,Over Votes,0,0,0,0
Waller,102,"Chief Justice, 14th Court of Appeals District",,REP,Tracy Elizabeth Christopher,7,135,72,214
Waller,102,"Chief Justice, 14th Court of Appeals District",,REP,Ballots Cast,7,135,72,214
Waller,102,"Chief Justice, 14th Court of Appeals District",,REP,Under Votes,0,27,15,42
Waller,102,"Chief Justice, 14th Court of Appeals District",,REP,Over Votes,0,0,0,0
Waller,102,"Justice, 1st Court of Appeals District, Place 3",,REP,Russell Lloyd,7,136,71,214
Waller,102,"Justice, 1st Court of Appeals District, Place 3",,REP,Ballots Cast,7,136,71,214
Waller,102,"Justice, 1st Court of Appeals District, Place 3",,REP,Under Votes,0,26,16,42
Waller,102,"Justice, 1st Court of Appeals District, Place 3",,REP,Over Votes,0,0,0,0
Waller,102,"Justice, 1st Court of Appeals District, Place 5",,REP,Chad Bridges,1,64,33,98
Waller,102,"Justice, 1st Court of Appeals District, Place 5",,REP,James Lombardino,1,13,5,19
Waller,102,"Justice, 1st Court of Appeals District, Place 5",,REP,Levi J. Benton,1,12,6,19
Waller,102,"Justice, 1st Court of Appeals District, Place 5",,REP,Terry Adams,4,41,23,68
Waller,102,"Justice, 1st Court of Appeals District, Place 5",,REP,Ballots Cast,7,130,67,204
Waller,102,"Justice, 1st Court of Appeals District, Place 5",,REP,Under Votes,0,32,20,52
Waller,102,"Justice, 1st Court of Appeals District, Place 5",,REP,Over Votes,0,0,0,0
Waller,102,"Justice, 14th Court of Appeals District, Place 7",,REP,Ken Wise,7,132,70,209
Waller,102,"Justice, 14th Court of Appeals District, Place 7",,REP,Ballots Cast,7,132,70,209
Waller,102,"Justice, 14th Court of Appeals District, Place 7",,REP,Under Votes,0,30,17,47
Waller,102,"Justice, 14th Court of Appeals District, Place 7",,REP,Over Votes,0,0,0,0
Waller,102,"District Judge, 506th Judicial District",,REP,Gary W. Chaney,6,141,73,220
Waller,102,"District Judge, 506th Judicial District",,REP,Ballots Cast,6,141,73,220
Waller,102,"District Judge, 506th Judicial District",,REP,Under Votes,1,21,14,36
Waller,102,"District Judge, 506th Judicial District",,REP,Over Votes,0,0,0,0
Waller,102,Sheriff,,REP,Dan Porter,0,5,11,16
Waller,102,Sheriff,,REP,R. Glenn Smith,6,81,42,129
Waller,102,Sheriff,,REP,Troy Guidry,0,76,33,109
Waller,102,Sheriff,,REP,Ballots Cast,6,162,86,254
Waller,102,Sheriff,,REP,Under Votes,1,0,1,2
Waller,102,Sheriff,,REP,Over Votes,0,0,0,0
Waller,102,County Tax Assessor-Collector,,REP,Ellen Contreras Shelburne,3,94,50,147
Waller,102,County Tax Assessor-Collector,,REP,Carolyn Miedke,3,64,31,98
Waller,102,County Tax Assessor-Collector,,REP,Ballots Cast,6,158,81,245
Waller,102,County Tax Assessor-Collector,,REP,Under Votes,1,4,6,11
Waller,102,County Tax Assessor-Collector,,REP,Over Votes,0,0,0,0
Waller,102,"County Commissioner, Precinct 1",,REP,John Allen Amsler,6,140,74,220
Waller,102,"County Commissioner, Precinct 1",,REP,Ballots Cast,6,140,74,220
Waller,102,"County Commissioner, Precinct 1",,REP,Under Votes,1,22,13,36
Waller,102,"County Commissioner, Precinct 1",,REP,Over Votes,0,0,0,0
Waller,102,"Constable, Precinct 1",,REP,Bo Hashaw,6,138,73,217
Waller,102,"Constable, Precinct 1",,REP,Ballots Cast,6,138,73,217
Waller,102,"Constable, Precinct 1",,REP,Under Votes,1,24,14,39
Waller,102,"Constable, Precinct 1",,REP,Over Votes,0,0,0,0
Waller,102,County Chairman,,REP,David W. Luther,6,129,72,207
Waller,102,County Chairman,,REP,Ballots Cast,6,129,72,207
Waller,102,County Chairman,,REP,Under Votes,1,33,15,49
Waller,102,County Chairman,,REP,Over Votes,0,0,0,0
Waller,102,Proposition #1,,DEM,Yes,27,60,84,171
Waller,102,Proposition #1,,DEM,No,0,0,4,4
Waller,102,Proposition #1,,DEM,Ballots Cast,27,60,88,175
Waller,102,Proposition #1,,DEM,Under Votes,3,4,2,9
Waller,102,Proposition #1,,DEM,Over Votes,0,0,0,0
Waller,102,Proposition #2,,DEM,Yes,27,59,82,168
Waller,102,Proposition #2,,DEM,No,0,0,3,3
Waller,102,Proposition #2,,DEM,Ballots Cast,27,59,85,171
Waller,102,Proposition #2,,DEM,Under Votes,3,5,5,13
Waller,102,Proposition #2,,DEM,Over Votes,0,0,0,0
Waller,102,Proposition #3,,DEM,Yes,27,59,81,167
Waller,102,Proposition #3,,DEM,No,0,0,2,2
Waller,102,Proposition #3,,DEM,Ballots Cast,27,59,83,169
Waller,102,Proposition #3,,DEM,Under Votes,3,5,7,15
Waller,102,Proposition #3,,DEM,Over Votes,0,0,0,0
Waller,102,Proposition #4,,DEM,Yes,27,56,83,166
Waller,102,Proposition #4,,DEM,No,0,2,2,4
Waller,102,Proposition #4,,DEM,Ballots Cast,27,58,85,170
Waller,102,Proposition #4,,DEM,Under Votes,3,6,5,14
Waller,102,Proposition #4,,DEM,Over Votes,0,0,0,0
Waller,102,Proposition #5,,DEM,Yes,28,56,85,169
Waller,102,Proposition #5,,DEM,No,0,2,1,3
Waller,102,Proposition #5,,DEM,Ballots Cast,28,58,86,172
Waller,102,Proposition #5,,DEM,Under Votes,2,6,4,12
Waller,102,Proposition #5,,DEM,Over Votes,0,0,0,0
Waller,102,Proposition #6,,DEM,Yes,28,57,80,165
Waller,102,Proposition #6,,DEM,No,0,2,6,8
Waller,102,Proposition #6,,DEM,Ballots Cast,28,59,86,173
Waller,102,Proposition #6,,DEM,Under Votes,2,5,4,11
Waller,102,Proposition #6,,DEM,Over Votes,0,0,0,0
Waller,102,Proposition #7,,DEM,Yes,27,55,84,166
Waller,102,Proposition #7,,DEM,No,1,2,3,6
Waller,102,Proposition #7,,DEM,Ballots Cast,28,57,87,172
Waller,102,Proposition #7,,DEM,Under Votes,2,7,3,12
Waller,102,Proposition #7,,DEM,Over Votes,0,0,0,0
Waller,102,Proposition #8,,DEM,Yes,27,55,81,163
Waller,102,Proposition #8,,DEM,No,1,2,5,8
Waller,102,Proposition #8,,DEM,Ballots Cast,28,57,86,171
Waller,102,Proposition #8,,DEM,Under Votes,2,7,4,13
Waller,102,Proposition #8,,DEM,Over Votes,0,0,0,0
Waller,102,Proposition #9,,DEM,Yes,29,57,82,168
Waller,102,Proposition #9,,DEM,No,0,1,2,3
Waller,102,Proposition #9,,DEM,Ballots Cast,29,58,84,171
Waller,102,Proposition #9,,DEM,Under Votes,1,6,6,13
Waller,102,Proposition #9,,DEM,Over Votes,0,0,0,0
Waller,102,Proposition #10,,DEM,Yes,28,53,76,157
Waller,102,Proposition #10,,DEM,No,0,3,9,12
Waller,102,Proposition #10,,DEM,Ballots Cast,28,56,85,169
Waller,102,Proposition #10,,DEM,Under Votes,2,8,5,15
Waller,102,Proposition #10,,DEM,Over Votes,0,0,0,0
Waller,102,Proposition #11,,DEM,Yes,22,54,80,156
Waller,102,Proposition #11,,DEM,No,6,4,5,15
Waller,102,Proposition #11,,DEM,Ballots Cast,28,58,85,171
Waller,102,Proposition #11,,DEM,Under Votes,2,6,5,13
Waller,102,Proposition #11,,DEM,Over Votes,0,0,0,0
Waller,102,Proposition 1,,REP,Yes,6,147,66,219
Waller,102,Proposition 1,,REP,No,1,14,18,33
Waller,102,Proposition 1,,REP,Ballots Cast,7,161,84,252
Waller,102,Proposition 1,,REP,Under Votes,0,1,3,4
Waller,102,Proposition 1,,REP,Over Votes,0,0,0,0
Waller,102,Proposition 2,,REP,Yes,7,142,68,217
Waller,102,Proposition 2,,REP,No,0,18,15,33
Waller,102,Proposition 2,,REP,Ballots Cast,7,160,83,250
Waller,102,Proposition 2,,REP,Under Votes,0,2,4,6
Waller,102,Proposition 2,,REP,Over Votes,0,0,0,0
Waller,102,Proposition 3,,REP,Yes,7,150,74,231
Waller,102,Proposition 3,,REP,No,0,8,9,17
Waller,102,Proposition 3,,REP,Ballots Cast,7,158,83,248
Waller,102,Proposition 3,,REP,Under Votes,0,4,4,8
Waller,102,Proposition 3,,REP,Over Votes,0,0,0,0
Waller,102,Proposition 4,,REP,Yes,7,146,75,228
Waller,102,Proposition 4,,REP,No,0,11,10,21
Waller,102,Proposition 4,,REP,Ballots Cast,7,157,85,249
Waller,102,Proposition 4,,REP,Under Votes,0,5,2,7
Waller,102,Proposition 4,,REP,Over Votes,0,0,0,0
Waller,102,Proposition 5,,REP,Yes,7,142,77,226
Waller,102,Proposition 5,,REP,No,0,12,7,19
Waller,102,Proposition 5,,REP,Ballots Cast,7,154,84,245
Waller,102,Proposition 5,,REP,Under Votes,0,8,3,11
Waller,102,Proposition 5,,REP,Over Votes,0,0,0,0
Waller,102,Proposition 6,,REP,Yes,7,155,76,238
Waller,102,Proposition 6,,REP,No,0,2,8,10
Waller,102,Proposition 6,,REP,Ballots Cast,7,157,84,248
Waller,102,Proposition 6,,REP,Under Votes,0,5,3,8
Waller,102,Proposition 6,,REP,Over Votes,0,0,0,0
Waller,102,Proposition 7,,REP,Yes,7,156,83,246
Waller,102,Proposition 7,,REP,No,0,2,1,3
Waller,102,Proposition 7,,REP,Ballots Cast,7,158,84,249
Waller,102,Proposition 7,,REP,Under Votes,0,4,3,7
Waller,102,Proposition 7,,REP,Over Votes,0,0,0,0
Waller,102,Proposition 8,,REP,Yes,7,155,82,244
Waller,102,Proposition 8,,REP,No,0,3,2,5
Waller,102,Proposition 8,,REP,Ballots Cast,7,158,84,249
Waller,102,Proposition 8,,REP,Under Votes,0,4,3,7
Waller,102,Proposition 8,,REP,Over Votes,0,0,0,0
Waller,102,Proposition 9,,REP,Yes,7,149,79,235
Waller,102,Proposition 9,,REP,No,0,6,6,12
Waller,102,Proposition 9,,REP,Ballots Cast,7,155,85,247
Waller,102,Proposition 9,,REP,Under Votes,0,7,2,9
Waller,102,Proposition 9,,REP,Over Votes,0,0,0,0
Waller,102,Proposition 10,,REP,Yes,7,141,69,217
Waller,102,Proposition 10,,REP,No,0,13,10,23
Waller,102,Proposition 10,,REP,Ballots Cast,7,154,79,240
Waller,102,Proposition 10,,REP,Under Votes,0,8,8,16
Waller,102,Proposition 10,,REP,Over Votes,0,0,0,0
Waller,103,President,,DEM,Michael Bennet,0,1,0,1
Waller,103,President,,DEM,Marianne Williamson,0,1,2,3
Waller,103,President,,DEM,Cory Booker,0,0,1,1
Waller,103,President,,DEM,Bernie Sanders,1,13,18,32
Waller,103,President,,DEM,Tulsi Gabbard,0,0,0,0
Waller,103,President,,DEM,Deval Patrick,0,2,0,2
Waller,103,President,,DEM,Amy Klobuchar,2,1,0,3
Waller,103,President,,DEM,Julián Castro,0,0,1,1
Waller,103,President,,DEM,Elizabeth Warren,0,1,5,6
Waller,103,President,,DEM,John K. Delaney,0,0,0,0
Waller,103,President,,DEM,Robby Wells,0,0,0,0
Waller,103,President,,DEM,"Roque ""Rocky"" De La Fuente",0,0,1,1
Waller,103,President,,DEM,Andrew Yang,0,0,0,0
Waller,103,President,,DEM,Joseph R. Biden,10,18,33,61
Waller,103,President,,DEM,Michael R. Bloomberg,8,0,11,19
Waller,103,President,,DEM,Tom Steyer,0,0,0,0
Waller,103,President,,DEM,Pete Buttigieg,0,0,0,0
Waller,103,President,,DEM,Ballots Cast,21,37,72,130
Waller,103,President,,DEM,Under Votes,1,4,2,7
Waller,103,President,,DEM,Over Votes,2,0,0,2
Waller,103,U.S. Senate,,DEM,Royce West,5,9,9,23
Waller,103,U.S. Senate,,DEM,"Annie ""Mamá"" Garcia",1,1,12,14
Waller,103,U.S. Senate,,DEM,D. R. Hunter,0,0,4,4
Waller,103,U.S. Senate,,DEM,Sema Hernandez,0,2,2,4
Waller,103,U.S. Senate,,DEM,Adrian Ocegueda,0,0,2,2
Waller,103,U.S. Senate,,DEM,Chris Bell,10,12,9,31
Waller,103,U.S. Senate,,DEM,Cristina Tzintzun Ramirez,0,4,3,7
Waller,103,U.S. Senate,,DEM,Jack Daniel Foster Jr,0,2,2,4
Waller,103,U.S. Senate,,DEM,Amanda K. Edwards,1,0,7,8
Waller,103,U.S. Senate,,DEM,Victor Hugo Harris,0,0,0,0
Waller,103,U.S. Senate,,DEM,"Mary ""MJ"" Hegar",4,3,5,12
Waller,103,U.S. Senate,,DEM,Michael Cooper,0,1,4,5
Waller,103,U.S. Senate,,DEM,Ballots Cast,21,34,59,114
Waller,103,U.S. Senate,,DEM,Under Votes,3,7,15,25
Waller,103,U.S. Senate,,DEM,Over Votes,0,0,0,0
Waller,103,U.S. House,10,DEM,Mike Siegel,12,19,36,67
Waller,103,U.S. House,10,DEM,Shannon Hutcheson,2,12,15,29
Waller,103,U.S. House,10,DEM,Pritesh Gandhi,10,5,10,25
Waller,103,U.S. House,10,DEM,Ballots Cast,24,36,61,121
Waller,103,U.S. House,10,DEM,Under Votes,0,5,13,18
Waller,103,U.S. House,10,DEM,Over Votes,0,0,0,0
Waller,103,Railroad Commissioner,,DEM,"Roberto R. ""Beto"" Alonzo",4,10,17,31
Waller,103,Railroad Commissioner,,DEM,Chrysta Castañeda,1,3,10,14
Waller,103,Railroad Commissioner,,DEM,Mark Watson,4,10,18,32
Waller,103,Railroad Commissioner,,DEM,Kelly Stone,7,9,13,29
Waller,103,Railroad Commissioner,,DEM,Ballots Cast,16,32,58,106
Waller,103,Railroad Commissioner,,DEM,Under Votes,8,9,16,33
Waller,103,Railroad Commissioner,,DEM,Over Votes,0,0,0,0
Waller,103,"Chief Justice, Supreme Court",,DEM,Jerry Zimmerer,4,5,13,22
Waller,103,"Chief Justice, Supreme Court",,DEM,Amy Clark Meachum,11,27,44,82
Waller,103,"Chief Justice, Supreme Court",,DEM,Ballots Cast,15,32,57,104
Waller,103,"Chief Justice, Supreme Court",,DEM,Under Votes,9,9,17,35
Waller,103,"Chief Justice, Supreme Court",,DEM,Over Votes,0,0,0,0
Waller,103,"Justice, Supreme Court, Place 6 Unexpired Term",,DEM,Kathy Cheng,13,24,48,85
Waller,103,"Justice, Supreme Court, Place 6 Unexpired Term",,DEM,Larry Praeger,3,8,13,24
Waller,103,"Justice, Supreme Court, Place 6 Unexpired Term",,DEM,Ballots Cast,16,32,61,109
Waller,103,"Justice, Supreme Court, Place 6 Unexpired Term",,DEM,Under Votes,8,9,13,30
Waller,103,"Justice, Supreme Court, Place 6 Unexpired Term",,DEM,Over Votes,0,0,0,0
Waller,103,"Justice, Supreme Court, Place 7",,DEM,Staci Williams,15,24,39,78
Waller,103,"Justice, Supreme Court, Place 7",,DEM,Brandy Voss,2,10,17,29
Waller,103,"Justice, Supreme Court, Place 7",,DEM,Ballots Cast,17,34,56,107
Waller,103,"Justice, Supreme Court, Place 7",,DEM,Under Votes,7,7,18,32
Waller,103,"Justice, Supreme Court, Place 7",,DEM,Over Votes,0,0,0,0
Waller,103,"Justice, Supreme Court, Place 8",,DEM,Gisela D. Triana,8,15,39,62
Waller,103,"Justice, Supreme Court, Place 8",,DEM,Peter Kelly,7,17,16,40
Waller,103,"Justice, Supreme Court, Place 8",,DEM,Ballots Cast,15,32,55,102
Waller,103,"Justice, Supreme Court, Place 8",,DEM,Under Votes,8,9,19,36
Waller,103,"Justice, Supreme Court, Place 8",,DEM,Over Votes,1,0,0,1
Waller,103,"Judge, Court of Criminal Appeals, Place 3",,DEM,Elizabeth Davis Frizell,11,18,37,66
Waller,103,"Judge, Court of Criminal Appeals, Place 3",,DEM,William Pieratt Demond,0,4,9,13
Waller,103,"Judge, Court of Criminal Appeals, Place 3",,DEM,Dan Wood,6,9,10,25
Waller,103,"Judge, Court of Criminal Appeals, Place 3",,DEM,Ballots Cast,17,31,56,104
Waller,103,"Judge, Court of Criminal Appeals, Place 3",,DEM,Under Votes,7,10,18,35
Waller,103,"Judge, Court of Criminal Appeals, Place 3",,DEM,Over Votes,0,0,0,0
Waller,103,"Judge, Court of Criminal Appeals, Place 4",,DEM,Steven Miears,5,5,14,24
Waller,103,"Judge, Court of Criminal Appeals, Place 4",,DEM,Tina Clinton,11,26,43,80
Waller,103,"Judge, Court of Criminal Appeals, Place 4",,DEM,Ballots Cast,16,31,57,104
Waller,103,"Judge, Court of Criminal Appeals, Place 4",,DEM,Under Votes,8,10,17,35
Waller,103,"Judge, Court of Criminal Appeals, Place 4",,DEM,Over Votes,0,0,0,0
Waller,103,"Judge, Court of Criminal Appeals, Place 9",,DEM,Brandon Birmingham,15,32,51,98
Waller,103,"Judge, Court of Criminal Appeals, Place 9",,DEM,Ballots Cast,15,32,51,98
Waller,103,"Judge, Court of Criminal Appeals, Place 9",,DEM,Under Votes,9,9,23,41
Waller,103,"Judge, Court of Criminal Appeals, Place 9",,DEM,Over Votes,0,0,0,0
Waller,103,"Member, State Board of Education, District 10",,DEM,Stephen Wyman,3,3,9,15
Waller,103,"Member, State Board of Education, District 10",,DEM,Marsha Burnett-Webster,13,27,46,86
Waller,103,"Member, State Board of Education, District 10",,DEM,Ballots Cast,16,30,55,101
Waller,103,"Member, State Board of Education, District 10",,DEM,Under Votes,8,11,19,38
Waller,103,"Member, State Board of Education, District 10",,DEM,Over Votes,0,0,0,0
Waller,103,State Senate,18,DEM,Michael Antalan,15,30,51,96
Waller,103,State Senate,18,DEM,Ballots Cast,15,30,51,96
Waller,103,State Senate,18,DEM,Under Votes,9,11,23,43
Waller,103,State Senate,18,DEM,Over Votes,0,0,0,0
Waller,103,State Representative,3,DEM,Martin Shupp,15,30,47,92
Waller,103,State Representative,3,DEM,Ballots Cast,15,30,47,92
Waller,103,State Representative,3,DEM,Under Votes,9,11,27,47
Waller,103,State Representative,3,DEM,Over Votes,0,0,0,0
Waller,103,"Chief Justice, 14th Court of Appeals District",,DEM,Jane Robinson,13,27,41,81
Waller,103,"Chief Justice, 14th Court of Appeals District",,DEM,Jim Evans,3,3,13,19
Waller,103,"Chief Justice, 14th Court of Appeals District",,DEM,Ballots Cast,16,30,54,100
Waller,103,"Chief Justice, 14th Court of Appeals District",,DEM,Under Votes,8,11,20,39
Waller,103,"Chief Justice, 14th Court of Appeals District",,DEM,Over Votes,0,0,0,0
Waller,103,"Justice, 1st Court of Appeals District, Place 3",,DEM,Jim Sharp,7,10,15,32
Waller,103,"Justice, 1st Court of Appeals District, Place 3",,DEM,Dinesh Singhal,2,1,11,14
Waller,103,"Justice, 1st Court of Appeals District, Place 3",,DEM,Veronica Rivas-Molloy,7,19,30,56
Waller,103,"Justice, 1st Court of Appeals District, Place 3",,DEM,Ballots Cast,16,30,56,102
Waller,103,"Justice, 1st Court of Appeals District, Place 3",,DEM,Under Votes,8,11,18,37
Waller,103,"Justice, 1st Court of Appeals District, Place 3",,DEM,Over Votes,0,0,0,0
Waller,103,"Justice, 1st Court of Appeals District, Place 5",,DEM,Tim Hootman,9,10,21,40
Waller,103,"Justice, 1st Court of Appeals District, Place 5",,DEM,Amparo Monique Guerra,7,18,31,56
Waller,103,"Justice, 1st Court of Appeals District, Place 5",,DEM,Ballots Cast,16,28,52,96
Waller,103,"Justice, 1st Court of Appeals District, Place 5",,DEM,Under Votes,8,13,22,43
Waller,103,"Justice, 1st Court of Appeals District, Place 5",,DEM,Over Votes,0,0,0,0
Waller,103,"Justice, 14th Court of Appeals District, Place 7",,DEM,"Tamika ""Tami"" Craft",8,16,25,49
Waller,103,"Justice, 14th Court of Appeals District, Place 7",,DEM,Wally Kronzer,0,1,2,3
Waller,103,"Justice, 14th Court of Appeals District, Place 7",,DEM,V.R. Faulkner,0,3,3,6
Waller,103,"Justice, 14th Court of Appeals District, Place 7",,DEM,Cheri Thomas,6,7,12,25
Waller,103,"Justice, 14th Court of Appeals District, Place 7",,DEM,Dominic J. Merino,0,2,4,6
Waller,103,"Justice, 14th Court of Appeals District, Place 7",,DEM,Lennon C. Wright,1,3,7,11
Waller,103,"Justice, 14th Court of Appeals District, Place 7",,DEM,Ballots Cast,15,32,53,100
Waller,103,"Justice, 14th Court of Appeals District, Place 7",,DEM,Under Votes,9,9,21,39
Waller,103,"Justice, 14th Court of Appeals District, Place 7",,DEM,Over Votes,0,0,0,0
Waller,103,Sheriff,,DEM,Cedric D. Watson,19,36,51,106
Waller,103,Sheriff,,DEM,Ballots Cast,19,36,51,106
Waller,103,Sheriff,,DEM,Under Votes,5,5,23,33
Waller,103,Sheriff,,DEM,Over Votes,0,0,0,0
Waller,103,"County Commissioner, Precinct 1",,DEM,Jacqueline Reynolds,4,7,31,42
Waller,103,"County Commissioner, Precinct 1",,DEM,Mildred Jefferson,17,25,38,80
Waller,103,"County Commissioner, Precinct 1",,DEM,Ballots Cast,21,32,69,122
Waller,103,"County Commissioner, Precinct 1",,DEM,Under Votes,3,9,5,17
Waller,103,"County Commissioner, Precinct 1",,DEM,Over Votes,0,0,0,0
Waller,103,County Chairman,,DEM,Rosa Patlan Harris,21,32,53,106
Waller,103,County Chairman,,DEM,Ballots Cast,21,32,53,106
Waller,103,County Chairman,,DEM,Under Votes,3,9,21,33
Waller,103,County Chairman,,DEM,Over Votes,0,0,0,0
Waller,103,President,,REP,Donald J. Trump,12,126,79,217
Waller,103,President,,REP,Joe Walsh,0,3,0,3
Waller,103,President,,REP,Bob Ely,0,0,0,0
Waller,103,President,,REP,"Roque ""Rocky"" De La Fuente Guerra",0,1,0,1
Waller,103,President,,REP,Zoltan G. Istvan,0,0,0,0
Waller,103,President,,REP,Matthew John Matern,0,0,0,0
Waller,103,President,,REP,Bill Weld,0,0,0,0
Waller,103,President,,REP,Uncommitted,0,6,7,13
Waller,103,President,,REP,Ballots Cast,12,136,86,234
Waller,103,President,,REP,Under Votes,0,1,2,3
Waller,103,President,,REP,Over Votes,0,0,0,0
Waller,103,U.S. Senate,,REP,Dwayne Stovall,0,21,20,41
Waller,103,U.S. Senate,,REP,Mark Yancey,2,6,6,14
Waller,103,U.S. Senate,,REP,Virgil Bierschwale,0,1,0,1
Waller,103,U.S. Senate,,REP,John Anthony Castro,0,4,4,8
Waller,103,U.S. Senate,,REP,John Cornyn,10,94,52,156
Waller,103,U.S. Senate,,REP,Ballots Cast,12,126,82,220
Waller,103,U.S. Senate,,REP,Under Votes,0,11,6,17
Waller,103,U.S. Senate,,REP,Over Votes,0,0,0,0
Waller,103,U.S. House,10,REP,Michael McCaul,11,128,78,217
Waller,103,U.S. House,10,REP,Ballots Cast,11,128,78,217
Waller,103,U.S. House,10,REP,Under Votes,1,9,10,20
Waller,103,U.S. House,10,REP,Over Votes,0,0,0,0
Waller,103,Railroad Commissioner,,REP,Ryan Sitton,6,70,40,116
Waller,103,Railroad Commissioner,,REP,"James ""Jim"" Wright",5,42,30,77
Waller,103,Railroad Commissioner,,REP,Ballots Cast,11,112,70,193
Waller,103,Railroad Commissioner,,REP,Under Votes,1,25,18,44
Waller,103,Railroad Commissioner,,REP,Over Votes,0,0,0,0
Waller,103,"Chief Justice, Supreme Court",,REP,Nathan Hecht,11,114,73,198
Waller,103,"Chief Justice, Supreme Court",,REP,Ballots Cast,11,114,73,198
Waller,103,"Chief Justice, Supreme Court",,REP,Under Votes,1,23,15,39
Waller,103,"Chief Justice, Supreme Court",,REP,Over Votes,0,0,0,0
Waller,103,"Justice, Supreme Court, Place 6 Unexpired Term",,REP,Jane Bland,11,115,71,197
Waller,103,"Justice, Supreme Court, Place 6 Unexpired Term",,REP,Ballots Cast,11,115,71,197
Waller,103,"Justice, Supreme Court, Place 6 Unexpired Term",,REP,Under Votes,1,22,17,40
Waller,103,"Justice, Supreme Court, Place 6 Unexpired Term",,REP,Over Votes,0,0,0,0
Waller,103,"Justice, Supreme Court, Place 7",,REP,Jeff Boyd,11,111,71,193
Waller,103,"Justice, Supreme Court, Place 7",,REP,Ballots Cast,11,111,71,193
Waller,103,"Justice, Supreme Court, Place 7",,REP,Under Votes,1,26,17,44
Waller,103,"Justice, Supreme Court, Place 7",,REP,Over Votes,0,0,0,0
Waller,103,"Justice, Supreme Court, Place 8",,REP,Brett Busby,11,110,72,193
Waller,103,"Justice, Supreme Court, Place 8",,REP,Ballots Cast,11,110,72,193
Waller,103,"Justice, Supreme Court, Place 8",,REP,Under Votes,1,27,16,44
Waller,103,"Justice, Supreme Court, Place 8",,REP,Over Votes,0,0,0,0
Waller,103,"Judge, Court of Criminal Appeals, Place 3",,REP,Gina Parker,3,44,33,80
Waller,103,"Judge, Court of Criminal Appeals, Place 3",,REP,Bert Richardson,7,63,35,105
Waller,103,"Judge, Court of Criminal Appeals, Place 3",,REP,Ballots Cast,10,107,68,185
Waller,103,"Judge, Court of Criminal Appeals, Place 3",,REP,Under Votes,2,30,20,52
Waller,103,"Judge, Court of Criminal Appeals, Place 3",,REP,Over Votes,0,0,0,0
Waller,103,"Judge, Court of Criminal Appeals, Place 4",,REP,Kevin Patrick Yeary,11,111,69,191
Waller,103,"Judge, Court of Criminal Appeals, Place 4",,REP,Ballots Cast,11,111,69,191
Waller,103,"Judge, Court of Criminal Appeals, Place 4",,REP,Under Votes,1,26,19,46
Waller,103,"Judge, Court of Criminal Appeals, Place 4",,REP,Over Votes,0,0,0,0
Waller,103,"Judge, Court of Criminal Appeals, Place 9",,REP,David Newell,11,113,68,192
Waller,103,"Judge, Court of Criminal Appeals, Place 9",,REP,Ballots Cast,11,113,68,192
Waller,103,"Judge, Court of Criminal Appeals, Place 9",,REP,Under Votes,1,24,20,45
Waller,103,"Judge, Court of Criminal Appeals, Place 9",,REP,Over Votes,0,0,0,0
Waller,103,"Member, State Board of Education, District 10",,REP,Tom Maynard,11,109,69,189
Waller,103,"Member, State Board of Education, District 10",,REP,Ballots Cast,11,109,69,189
Waller,103,"Member, State Board of Education, District 10",,REP,Under Votes,1,28,19,48
Waller,103,"Member, State Board of Education, District 10",,REP,Over Votes,0,0,0,0
Waller,103,State Senate,18,REP,Lois W. Kolkhorst,11,128,74,213
Waller,103,State Senate,18,REP,Ballots Cast,11,128,74,213
Waller,103,State Senate,18,REP,Under Votes,1,9,14,24
Waller,103,State Senate,18,REP,Over Votes,0,0,0,0
Waller,103,State Representative,3,REP,Cecil Bell Jr,11,122,73,206
Waller,103,State Representative,3,REP,Ballots Cast,11,122,73,206
Waller,103,State Representative,3,REP,Under Votes,1,15,15,31
Waller,103,State Representative,3,REP,Over Votes,0,0,0,0
Waller,103,"Chief Justice, 14th Court of Appeals District",,REP,Tracy Elizabeth Christopher,11,112,70,193
Waller,103,"Chief Justice, 14th Court of Appeals District",,REP,Ballots Cast,11,112,70,193
Waller,103,"Chief Justice, 14th Court of Appeals District",,REP,Under Votes,1,25,18,44
Waller,103,"Chief Justice, 14th Court of Appeals District",,REP,Over Votes,0,0,0,0
Waller,103,"Justice, 1st Court of Appeals District, Place 3",,REP,Russell Lloyd,10,112,68,190
Waller,103,"Justice, 1st Court of Appeals District, Place 3",,REP,Ballots Cast,10,112,68,190
Waller,103,"Justice, 1st Court of Appeals District, Place 3",,REP,Under Votes,2,25,20,47
Waller,103,"Justice, 1st Court of Appeals District, Place 3",,REP,Over Votes,0,0,0,0
Waller,103,"Justice, 1st Court of Appeals District, Place 5",,REP,Chad Bridges,3,44,24,71
Waller,103,"Justice, 1st Court of Appeals District, Place 5",,REP,James Lombardino,0,12,8,20
Waller,103,"Justice, 1st Court of Appeals District, Place 5",,REP,Levi J. Benton,0,10,10,20
Waller,103,"Justice, 1st Court of Appeals District, Place 5",,REP,Terry Adams,5,35,25,65
Waller,103,"Justice, 1st Court of Appeals District, Place 5",,REP,Ballots Cast,8,101,67,176
Waller,103,"Justice, 1st Court of Appeals District, Place 5",,REP,Under Votes,4,36,21,61
Waller,103,"Justice, 1st Court of Appeals District, Place 5",,REP,Over Votes,0,0,0,0
Waller,103,"Justice, 14th Court of Appeals District, Place 7",,REP,Ken Wise,10,110,70,190
Waller,103,"Justice, 14th Court of Appeals District, Place 7",,REP,Ballots Cast,10,110,70,190
Waller,103,"Justice, 14th Court of Appeals District, Place 7",,REP,Under Votes,2,27,18,47
Waller,103,"Justice, 14th Court of Appeals District, Place 7",,REP,Over Votes,0,0,0,0
Waller,103,"District Judge, 506th Judicial District",,REP,Gary W. Chaney,10,120,72,202
Waller,103,"District Judge, 506th Judicial District",,REP,Ballots Cast,10,120,72,202
Waller,103,"District Judge, 506th Judicial District",,REP,Under Votes,2,17,16,35
Waller,103,"District Judge, 506th Judicial District",,REP,Over Votes,0,0,0,0
Waller,103,Sheriff,,REP,Dan Porter,0,7,2,9
Waller,103,Sheriff,,REP,R. Glenn Smith,8,73,57,138
Waller,103,Sheriff,,REP,Troy Guidry,4,54,27,85
Waller,103,Sheriff,,REP,Ballots Cast,12,134,86,232
Waller,103,Sheriff,,REP,Under Votes,0,3,2,5
Waller,103,Sheriff,,REP,Over Votes,0,0,0,0
Waller,103,County Tax Assessor-Collector,,REP,Ellen Contreras Shelburne,9,81,52,142
Waller,103,County Tax Assessor-Collector,,REP,Carolyn Miedke,3,54,33,90
Waller,103,County Tax Assessor-Collector,,REP,Ballots Cast,12,135,85,232
Waller,103,County Tax Assessor-Collector,,REP,Under Votes,0,2,3,5
Waller,103,County Tax Assessor-Collector,,REP,Over Votes,0,0,0,0
Waller,103,"County Commissioner, Precinct 1",,REP,John Allen Amsler,12,115,74,201
Waller,103,"County Commissioner, Precinct 1",,REP,Ballots Cast,12,115,74,201
Waller,103,"County Commissioner, Precinct 1",,REP,Under Votes,0,22,14,36
Waller,103,"County Commissioner, Precinct 1",,REP,Over Votes,0,0,0,0
Waller,103,"Constable, Precinct 1",,REP,Bo Hashaw,12,122,76,210
Waller,103,"Constable, Precinct 1",,REP,Ballots Cast,12,122,76,210
Waller,103,"Constable, Precinct 1",,REP,Under Votes,0,15,12,27
Waller,103,"Constable, Precinct 1",,REP,Over Votes,0,0,0,0
Waller,103,County Chairman,,REP,David W. Luther,9,110,70,189
Waller,103,County Chairman,,REP,Ballots Cast,9,110,70,189
Waller,103,County Chairman,,REP,Under Votes,3,27,18,48
Waller,103,County Chairman,,REP,Over Votes,0,0,0,0
Waller,103,Proposition #1,,DEM,Yes,24,38,64,126
Waller,103,Proposition #1,,DEM,No,0,0,2,2
Waller,103,Proposition #1,,DEM,Ballots Cast,24,38,66,128
Waller,103,Proposition #1,,DEM,Under Votes,0,3,8,11
Waller,103,Proposition #1,,DEM,Over Votes,0,0,0,0
Waller,103,Proposition #2,,DEM,Yes,23,38,67,128
Waller,103,Proposition #2,,DEM,No,0,0,0,0
Waller,103,Proposition #2,,DEM,Ballots Cast,23,38,67,128
Waller,103,Proposition #2,,DEM,Under Votes,1,3,7,11
Waller,103,Proposition #2,,DEM,Over Votes,0,0,0,0
Waller,103,Proposition #3,,DEM,Yes,24,37,64,125
Waller,103,Proposition #3,,DEM,No,0,1,1,2
Waller,103,Proposition #3,,DEM,Ballots Cast,24,38,65,127
Waller,103,Proposition #3,,DEM,Under Votes,0,3,9,12
Waller,103,Proposition #3,,DEM,Over Votes,0,0,0,0
Waller,103,Proposition #4,,DEM,Yes,24,38,66,128
Waller,103,Proposition #4,,DEM,No,0,0,2,2
Waller,103,Proposition #4,,DEM,Ballots Cast,24,38,68,130
Waller,103,Proposition #4,,DEM,Under Votes,0,3,6,9
Waller,103,Proposition #4,,DEM,Over Votes,0,0,0,0
Waller,103,Proposition #5,,DEM,Yes,23,37,65,125
Waller,103,Proposition #5,,DEM,No,0,1,1,2
Waller,103,Proposition #5,,DEM,Ballots Cast,23,38,66,127
Waller,103,Proposition #5,,DEM,Under Votes,1,3,8,12
Waller,103,Proposition #5,,DEM,Over Votes,0,0,0,0
Waller,103,Proposition #6,,DEM,Yes,24,37,66,127
Waller,103,Proposition #6,,DEM,No,0,0,1,1
Waller,103,Proposition #6,,DEM,Ballots Cast,24,37,67,128
Waller,103,Proposition #6,,DEM,Under Votes,0,4,7,11
Waller,103,Proposition #6,,DEM,Over Votes,0,0,0,0
Waller,103,Proposition #7,,DEM,Yes,24,38,67,129
Waller,103,Proposition #7,,DEM,No,0,0,0,0
Waller,103,Proposition #7,,DEM,Ballots Cast,24,38,67,129
Waller,103,Proposition #7,,DEM,Under Votes,0,3,7,10
Waller,103,Proposition #7,,DEM,Over Votes,0,0,0,0
Waller,103,Proposition #8,,DEM,Yes,23,37,66,126
Waller,103,Proposition #8,,DEM,No,1,1,2,4
Waller,103,Proposition #8,,DEM,Ballots Cast,24,38,68,130
Waller,103,Proposition #8,,DEM,Under Votes,0,3,6,9
Waller,103,Proposition #8,,DEM,Over Votes,0,0,0,0
Waller,103,Proposition #9,,DEM,Yes,24,38,64,126
Waller,103,Proposition #9,,DEM,No,0,0,2,2
Waller,103,Proposition #9,,DEM,Ballots Cast,24,38,66,128
Waller,103,Proposition #9,,DEM,Under Votes,0,3,8,11
Waller,103,Proposition #9,,DEM,Over Votes,0,0,0,0
Waller,103,Proposition #10,,DEM,Yes,24,37,65,126
Waller,103,Proposition #10,,DEM,No,0,1,2,3
Waller,103,Proposition #10,,DEM,Ballots Cast,24,38,67,129
Waller,103,Proposition #10,,DEM,Under Votes,0,3,7,10
Waller,103,Proposition #10,,DEM,Over Votes,0,0,0,0
Waller,103,Proposition #11,,DEM,Yes,20,34,61,115
Waller,103,Proposition #11,,DEM,No,4,3,5,12
Waller,103,Proposition #11,,DEM,Ballots Cast,24,37,66,127
Waller,103,Proposition #11,,DEM,Under Votes,0,4,8,12
Waller,103,Proposition #11,,DEM,Over Votes,0,0,0,0
Waller,103,Proposition 1,,REP,Yes,8,117,83,208
Waller,103,Proposition 1,,REP,No,3,18,5,26
Waller,103,Proposition 1,,REP,Ballots Cast,11,135,88,234
Waller,103,Proposition 1,,REP,Under Votes,0,2,0,2
Waller,103,Proposition 1,,REP,Over Votes,1,0,0,1
Waller,103,Proposition 2,,REP,Yes,11,115,77,203
Waller,103,Proposition 2,,REP,No,1,20,11,32
Waller,103,Proposition 2,,REP,Ballots Cast,12,135,88,235
Waller,103,Proposition 2,,REP,Under Votes,0,2,0,2
Waller,103,Proposition 2,,REP,Over Votes,0,0,0,0
Waller,103,Proposition 3,,REP,Yes,12,121,83,216
Waller,103,Proposition 3,,REP,No,0,11,5,16
Waller,103,Proposition 3,,REP,Ballots Cast,12,132,88,232
Waller,103,Proposition 3,,REP,Under Votes,0,5,0,5
Waller,103,Proposition 3,,REP,Over Votes,0,0,0,0
Waller,103,Proposition 4,,REP,Yes,12,125,79,216
Waller,103,Proposition 4,,REP,No,0,9,9,18
Waller,103,Proposition 4,,REP,Ballots Cast,12,134,88,234
Waller,103,Proposition 4,,REP,Under Votes,0,3,0,3
Waller,103,Proposition 4,,REP,Over Votes,0,0,0,0
Waller,103,Proposition 5,,REP,Yes,12,116,77,205
Waller,103,Proposition 5,,REP,No,0,15,11,26
Waller,103,Proposition 5,,REP,Ballots Cast,12,131,88,231
Waller,103,Proposition 5,,REP,Under Votes,0,6,0,6
Waller,103,Proposition 5,,REP,Over Votes,0,0,0,0
Waller,103,Proposition 6,,REP,Yes,12,120,84,216
Waller,103,Proposition 6,,REP,No,0,9,2,11
Waller,103,Proposition 6,,REP,Ballots Cast,12,129,86,227
Waller,103,Proposition 6,,REP,Under Votes,0,8,2,10
Waller,103,Proposition 6,,REP,Over Votes,0,0,0,0
Waller,103,Proposition 7,,REP,Yes,12,127,84,223
Waller,103,Proposition 7,,REP,No,0,5,2,7
Waller,103,Proposition 7,,REP,Ballots Cast,12,132,86,230
Waller,103,Proposition 7,,REP,Under Votes,0,5,2,7
Waller,103,Proposition 7,,REP,Over Votes,0,0,0,0
Waller,103,Proposition 8,,REP,Yes,12,129,84,225
Waller,103,Proposition 8,,REP,No,0,2,2,4
Waller,103,Proposition 8,,REP,Ballots Cast,12,131,86,229
Waller,103,Proposition 8,,REP,Under Votes,0,6,2,8
Waller,103,Proposition 8,,REP,Over Votes,0,0,0,0
Waller,103,Proposition 9,,REP,Yes,10,128,83,221
Waller,103,Proposition 9,,REP,No,1,6,2,9
Waller,103,Proposition 9,,REP,Ballots Cast,11,134,85,230
Waller,103,Proposition 9,,REP,Under Votes,1,3,3,7
Waller,103,Proposition 9,,REP,Over Votes,0,0,0,0
Waller,103,Proposition 10,,REP,Yes,12,124,79,215
Waller,103,Proposition 10,,REP,No,0,7,5,12
Waller,103,Proposition 10,,REP,Ballots Cast,12,131,84,227
Waller,103,Proposition 10,,REP,Under Votes,0,6,4,10
Waller,103,Proposition 10,,REP,Over Votes,0,0,0,0
Waller,104,President,,DEM,Michael Bennet,0,0,1,1
Waller,104,President,,DEM,Marianne Williamson,0,0,0,0
Waller,104,President,,DEM,Cory Booker,0,0,1,1
Waller,104,President,,DEM,Bernie Sanders,1,1,8,10
Waller,104,President,,DEM,Tulsi Gabbard,0,0,0,0
Waller,104,President,,DEM,Deval Patrick,0,1,0,1
Waller,104,President,,DEM,Amy Klobuchar,0,0,0,0
Waller,104,President,,DEM,Julián Castro,0,0,0,0
Waller,104,President,,DEM,Elizabeth Warren,0,3,3,6
Waller,104,President,,DEM,John K. Delaney,0,0,0,0
Waller,104,President,,DEM,Robby Wells,0,0,0,0
Waller,104,President,,DEM,"Roque ""Rocky"" De La Fuente",0,0,0,0
Waller,104,President,,DEM,Andrew Yang,0,0,0,0
Waller,104,President,,DEM,Joseph R. Biden,1,5,18,24
Waller,104,President,,DEM,Michael R. Bloomberg,1,8,5,14
Waller,104,President,,DEM,Tom Steyer,0,0,0,0
Waller,104,President,,DEM,Pete Buttigieg,1,1,0,2
Waller,104,President,,DEM,Ballots Cast,4,19,36,59
Waller,104,President,,DEM,Under Votes,0,2,1,3
Waller,104,President,,DEM,Over Votes,0,0,0,0
Waller,104,U.S. Senate,,DEM,Royce West,1,5,9,15
Waller,104,U.S. Senate,,DEM,"Annie ""Mamá"" Garcia",0,0,2,2
Waller,104,U.S. Senate,,DEM,D. R. Hunter,0,0,2,2
Waller,104,U.S. Senate,,DEM,Sema Hernandez,1,2,2,5
Waller,104,U.S. Senate,,DEM,Adrian Ocegueda,0,0,0,0
Waller,104,U.S. Senate,,DEM,Chris Bell,1,2,10,13
Waller,104,U.S. Senate,,DEM,Cristina Tzintzun Ramirez,0,1,2,3
Waller,104,U.S. Senate,,DEM,Jack Daniel Foster Jr,0,1,0,1
Waller,104,U.S. Senate,,DEM,Amanda K. Edwards,0,0,2,2
Waller,104,U.S. Senate,,DEM,Victor Hugo Harris,0,0,0,0
Waller,104,U.S. Senate,,DEM,"Mary ""MJ"" Hegar",0,7,2,9
Waller,104,U.S. Senate,,DEM,Michael Cooper,0,0,1,1
Waller,104,U.S. Senate,,DEM,Ballots Cast,3,18,32,53
Waller,104,U.S. Senate,,DEM,Under Votes,1,3,5,9
Waller,104,U.S. Senate,,DEM,Over Votes,0,0,0,0
Waller,104,U.S. House,10,DEM,Mike Siegel,3,14,16,33
Waller,104,U.S. House,10,DEM,Shannon Hutcheson,0,2,11,13
Waller,104,U.S. House,10,DEM,Pritesh Gandhi,0,3,4,7
Waller,104,U.S. House,10,DEM,Ballots Cast,3,19,31,53
Waller,104,U.S. House,10,DEM,Under Votes,1,2,6,9
Waller,104,U.S. House,10,DEM,Over Votes,0,0,0,0
Waller,104,Railroad Commissioner,,DEM,"Roberto R. ""Beto"" Alonzo",3,6,9,18
Waller,104,Railroad Commissioner,,DEM,Chrysta Castañeda,0,4,5,9
Waller,104,Railroad Commissioner,,DEM,Mark Watson,0,5,8,13
Waller,104,Railroad Commissioner,,DEM,Kelly Stone,0,3,6,9
Waller,104,Railroad Commissioner,,DEM,Ballots Cast,3,18,28,49
Waller,104,Railroad Commissioner,,DEM,Under Votes,1,3,9,13
Waller,104,Railroad Commissioner,,DEM,Over Votes,0,0,0,0
Waller,104,"Chief Justice, Supreme Court",,DEM,Jerry Zimmerer,2,4,6,12
Waller,104,"Chief Justice, Supreme Court",,DEM,Amy Clark Meachum,1,15,24,40
Waller,104,"Chief Justice, Supreme Court",,DEM,Ballots Cast,3,19,30,52
Waller,104,"Chief Justice, Supreme Court",,DEM,Under Votes,1,2,7,10
Waller,104,"Chief Justice, Supreme Court",,DEM,Over Votes,0,0,0,0
Waller,104,"Justice, Supreme Court, Place 6 Unexpired Term",,DEM,Kathy Cheng,2,15,20,37
Waller,104,"Justice, Supreme Court, Place 6 Unexpired Term",,DEM,Larry Praeger,1,4,9,14
Waller,104,"Justice, Supreme Court, Place 6 Unexpired Term",,DEM,Ballots Cast,3,19,29,51
Waller,104,"Justice, Supreme Court, Place 6 Unexpired Term",,DEM,Under Votes,1,2,8,11
Waller,104,"Justice, Supreme Court, Place 6 Unexpired Term",,DEM,Over Votes,0,0,0,0
Waller,104,"Justice, Supreme Court, Place 7",,DEM,Staci Williams,3,16,25,44
Waller,104,"Justice, Supreme Court, Place 7",,DEM,Brandy Voss,0,3,6,9
Waller,104,"Justice, Supreme Court, Place 7",,DEM,Ballots Cast,3,19,31,53
Waller,104,"Justice, Supreme Court, Place 7",,DEM,Under Votes,1,2,6,9
Waller,104,"Justice, Supreme Court, Place 7",,DEM,Over Votes,0,0,0,0
Waller,104,"Justice, Supreme Court, Place 8",,DEM,Gisela D. Triana,1,13,23,37
Waller,104,"Justice, Supreme Court, Place 8",,DEM,Peter Kelly,2,5,7,14
Waller,104,"Justice, Supreme Court, Place 8",,DEM,Ballots Cast,3,18,30,51
Waller,104,"Justice, Supreme Court, Place 8",,DEM,Under Votes,1,3,7,11
Waller,104,"Justice, Supreme Court, Place 8",,DEM,Over Votes,0,0,0,0
Waller,104,"Judge, Court of Criminal Appeals, Place 3",,DEM,Elizabeth Davis Frizell,2,13,19,34
Waller,104,"Judge, Court of Criminal Appeals, Place 3",,DEM,William Pieratt Demond,1,3,5,9
Waller,104,"Judge, Court of Criminal Appeals, Place 3",,DEM,Dan Wood,0,3,6,9
Waller,104,"Judge, Court of Criminal Appeals, Place 3",,DEM,Ballots Cast,3,19,30,52
Waller,104,"Judge, Court of Criminal Appeals, Place 3",,DEM,Under Votes,1,2,7,10
Waller,104,"Judge, Court of Criminal Appeals, Place 3",,DEM,Over Votes,0,0,0,0
Waller,104,"Judge, Court of Criminal Appeals, Place 4",,DEM,Steven Miears,1,7,4,12
Waller,104,"Judge, Court of Criminal Appeals, Place 4",,DEM,Tina Clinton,2,12,25,39
Waller,104,"Judge, Court of Criminal Appeals, Place 4",,DEM,Ballots Cast,3,19,29,51
Waller,104,"Judge, Court of Criminal Appeals, Place 4",,DEM,Under Votes,1,2,8,11
Waller,104,"Judge, Court of Criminal Appeals, Place 4",,DEM,Over Votes,0,0,0,0
Waller,104,"Judge, Court of Criminal Appeals, Place 9",,DEM,Brandon Birmingham,3,17,25,45
Waller,104,"Judge, Court of Criminal Appeals, Place 9",,DEM,Ballots Cast,3,17,25,45
Waller,104,"Judge, Court of Criminal Appeals, Place 9",,DEM,Under Votes,1,4,12,17
Waller,104,"Judge, Court of Criminal Appeals, Place 9",,DEM,Over Votes,0,0,0,0
Waller,104,"Member, State Board of Education, District 10",,DEM,Stephen Wyman,0,4,5,9
Waller,104,"Member, State Board of Education, District 10",,DEM,Marsha Burnett-Webster,3,14,23,40
Waller,104,"Member, State Board of Education, District 10",,DEM,Ballots Cast,3,18,28,49
Waller,104,"Member, State Board of Education, District 10",,DEM,Under Votes,1,3,9,13
Waller,104,"Member, State Board of Education, District 10",,DEM,Over Votes,0,0,0,0
Waller,104,State Senate,18,DEM,Michael Antalan,3,17,25,45
Waller,104,State Senate,18,DEM,Ballots Cast,3,17,25,45
Waller,104,State Senate,18,DEM,Under Votes,1,4,12,17
Waller,104,State Senate,18,DEM,Over Votes,0,0,0,0
Waller,104,State Representative,3,DEM,Martin Shupp,3,17,25,45
Waller,104,State Representative,3,DEM,Ballots Cast,3,17,25,45
Waller,104,State Representative,3,DEM,Under Votes,1,4,12,17
Waller,104,State Representative,3,DEM,Over Votes,0,0,0,0
Waller,104,"Chief Justice, 14th Court of Appeals District",,DEM,Jane Robinson,2,17,23,42
Waller,104,"Chief Justice, 14th Court of Appeals District",,DEM,Jim Evans,0,1,5,6
Waller,104,"Chief Justice, 14th Court of Appeals District",,DEM,Ballots Cast,2,18,28,48
Waller,104,"Chief Justice, 14th Court of Appeals District",,DEM,Under Votes,2,3,9,14
Waller,104,"Chief Justice, 14th Court of Appeals District",,DEM,Over Votes,0,0,0,0
Waller,104,"Justice, 1st Court of Appeals District, Place 3",,DEM,Jim Sharp,3,4,6,13
Waller,104,"Justice, 1st Court of Appeals District, Place 3",,DEM,Dinesh Singhal,0,7,10,17
Waller,104,"Justice, 1st Court of Appeals District, Place 3",,DEM,Veronica Rivas-Molloy,0,7,13,20
Waller,104,"Justice, 1st Court of Appeals District, Place 3",,DEM,Ballots Cast,3,18,29,50
Waller,104,"Justice, 1st Court of Appeals District, Place 3",,DEM,Under Votes,1,3,8,12
Waller,104,"Justice, 1st Court of Appeals District, Place 3",,DEM,Over Votes,0,0,0,0
Waller,104,"Justice, 1st Court of Appeals District, Place 5",,DEM,Tim Hootman,3,7,12,22
Waller,104,"Justice, 1st Court of Appeals District, Place 5",,DEM,Amparo Monique Guerra,0,11,14,25
Waller,104,"Justice, 1st Court of Appeals District, Place 5",,DEM,Ballots Cast,3,18,26,47
Waller,104,"Justice, 1st Court of Appeals District, Place 5",,DEM,Under Votes,1,3,11,15
Waller,104,"Justice, 1st Court of Appeals District, Place 5",,DEM,Over Votes,0,0,0,0
Waller,104,"Justice, 14th Court of Appeals District, Place 7",,DEM,"Tamika ""Tami"" Craft",0,8,11,19
Waller,104,"Justice, 14th Court of Appeals District, Place 7",,DEM,Wally Kronzer,0,0,4,4
Waller,104,"Justice, 14th Court of Appeals District, Place 7",,DEM,V.R. Faulkner,0,1,2,3
Waller,104,"Justice, 14th Court of Appeals District, Place 7",,DEM,Cheri Thomas,3,4,4,11
Waller,104,"Justice, 14th Court of Appeals District, Place 7",,DEM,Dominic J. Merino,0,2,2,4
Waller,104,"Justice, 14th Court of Appeals District, Place 7",,DEM,Lennon C. Wright,0,2,4,6
Waller,104,"Justice, 14th Court of Appeals District, Place 7",,DEM,Ballots Cast,3,17,27,47
Waller,104,"Justice, 14th Court of Appeals District, Place 7",,DEM,Under Votes,1,4,10,15
Waller,104,"Justice, 14th Court of Appeals District, Place 7",,DEM,Over Votes,0,0,0,0
Waller,104,Sheriff,,DEM,Cedric D. Watson,2,16,28,46
Waller,104,Sheriff,,DEM,Ballots Cast,2,16,28,46
Waller,104,Sheriff,,DEM,Under Votes,2,5,9,16
Waller,104,Sheriff,,DEM,Over Votes,0,0,0,0
Waller,104,"County Commissioner, Precinct 1",,DEM,Jacqueline Reynolds,1,14,14,29
Waller,104,"County Commissioner, Precinct 1",,DEM,Mildred Jefferson,2,4,16,22
Waller,104,"County Commissioner, Precinct 1",,DEM,Ballots Cast,3,18,30,51
Waller,104,"County Commissioner, Precinct 1",,DEM,Under Votes,1,3,7,11
Waller,104,"County Commissioner, Precinct 1",,DEM,Over Votes,0,0,0,0
Waller,104,County Chairman,,DEM,Rosa Patlan Harris,3,15,27,45
Waller,104,County Chairman,,DEM,Ballots Cast,3,15,27,45
Waller,104,County Chairman,,DEM,Under Votes,1,6,10,17
Waller,104,County Chairman,,DEM,Over Votes,0,0,0,0
Waller,104,President,,REP,Donald J. Trump,4,70,61,135
Waller,104,President,,REP,Joe Walsh,0,0,0,0
Waller,104,President,,REP,Bob Ely,0,0,0,0
Waller,104,President,,REP,"Roque ""Rocky"" De La Fuente Guerra",0,0,0,0
Waller,104,President,,REP,Zoltan G. Istvan,0,0,0,0
Waller,104,President,,REP,Matthew John Matern,0,0,0,0
Waller,104,President,,REP,Bill Weld,0,1,0,1
Waller,104,President,,REP,Uncommitted,0,3,1,4
Waller,104,President,,REP,Ballots Cast,4,74,62,140
Waller,104,President,,REP,Under Votes,0,0,1,1
Waller,104,President,,REP,Over Votes,0,0,0,0
Waller,104,U.S. Senate,,REP,Dwayne Stovall,0,13,16,29
Waller,104,U.S. Senate,,REP,Mark Yancey,0,3,7,10
Waller,104,U.S. Senate,,REP,Virgil Bierschwale,0,0,0,0
Waller,104,U.S. Senate,,REP,John Anthony Castro,0,2,2,4
Waller,104,U.S. Senate,,REP,John Cornyn,4,50,33,87
Waller,104,U.S. Senate,,REP,Ballots Cast,4,68,58,130
Waller,104,U.S. Senate,,REP,Under Votes,0,6,5,11
Waller,104,U.S. Senate,,REP,Over Votes,0,0,0,0
Waller,104,U.S. House,10,REP,Michael McCaul,4,69,54,127
Waller,104,U.S. House,10,REP,Ballots Cast,4,69,54,127
Waller,104,U.S. House,10,REP,Under Votes,0,5,9,14
Waller,104,U.S. House,10,REP,Over Votes,0,0,0,0
Waller,104,Railroad Commissioner,,REP,Ryan Sitton,3,41,27,71
Waller,104,Railroad Commissioner,,REP,"James ""Jim"" Wright",0,24,24,48
Waller,104,Railroad Commissioner,,REP,Ballots Cast,3,65,51,119
Waller,104,Railroad Commissioner,,REP,Under Votes,1,9,12,22
Waller,104,Railroad Commissioner,,REP,Over Votes,0,0,0,0
Waller,104,"Chief Justice, Supreme Court",,REP,Nathan Hecht,4,63,51,118
Waller,104,"Chief Justice, Supreme Court",,REP,Ballots Cast,4,63,51,118
Waller,104,"Chief Justice, Supreme Court",,REP,Under Votes,0,11,12,23
Waller,104,"Chief Justice, Supreme Court",,REP,Over Votes,0,0,0,0
Waller,104,"Justice, Supreme Court, Place 6 Unexpired Term",,REP,Jane Bland,4,60,50,114
Waller,104,"Justice, Supreme Court, Place 6 Unexpired Term",,REP,Ballots Cast,4,60,50,114
Waller,104,"Justice, Supreme Court, Place 6 Unexpired Term",,REP,Under Votes,0,14,13,27
Waller,104,"Justice, Supreme Court, Place 6 Unexpired Term",,REP,Over Votes,0,0,0,0
Waller,104,"Justice, Supreme Court, Place 7",,REP,Jeff Boyd,4,59,50,113
Waller,104,"Justice, Supreme Court, Place 7",,REP,Ballots Cast,4,59,50,113
Waller,104,"Justice, Supreme Court, Place 7",,REP,Under Votes,0,15,13,28
Waller,104,"Justice, Supreme Court, Place 7",,REP,Over Votes,0,0,0,0
Waller,104,"Justice, Supreme Court, Place 8",,REP,Brett Busby,4,62,48,114
Waller,104,"Justice, Supreme Court, Place 8",,REP,Ballots Cast,4,62,48,114
Waller,104,"Justice, Supreme Court, Place 8",,REP,Under Votes,0,12,15,27
Waller,104,"Justice, Supreme Court, Place 8",,REP,Over Votes,0,0,0,0
Waller,104,"Judge, Court of Criminal Appeals, Place 3",,REP,Gina Parker,1,28,26,55
Waller,104,"Judge, Court of Criminal Appeals, Place 3",,REP,Bert Richardson,3,36,25,64
Waller,104,"Judge, Court of Criminal Appeals, Place 3",,REP,Ballots Cast,4,64,51,119
Waller,104,"Judge, Court of Criminal Appeals, Place 3",,REP,Under Votes,0,10,12,22
Waller,104,"Judge, Court of Criminal Appeals, Place 3",,REP,Over Votes,0,0,0,0
Waller,104,"Judge, Court of Criminal Appeals, Place 4",,REP,Kevin Patrick Yeary,4,59,50,113
Waller,104,"Judge, Court of Criminal Appeals, Place 4",,REP,Ballots Cast,4,59,50,113
Waller,104,"Judge, Court of Criminal Appeals, Place 4",,REP,Under Votes,0,15,13,28
Waller,104,"Judge, Court of Criminal Appeals, Place 4",,REP,Over Votes,0,0,0,0
Waller,104,"Judge, Court of Criminal Appeals, Place 9",,REP,David Newell,4,60,49,113
Waller,104,"Judge, Court of Criminal Appeals, Place 9",,REP,Ballots Cast,4,60,49,113
Waller,104,"Judge, Court of Criminal Appeals, Place 9",,REP,Under Votes,0,14,14,28
Waller,104,"Judge, Court of Criminal Appeals, Place 9",,REP,Over Votes,0,0,0,0
Waller,104,"Member, State Board of Education, District 10",,REP,Tom Maynard,3,61,50,114
Waller,104,"Member, State Board of Education, District 10",,REP,Ballots Cast,3,61,50,114
Waller,104,"Member, State Board of Education, District 10",,REP,Under Votes,1,13,13,27
Waller,104,"Member, State Board of Education, District 10",,REP,Over Votes,0,0,0,0
Waller,104,State Senate,18,REP,Lois W. Kolkhorst,4,67,51,122
Waller,104,State Senate,18,REP,Ballots Cast,4,67,51,122
Waller,104,State Senate,18,REP,Under Votes,0,7,12,19
Waller,104,State Senate,18,REP,Over Votes,0,0,0,0
Waller,104,State Representative,3,REP,Cecil Bell Jr,4,67,51,122
Waller,104,State Representative,3,REP,Ballots Cast,4,67,51,122
Waller,104,State Representative,3,REP,Under Votes,0,7,12,19
Waller,104,State Representative,3,REP,Over Votes,0,0,0,0
Waller,104,"Chief Justice, 14th Court of Appeals District",,REP,Tracy Elizabeth Christopher,4,59,47,110
Waller,104,"Chief Justice, 14th Court of Appeals District",,REP,Ballots Cast,4,59,47,110
Waller,104,"Chief Justice, 14th Court of Appeals District",,REP,Under Votes,0,15,16,31
Waller,104,"Chief Justice, 14th Court of Appeals District",,REP,Over Votes,0,0,0,0
Waller,104,"Justice, 1st Court of Appeals District, Place 3",,REP,Russell Lloyd,4,60,48,112
Waller,104,"Justice, 1st Court of Appeals District, Place 3",,REP,Ballots Cast,4,60,48,112
Waller,104,"Justice, 1st Court of Appeals District, Place 3",,REP,Under Votes,0,14,15,29
Waller,104,"Justice, 1st Court of Appeals District, Place 3",,REP,Over Votes,0,0,0,0
Waller,104,"Justice, 1st Court of Appeals District, Place 5",,REP,Chad Bridges,2,21,28,51
Waller,104,"Justice, 1st Court of Appeals District, Place 5",,REP,James Lombardino,0,4,1,5
Waller,104,"Justice, 1st Court of Appeals District, Place 5",,REP,Levi J. Benton,0,15,9,24
Waller,104,"Justice, 1st Court of Appeals District, Place 5",,REP,Terry Adams,0,23,7,30
Waller,104,"Justice, 1st Court of Appeals District, Place 5",,REP,Ballots Cast,2,63,45,110
Waller,104,"Justice, 1st Court of Appeals District, Place 5",,REP,Under Votes,2,11,18,31
Waller,104,"Justice, 1st Court of Appeals District, Place 5",,REP,Over Votes,0,0,0,0
Waller,104,"Justice, 14th Court of Appeals District, Place 7",,REP,Ken Wise,4,60,47,111
Waller,104,"Justice, 14th Court of Appeals District, Place 7",,REP,Ballots Cast,4,60,47,111
Waller,104,"Justice, 14th Court of Appeals District, Place 7",,REP,Under Votes,0,14,16,30
Waller,104,"Justice, 14th Court of Appeals District, Place 7",,REP,Over Votes,0,0,0,0
Waller,104,"District Judge, 506th Judicial District",,REP,Gary W. Chaney,4,63,48,115
Waller,104,"District Judge, 506th Judicial District",,REP,Ballots Cast,4,63,48,115
Waller,104,"District Judge, 506th Judicial District",,REP,Under Votes,0,11,15,26
Waller,104,"District Judge, 506th Judicial District",,REP,Over Votes,0,0,0,0
Waller,104,Sheriff,,REP,Dan Porter,0,10,5,15
Waller,104,Sheriff,,REP,R. Glenn Smith,2,31,12,45
Waller,104,Sheriff,,REP,Troy Guidry,2,32,44,78
Waller,104,Sheriff,,REP,Ballots Cast,4,73,61,138
Waller,104,Sheriff,,REP,Under Votes,0,1,2,3
Waller,104,Sheriff,,REP,Over Votes,0,0,0,0
Waller,104,County Tax Assessor-Collector,,REP,Ellen Contreras Shelburne,2,37,23,62
Waller,104,County Tax Assessor-Collector,,REP,Carolyn Miedke,2,37,35,74
Waller,104,County Tax Assessor-Collector,,REP,Ballots Cast,4,74,58,136
Waller,104,County Tax Assessor-Collector,,REP,Under Votes,0,0,5,5
Waller,104,County Tax Assessor-Collector,,REP,Over Votes,0,0,0,0
Waller,104,"County Commissioner, Precinct 1",,REP,John Allen Amsler,4,66,48,118
Waller,104,"County Commissioner, Precinct 1",,REP,Ballots Cast,4,66,48,118
Waller,104,"County Commissioner, Precinct 1",,REP,Under Votes,0,8,15,23
Waller,104,"County Commissioner, Precinct 1",,REP,Over Votes,0,0,0,0
Waller,104,"Constable, Precinct 1",,REP,Bo Hashaw,4,63,46,113
Waller,104,"Constable, Precinct 1",,REP,Ballots Cast,4,63,46,113
Waller,104,"Constable, Precinct 1",,REP,Under Votes,0,11,17,28
Waller,104,"Constable, Precinct 1",,REP,Over Votes,0,0,0,0
Waller,104,County Chairman,,REP,David W. Luther,4,63,47,114
Waller,104,County Chairman,,REP,Ballots Cast,4,63,47,114
Waller,104,County Chairman,,REP,Under Votes,0,11,16,27
Waller,104,County Chairman,,REP,Over Votes,0,0,0,0
Waller,104,Proposition #1,,DEM,Yes,4,17,35,56
Waller,104,Proposition #1,,DEM,No,0,1,0,1
Waller,104,Proposition #1,,DEM,Ballots Cast,4,18,35,57
Waller,104,Proposition #1,,DEM,Under Votes,0,3,2,5
Waller,104,Proposition #1,,DEM,Over Votes,0,0,0,0
Waller,104,Proposition #2,,DEM,Yes,4,19,34,57
Waller,104,Proposition #2,,DEM,No,0,0,0,0
Waller,104,Proposition #2,,DEM,Ballots Cast,4,19,34,57
Waller,104,Proposition #2,,DEM,Under Votes,0,2,3,5
Waller,104,Proposition #2,,DEM,Over Votes,0,0,0,0
Waller,104,Proposition #3,,DEM,Yes,4,19,34,57
Waller,104,Proposition #3,,DEM,No,0,0,0,0
Waller,104,Proposition #3,,DEM,Ballots Cast,4,19,34,57
Waller,104,Proposition #3,,DEM,Under Votes,0,2,3,5
Waller,104,Proposition #3,,DEM,Over Votes,0,0,0,0
Waller,104,Proposition #4,,DEM,Yes,4,19,33,56
Waller,104,Proposition #4,,DEM,No,0,0,1,1
Waller,104,Proposition #4,,DEM,Ballots Cast,4,19,34,57
Waller,104,Proposition #4,,DEM,Under Votes,0,2,3,5
Waller,104,Proposition #4,,DEM,Over Votes,0,0,0,0
Waller,104,Proposition #5,,DEM,Yes,4,19,32,55
Waller,104,Proposition #5,,DEM,No,0,0,2,2
Waller,104,Proposition #5,,DEM,Ballots Cast,4,19,34,57
Waller,104,Proposition #5,,DEM,Under Votes,0,2,3,5
Waller,104,Proposition #5,,DEM,Over Votes,0,0,0,0
Waller,104,Proposition #6,,DEM,Yes,4,19,33,56
Waller,104,Proposition #6,,DEM,No,0,1,1,2
Waller,104,Proposition #6,,DEM,Ballots Cast,4,20,34,58
Waller,104,Proposition #6,,DEM,Under Votes,0,1,3,4
Waller,104,Proposition #6,,DEM,Over Votes,0,0,0,0
Waller,104,Proposition #7,,DEM,Yes,4,16,31,51
Waller,104,Proposition #7,,DEM,No,0,2,1,3
Waller,104,Proposition #7,,DEM,Ballots Cast,4,18,32,54
Waller,104,Proposition #7,,DEM,Under Votes,0,3,5,8
Waller,104,Proposition #7,,DEM,Over Votes,0,0,0,0
Waller,104,Proposition #8,,DEM,Yes,4,18,33,55
Waller,104,Proposition #8,,DEM,No,0,0,2,2
Waller,104,Proposition #8,,DEM,Ballots Cast,4,18,35,57
Waller,104,Proposition #8,,DEM,Under Votes,0,3,2,5
Waller,104,Proposition #8,,DEM,Over Votes,0,0,0,0
Waller,104,Proposition #9,,DEM,Yes,4,18,33,55
Waller,104,Proposition #9,,DEM,No,0,0,0,0
Waller,104,Proposition #9,,DEM,Ballots Cast,4,18,33,55
Waller,104,Proposition #9,,DEM,Under Votes,0,3,4,7
Waller,104,Proposition #9,,DEM,Over Votes,0,0,0,0
Waller,104,Proposition #10,,DEM,Yes,4,16,35,55
Waller,104,Proposition #10,,DEM,No,0,2,0,2
Waller,104,Proposition #10,,DEM,Ballots Cast,4,18,35,57
Waller,104,Proposition #10,,DEM,Under Votes,0,3,2,5
Waller,104,Proposition #10,,DEM,Over Votes,0,0,0,0
Waller,104,Proposition #11,,DEM,Yes,1,15,33,49
Waller,104,Proposition #11,,DEM,No,3,3,2,8
Waller,104,Proposition #11,,DEM,Ballots Cast,4,18,35,57
Waller,104,Proposition #11,,DEM,Under Votes,0,3,2,5
Waller,104,Proposition #11,,DEM,Over Votes,0,0,0,0
Waller,104,Proposition 1,,REP,Yes,4,64,55,123
Waller,104,Proposition 1,,REP,No,0,10,8,18
Waller,104,Proposition 1,,REP,Ballots Cast,4,74,63,141
Waller,104,Proposition 1,,REP,Under Votes,0,0,0,0
Waller,104,Proposition 1,,REP,Over Votes,0,0,0,0
Waller,104,Proposition 2,,REP,Yes,3,65,53,121
Waller,104,Proposition 2,,REP,No,1,8,10,19
Waller,104,Proposition 2,,REP,Ballots Cast,4,73,63,140
Waller,104,Proposition 2,,REP,Under Votes,0,1,0,1
Waller,104,Proposition 2,,REP,Over Votes,0,0,0,0
Waller,104,Proposition 3,,REP,Yes,4,66,58,128
Waller,104,Proposition 3,,REP,No,0,4,2,6
Waller,104,Proposition 3,,REP,Ballots Cast,4,70,60,134
Waller,104,Proposition 3,,REP,Under Votes,0,4,3,7
Waller,104,Proposition 3,,REP,Over Votes,0,0,0,0
Waller,104,Proposition 4,,REP,Yes,4,71,61,136
Waller,104,Proposition 4,,REP,No,0,2,0,2
Waller,104,Proposition 4,,REP,Ballots Cast,4,73,61,138
Waller,104,Proposition 4,,REP,Under Votes,0,1,2,3
Waller,104,Proposition 4,,REP,Over Votes,0,0,0,0
Waller,104,Proposition 5,,REP,Yes,4,67,60,131
Waller,104,Proposition 5,,REP,No,0,7,2,9
Waller,104,Proposition 5,,REP,Ballots Cast,4,74,62,140
Waller,104,Proposition 5,,REP,Under Votes,0,0,1,1
Waller,104,Proposition 5,,REP,Over Votes,0,0,0,0
Waller,104,Proposition 6,,REP,Yes,4,66,61,131
Waller,104,Proposition 6,,REP,No,0,7,2,9
Waller,104,Proposition 6,,REP,Ballots Cast,4,73,63,140
Waller,104,Proposition 6,,REP,Under Votes,0,1,0,1
Waller,104,Proposition 6,,REP,Over Votes,0,0,0,0
Waller,104,Proposition 7,,REP,Yes,4,71,62,137
Waller,104,Proposition 7,,REP,No,0,1,0,1
Waller,104,Proposition 7,,REP,Ballots Cast,4,72,62,138
Waller,104,Proposition 7,,REP,Under Votes,0,2,1,3
Waller,104,Proposition 7,,REP,Over Votes,0,0,0,0
Waller,104,Proposition 8,,REP,Yes,4,72,62,138
Waller,104,Proposition 8,,REP,No,0,1,0,1
Waller,104,Proposition 8,,REP,Ballots Cast,4,73,62,139
Waller,104,Proposition 8,,REP,Under Votes,0,1,1,2
Waller,104,Proposition 8,,REP,Over Votes,0,0,0,0
Waller,104,Proposition 9,,REP,Yes,4,70,60,134
Waller,104,Proposition 9,,REP,No,0,2,1,3
Waller,104,Proposition 9,,REP,Ballots Cast,4,72,61,137
Waller,104,Proposition 9,,REP,Under Votes,0,2,2,4
Waller,104,Proposition 9,,REP,Over Votes,0,0,0,0
Waller,104,Proposition 10,,REP,Yes,4,66,57,127
Waller,104,Proposition 10,,REP,No,0,7,4,11
Waller,104,Proposition 10,,REP,Ballots Cast,4,73,61,138
Waller,104,Proposition 10,,REP,Under Votes,0,1,2,3
Waller,104,Proposition 10,,REP,Over Votes,0,0,0,0
Waller,105,President,,DEM,Michael Bennet,0,0,0,0
Waller,105,President,,DEM,Marianne Williamson,0,0,0,0
Waller,105,President,,DEM,Cory Booker,0,0,0,0
Waller,105,President,,DEM,Bernie Sanders,2,4,9,15
Waller,105,President,,DEM,Tulsi Gabbard,0,0,0,0
Waller,105,President,,DEM,Deval Patrick,0,0,0,0
Waller,105,President,,DEM,Amy Klobuchar,1,0,0,1
Waller,105,President,,DEM,Julián Castro,0,0,0,0
Waller,105,President,,DEM,Elizabeth Warren,0,0,3,3
Waller,105,President,,DEM,John K. Delaney,0,0,0,0
Waller,105,President,,DEM,Robby Wells,0,0,0,0
Waller,105,President,,DEM,"Roque ""Rocky"" De La Fuente",0,0,0,0
Waller,105,President,,DEM,Andrew Yang,0,0,0,0
Waller,105,President,,DEM,Joseph R. Biden,0,4,12,16
Waller,105,President,,DEM,Michael R. Bloomberg,0,1,2,3
Waller,105,President,,DEM,Tom Steyer,0,0,0,0
Waller,105,President,,DEM,Pete Buttigieg,0,0,0,0
Waller,105,President,,DEM,Ballots Cast,3,9,26,38
Waller,105,President,,DEM,Under Votes,0,1,0,1
Waller,105,President,,DEM,Over Votes,0,0,0,0
Waller,105,U.S. Senate,,DEM,Royce West,0,0,0,0
Waller,105,U.S. Senate,,DEM,"Annie ""Mamá"" Garcia",0,0,5,5
Waller,105,U.S. Senate,,DEM,D. R. Hunter,0,0,0,0
Waller,105,U.S. Senate,,DEM,Sema Hernandez,0,2,0,2
Waller,105,U.S. Senate,,DEM,Adrian Ocegueda,0,0,0,0
Waller,105,U.S. Senate,,DEM,Chris Bell,0,4,8,12
Waller,105,U.S. Senate,,DEM,Cristina Tzintzun Ramirez,1,0,4,5
Waller,105,U.S. Senate,,DEM,Jack Daniel Foster Jr,0,1,1,2
Waller,105,U.S. Senate,,DEM,Amanda K. Edwards,0,0,1,1
Waller,105,U.S. Senate,,DEM,Victor Hugo Harris,0,0,0,0
Waller,105,U.S. Senate,,DEM,"Mary ""MJ"" Hegar",2,1,3,6
Waller,105,U.S. Senate,,DEM,Michael Cooper,0,1,0,1
Waller,105,U.S. Senate,,DEM,Ballots Cast,3,9,22,34
Waller,105,U.S. Senate,,DEM,Under Votes,0,1,4,5
Waller,105,U.S. Senate,,DEM,Over Votes,0,0,0,0
Waller,105,U.S. House,10,DEM,Mike Siegel,1,4,7,12
Waller,105,U.S. House,10,DEM,Shannon Hutcheson,0,2,10,12
Waller,105,U.S. House,10,DEM,Pritesh Gandhi,2,4,6,12
Waller,105,U.S. House,10,DEM,Ballots Cast,3,10,23,36
Waller,105,U.S. House,10,DEM,Under Votes,0,0,3,3
Waller,105,U.S. House,10,DEM,Over Votes,0,0,0,0
Waller,105,Railroad Commissioner,,DEM,"Roberto R. ""Beto"" Alonzo",0,4,4,8
Waller,105,Railroad Commissioner,,DEM,Chrysta Castañeda,3,2,7,12
Waller,105,Railroad Commissioner,,DEM,Mark Watson,0,2,4,6
Waller,105,Railroad Commissioner,,DEM,Kelly Stone,0,0,7,7
Waller,105,Railroad Commissioner,,DEM,Ballots Cast,3,8,22,33
Waller,105,Railroad Commissioner,,DEM,Under Votes,0,2,4,6
Waller,105,Railroad Commissioner,,DEM,Over Votes,0,0,0,0
Waller,105,"Chief Justice, Supreme Court",,DEM,Jerry Zimmerer,0,2,5,7
Waller,105,"Chief Justice, Supreme Court",,DEM,Amy Clark Meachum,3,7,17,27
Waller,105,"Chief Justice, Supreme Court",,DEM,Ballots Cast,3,9,22,34
Waller,105,"Chief Justice, Supreme Court",,DEM,Under Votes,0,1,4,5
Waller,105,"Chief Justice, Supreme Court",,DEM,Over Votes,0,0,0,0
Waller,105,"Justice, Supreme Court, Place 6 Unexpired Term",,DEM,Kathy Cheng,3,8,14,25
Waller,105,"Justice, Supreme Court, Place 6 Unexpired Term",,DEM,Larry Praeger,0,1,8,9
Waller,105,"Justice, Supreme Court, Place 6 Unexpired Term",,DEM,Ballots Cast,3,9,22,34
Waller,105,"Justice, Supreme Court, Place 6 Unexpired Term",,DEM,Under Votes,0,1,4,5
Waller,105,"Justice, Supreme Court, Place 6 Unexpired Term",,DEM,Over Votes,0,0,0,0
Waller,105,"Justice, Supreme Court, Place 7",,DEM,Staci Williams,2,3,16,21
Waller,105,"Justice, Supreme Court, Place 7",,DEM,Brandy Voss,0,5,6,11
Waller,105,"Justice, Supreme Court, Place 7",,DEM,Ballots Cast,2,8,22,32
Waller,105,"Justice, Supreme Court, Place 7",,DEM,Under Votes,1,2,4,7
Waller,105,"Justice, Supreme Court, Place 7",,DEM,Over Votes,0,0,0,0
Waller,105,"Justice, Supreme Court, Place 8",,DEM,Gisela D. Triana,2,6,14,22
Waller,105,"Justice, Supreme Court, Place 8",,DEM,Peter Kelly,0,1,8,9
Waller,105,"Justice, Supreme Court, Place 8",,DEM,Ballots Cast,2,7,22,31
Waller,105,"Justice, Supreme Court, Place 8",,DEM,Under Votes,1,3,4,8
Waller,105,"Justice, Supreme Court, Place 8",,DEM,Over Votes,0,0,0,0
Waller,105,"Judge, Court of Criminal Appeals, Place 3",,DEM,Elizabeth Davis Frizell,2,6,12,20
Waller,105,"Judge, Court of Criminal Appeals, Place 3",,DEM,William Pieratt Demond,0,1,2,3
Waller,105,"Judge, Court of Criminal Appeals, Place 3",,DEM,Dan Wood,0,1,7,8
Waller,105,"Judge, Court of Criminal Appeals, Place 3",,DEM,Ballots Cast,2,8,21,31
Waller,105,"Judge, Court of Criminal Appeals, Place 3",,DEM,Under Votes,1,2,5,8
Waller,105,"Judge, Court of Criminal Appeals, Place 3",,DEM,Over Votes,0,0,0,0
Waller,105,"Judge, Court of Criminal Appeals, Place 4",,DEM,Steven Miears,0,1,6,7
Waller,105,"Judge, Court of Criminal Appeals, Place 4",,DEM,Tina Clinton,2,7,15,24
Waller,105,"Judge, Court of Criminal Appeals, Place 4",,DEM,Ballots Cast,2,8,21,31
Waller,105,"Judge, Court of Criminal Appeals, Place 4",,DEM,Under Votes,1,2,5,8
Waller,105,"Judge, Court of Criminal Appeals, Place 4",,DEM,Over Votes,0,0,0,0
Waller,105,"Judge, Court of Criminal Appeals, Place 9",,DEM,Brandon Birmingham,2,8,17,27
Waller,105,"Judge, Court of Criminal Appeals, Place 9",,DEM,Ballots Cast,2,8,17,27
Waller,105,"Judge, Court of Criminal Appeals, Place 9",,DEM,Under Votes,1,2,9,12
Waller,105,"Judge, Court of Criminal Appeals, Place 9",,DEM,Over Votes,0,0,0,0
Waller,105,"Member, State Board of Education, District 10",,DEM,Stephen Wyman,0,3,2,5
Waller,105,"Member, State Board of Education, District 10",,DEM,Marsha Burnett-Webster,2,5,19,26
Waller,105,"Member, State Board of Education, District 10",,DEM,Ballots Cast,2,8,21,31
Waller,105,"Member, State Board of Education, District 10",,DEM,Under Votes,1,2,5,8
Waller,105,"Member, State Board of Education, District 10",,DEM,Over Votes,0,0,0,0
Waller,105,State Senate,18,DEM,Michael Antalan,2,9,18,29
Waller,105,State Senate,18,DEM,Ballots Cast,2,9,18,29
Waller,105,State Senate,18,DEM,Under Votes,1,1,8,10
Waller,105,State Senate,18,DEM,Over Votes,0,0,0,0
Waller,105,State Representative,3,DEM,Martin Shupp,2,8,18,28
Waller,105,State Representative,3,DEM,Ballots Cast,2,8,18,28
Waller,105,State Representative,3,DEM,Under Votes,1,2,8,11
Waller,105,State Representative,3,DEM,Over Votes,0,0,0,0
Waller,105,"Chief Justice, 14th Court of Appeals District",,DEM,Jane Robinson,2,8,16,26
Waller,105,"Chief Justice, 14th Court of Appeals District",,DEM,Jim Evans,0,0,6,6
Waller,105,"Chief Justice, 14th Court of Appeals District",,DEM,Ballots Cast,2,8,22,32
Waller,105,"Chief Justice, 14th Court of Appeals District",,DEM,Under Votes,1,2,4,7
Waller,105,"Chief Justice, 14th Court of Appeals District",,DEM,Over Votes,0,0,0,0
Waller,105,"Justice, 1st Court of Appeals District, Place 3",,DEM,Jim Sharp,0,3,8,11
Waller,105,"Justice, 1st Court of Appeals District, Place 3",,DEM,Dinesh Singhal,1,1,3,5
Waller,105,"Justice, 1st Court of Appeals District, Place 3",,DEM,Veronica Rivas-Molloy,1,4,10,15
Waller,105,"Justice, 1st Court of Appeals District, Place 3",,DEM,Ballots Cast,2,8,21,31
Waller,105,"Justice, 1st Court of Appeals District, Place 3",,DEM,Under Votes,1,2,5,8
Waller,105,"Justice, 1st Court of Appeals District, Place 3",,DEM,Over Votes,0,0,0,0
Waller,105,"Justice, 1st Court of Appeals District, Place 5",,DEM,Tim Hootman,1,4,10,15
Waller,105,"Justice, 1st Court of Appeals District, Place 5",,DEM,Amparo Monique Guerra,1,4,12,17
Waller,105,"Justice, 1st Court of Appeals District, Place 5",,DEM,Ballots Cast,2,8,22,32
Waller,105,"Justice, 1st Court of Appeals District, Place 5",,DEM,Under Votes,1,2,4,7
Waller,105,"Justice, 1st Court of Appeals District, Place 5",,DEM,Over Votes,0,0,0,0
Waller,105,"Justice, 14th Court of Appeals District, Place 7",,DEM,"Tamika ""Tami"" Craft",1,1,5,7
Waller,105,"Justice, 14th Court of Appeals District, Place 7",,DEM,Wally Kronzer,0,0,3,3
Waller,105,"Justice, 14th Court of Appeals District, Place 7",,DEM,V.R. Faulkner,0,0,1,1
Waller,105,"Justice, 14th Court of Appeals District, Place 7",,DEM,Cheri Thomas,1,4,3,8
Waller,105,"Justice, 14th Court of Appeals District, Place 7",,DEM,Dominic J. Merino,0,2,4,6
Waller,105,"Justice, 14th Court of Appeals District, Place 7",,DEM,Lennon C. Wright,0,0,5,5
Waller,105,"Justice, 14th Court of Appeals District, Place 7",,DEM,Ballots Cast,2,7,21,30
Waller,105,"Justice, 14th Court of Appeals District, Place 7",,DEM,Under Votes,1,3,5,9
Waller,105,"Justice, 14th Court of Appeals District, Place 7",,DEM,Over Votes,0,0,0,0
Waller,105,Sheriff,,DEM,Cedric D. Watson,2,7,19,28
Waller,105,Sheriff,,DEM,Ballots Cast,2,7,19,28
Waller,105,Sheriff,,DEM,Under Votes,1,3,7,11
Waller,105,Sheriff,,DEM,Over Votes,0,0,0,0
Waller,105,"County Commissioner, Precinct 1",,DEM,Jacqueline Reynolds,2,6,11,19
Waller,105,"County Commissioner, Precinct 1",,DEM,Mildred Jefferson,0,1,10,11
Waller,105,"County Commissioner, Precinct 1",,DEM,Ballots Cast,2,7,21,30
Waller,105,"County Commissioner, Precinct 1",,DEM,Under Votes,1,3,5,9
Waller,105,"County Commissioner, Precinct 1",,DEM,Over Votes,0,0,0,0
Waller,105,County Chairman,,DEM,Rosa Patlan Harris,1,8,21,30
Waller,105,County Chairman,,DEM,Ballots Cast,1,8,21,30
Waller,105,County Chairman,,DEM,Under Votes,2,2,5,9
Waller,105,County Chairman,,DEM,Over Votes,0,0,0,0
Waller,105,President,,REP,Donald J. Trump,10,86,111,207
Waller,105,President,,REP,Joe Walsh,0,1,0,1
Waller,105,President,,REP,Bob Ely,0,0,0,0
Waller,105,President,,REP,"Roque ""Rocky"" De La Fuente Guerra",0,0,1,1
Waller,105,President,,REP,Zoltan G. Istvan,0,0,0,0
Waller,105,President,,REP,Matthew John Matern,0,0,0,0
Waller,105,President,,REP,Bill Weld,0,0,1,1
Waller,105,President,,REP,Uncommitted,1,5,2,8
Waller,105,President,,REP,Ballots Cast,11,92,115,218
Waller,105,President,,REP,Under Votes,0,1,0,1
Waller,105,President,,REP,Over Votes,0,0,0,0
Waller,105,U.S. Senate,,REP,Dwayne Stovall,0,23,23,46
Waller,105,U.S. Senate,,REP,Mark Yancey,2,4,9,15
Waller,105,U.S. Senate,,REP,Virgil Bierschwale,1,0,0,1
Waller,105,U.S. Senate,,REP,John Anthony Castro,0,3,5,8
Waller,105,U.S. Senate,,REP,John Cornyn,7,57,71,135
Waller,105,U.S. Senate,,REP,Ballots Cast,10,87,108,205
Waller,105,U.S. Senate,,REP,Under Votes,1,6,7,14
Waller,105,U.S. Senate,,REP,Over Votes,0,0,0,0
Waller,105,U.S. House,10,REP,Michael McCaul,9,83,108,200
Waller,105,U.S. House,10,REP,Ballots Cast,9,83,108,200
Waller,105,U.S. House,10,REP,Under Votes,2,10,7,19
Waller,105,U.S. House,10,REP,Over Votes,0,0,0,0
Waller,105,Railroad Commissioner,,REP,Ryan Sitton,5,45,50,100
Waller,105,Railroad Commissioner,,REP,"James ""Jim"" Wright",5,30,50,85
Waller,105,Railroad Commissioner,,REP,Ballots Cast,10,75,100,185
Waller,105,Railroad Commissioner,,REP,Under Votes,1,18,15,34
Waller,105,Railroad Commissioner,,REP,Over Votes,0,0,0,0
Waller,105,"Chief Justice, Supreme Court",,REP,Nathan Hecht,8,75,99,182
Waller,105,"Chief Justice, Supreme Court",,REP,Ballots Cast,8,75,99,182
Waller,105,"Chief Justice, Supreme Court",,REP,Under Votes,3,18,16,37
Waller,105,"Chief Justice, Supreme Court",,REP,Over Votes,0,0,0,0
Waller,105,"Justice, Supreme Court, Place 6 Unexpired Term",,REP,Jane Bland,8,72,102,182
Waller,105,"Justice, Supreme Court, Place 6 Unexpired Term",,REP,Ballots Cast,8,72,102,182
Waller,105,"Justice, Supreme Court, Place 6 Unexpired Term",,REP,Under Votes,3,21,13,37
Waller,105,"Justice, Supreme Court, Place 6 Unexpired Term",,REP,Over Votes,0,0,0,0
Waller,105,"Justice, Supreme Court, Place 7",,REP,Jeff Boyd,8,73,101,182
Waller,105,"Justice, Supreme Court, Place 7",,REP,Ballots Cast,8,73,101,182
Waller,105,"Justice, Supreme Court, Place 7",,REP,Under Votes,3,20,14,37
Waller,105,"Justice, Supreme Court, Place 7",,REP,Over Votes,0,0,0,0
Waller,105,"Justice, Supreme Court, Place 8",,REP,Brett Busby,8,73,101,182
Waller,105,"Justice, Supreme Court, Place 8",,REP,Ballots Cast,8,73,101,182
Waller,105,"Justice, Supreme Court, Place 8",,REP,Under Votes,3,20,14,37
Waller,105,"Justice, Supreme Court, Place 8",,REP,Over Votes,0,0,0,0
Waller,105,"Judge, Court of Criminal Appeals, Place 3",,REP,Gina Parker,7,41,53,101
Waller,105,"Judge, Court of Criminal Appeals, Place 3",,REP,Bert Richardson,3,31,43,77
Waller,105,"Judge, Court of Criminal Appeals, Place 3",,REP,Ballots Cast,10,72,96,178
Waller,105,"Judge, Court of Criminal Appeals, Place 3",,REP,Under Votes,1,21,19,41
Waller,105,"Judge, Court of Criminal Appeals, Place 3",,REP,Over Votes,0,0,0,0
Waller,105,"Judge, Court of Criminal Appeals, Place 4",,REP,Kevin Patrick Yeary,8,74,99,181
Waller,105,"Judge, Court of Criminal Appeals, Place 4",,REP,Ballots Cast,8,74,99,181
Waller,105,"Judge, Court of Criminal Appeals, Place 4",,REP,Under Votes,3,19,16,38
Waller,105,"Judge, Court of Criminal Appeals, Place 4",,REP,Over Votes,0,0,0,0
Waller,105,"Judge, Court of Criminal Appeals, Place 9",,REP,David Newell,8,74,99,181
Waller,105,"Judge, Court of Criminal Appeals, Place 9",,REP,Ballots Cast,8,74,99,181
Waller,105,"Judge, Court of Criminal Appeals, Place 9",,REP,Under Votes,3,19,16,38
Waller,105,"Judge, Court of Criminal Appeals, Place 9",,REP,Over Votes,0,0,0,0
Waller,105,"Member, State Board of Education, District 10",,REP,Tom Maynard,8,76,102,186
Waller,105,"Member, State Board of Education, District 10",,REP,Ballots Cast,8,76,102,186
Waller,105,"Member, State Board of Education, District 10",,REP,Under Votes,3,17,13,33
Waller,105,"Member, State Board of Education, District 10",,REP,Over Votes,0,0,0,0
Waller,105,State Senate,18,REP,Lois W. Kolkhorst,9,86,106,201
Waller,105,State Senate,18,REP,Ballots Cast,9,86,106,201
Waller,105,State Senate,18,REP,Under Votes,2,7,9,18
Waller,105,State Senate,18,REP,Over Votes,0,0,0,0
Waller,105,State Representative,3,REP,Cecil Bell Jr,9,83,105,197
Waller,105,State Representative,3,REP,Ballots Cast,9,83,105,197
Waller,105,State Representative,3,REP,Under Votes,2,10,10,22
Waller,105,State Representative,3,REP,Over Votes,0,0,0,0
Waller,105,"Chief Justice, 14th Court of Appeals District",,REP,Tracy Elizabeth Christopher,8,77,98,183
Waller,105,"Chief Justice, 14th Court of Appeals District",,REP,Ballots Cast,8,77,98,183
Waller,105,"Chief Justice, 14th Court of Appeals District",,REP,Under Votes,3,16,17,36
Waller,105,"Chief Justice, 14th Court of Appeals District",,REP,Over Votes,0,0,0,0
Waller,105,"Justice, 1st Court of Appeals District, Place 3",,REP,Russell Lloyd,7,76,99,182
Waller,105,"Justice, 1st Court of Appeals District, Place 3",,REP,Ballots Cast,7,76,99,182
Waller,105,"Justice, 1st Court of Appeals District, Place 3",,REP,Under Votes,4,17,16,37
Waller,105,"Justice, 1st Court of Appeals District, Place 3",,REP,Over Votes,0,0,0,0
Waller,105,"Justice, 1st Court of Appeals District, Place 5",,REP,Chad Bridges,4,29,28,61
Waller,105,"Justice, 1st Court of Appeals District, Place 5",,REP,James Lombardino,0,11,14,25
Waller,105,"Justice, 1st Court of Appeals District, Place 5",,REP,Levi J. Benton,0,5,11,16
Waller,105,"Justice, 1st Court of Appeals District, Place 5",,REP,Terry Adams,4,25,40,69
Waller,105,"Justice, 1st Court of Appeals District, Place 5",,REP,Ballots Cast,8,70,93,171
Waller,105,"Justice, 1st Court of Appeals District, Place 5",,REP,Under Votes,3,23,22,48
Waller,105,"Justice, 1st Court of Appeals District, Place 5",,REP,Over Votes,0,0,0,0
Waller,105,"Justice, 14th Court of Appeals District, Place 7",,REP,Ken Wise,7,72,99,178
Waller,105,"Justice, 14th Court of Appeals District, Place 7",,REP,Ballots Cast,7,72,99,178
Waller,105,"Justice, 14th Court of Appeals District, Place 7",,REP,Under Votes,4,21,16,41
Waller,105,"Justice, 14th Court of Appeals District, Place 7",,REP,Over Votes,0,0,0,0
Waller,105,"District Judge, 506th Judicial District",,REP,Gary W. Chaney,8,79,105,192
Waller,105,"District Judge, 506th Judicial District",,REP,Ballots Cast,8,79,105,192
Waller,105,"District Judge, 506th Judicial District",,REP,Under Votes,3,14,10,27
Waller,105,"District Judge, 506th Judicial District",,REP,Over Votes,0,0,0,0
Waller,105,Sheriff,,REP,Dan Porter,2,3,10,15
Waller,105,Sheriff,,REP,R. Glenn Smith,7,45,50,102
Waller,105,Sheriff,,REP,Troy Guidry,1,43,54,98
Waller,105,Sheriff,,REP,Ballots Cast,10,91,114,215
Waller,105,Sheriff,,REP,Under Votes,1,2,1,4
Waller,105,Sheriff,,REP,Over Votes,0,0,0,0
Waller,105,County Tax Assessor-Collector,,REP,Ellen Contreras Shelburne,7,49,63,119
Waller,105,County Tax Assessor-Collector,,REP,Carolyn Miedke,4,41,48,93
Waller,105,County Tax Assessor-Collector,,REP,Ballots Cast,11,90,111,212
Waller,105,County Tax Assessor-Collector,,REP,Under Votes,0,3,4,7
Waller,105,County Tax Assessor-Collector,,REP,Over Votes,0,0,0,0
Waller,105,"County Commissioner, Precinct 1",,REP,John Allen Amsler,8,86,100,194
Waller,105,"County Commissioner, Precinct 1",,REP,Ballots Cast,8,86,100,194
Waller,105,"County Commissioner, Precinct 1",,REP,Under Votes,3,7,15,25
Waller,105,"County Commissioner, Precinct 1",,REP,Over Votes,0,0,0,0
Waller,105,"Constable, Precinct 1",,REP,Bo Hashaw,8,84,103,195
Waller,105,"Constable, Precinct 1",,REP,Ballots Cast,8,84,103,195
Waller,105,"Constable, Precinct 1",,REP,Under Votes,3,9,12,24
Waller,105,"Constable, Precinct 1",,REP,Over Votes,0,0,0,0
Waller,105,County Chairman,,REP,David W. Luther,7,77,97,181
Waller,105,County Chairman,,REP,Ballots Cast,7,77,97,181
Waller,105,County Chairman,,REP,Under Votes,4,16,18,38
Waller,105,County Chairman,,REP,Over Votes,0,0,0,0
Waller,105,Proposition #1,,DEM,Yes,3,9,24,36
Waller,105,Proposition #1,,DEM,No,0,1,2,3
Waller,105,Proposition #1,,DEM,Ballots Cast,3,10,26,39
Waller,105,Proposition #1,,DEM,Under Votes,0,0,0,0
Waller,105,Proposition #1,,DEM,Over Votes,0,0,0,0
Waller,105,Proposition #2,,DEM,Yes,3,8,22,33
Waller,105,Proposition #2,,DEM,No,0,1,4,5
Waller,105,Proposition #2,,DEM,Ballots Cast,3,9,26,38
Waller,105,Proposition #2,,DEM,Under Votes,0,1,0,1
Waller,105,Proposition #2,,DEM,Over Votes,0,0,0,0
Waller,105,Proposition #3,,DEM,Yes,3,8,25,36
Waller,105,Proposition #3,,DEM,No,0,1,0,1
Waller,105,Proposition #3,,DEM,Ballots Cast,3,9,25,37
Waller,105,Proposition #3,,DEM,Under Votes,0,1,1,2
Waller,105,Proposition #3,,DEM,Over Votes,0,0,0,0
Waller,105,Proposition #4,,DEM,Yes,3,8,23,34
Waller,105,Proposition #4,,DEM,No,0,2,2,4
Waller,105,Proposition #4,,DEM,Ballots Cast,3,10,25,38
Waller,105,Proposition #4,,DEM,Under Votes,0,0,1,1
Waller,105,Proposition #4,,DEM,Over Votes,0,0,0,0
Waller,105,Proposition #5,,DEM,Yes,3,10,25,38
Waller,105,Proposition #5,,DEM,No,0,0,0,0
Waller,105,Proposition #5,,DEM,Ballots Cast,3,10,25,38
Waller,105,Proposition #5,,DEM,Under Votes,0,0,1,1
Waller,105,Proposition #5,,DEM,Over Votes,0,0,0,0
Waller,105,Proposition #6,,DEM,Yes,3,9,24,36
Waller,105,Proposition #6,,DEM,No,0,1,0,1
Waller,105,Proposition #6,,DEM,Ballots Cast,3,10,24,37
Waller,105,Proposition #6,,DEM,Under Votes,0,0,2,2
Waller,105,Proposition #6,,DEM,Over Votes,0,0,0,0
Waller,105,Proposition #7,,DEM,Yes,3,8,22,33
Waller,105,Proposition #7,,DEM,No,0,1,2,3
Waller,105,Proposition #7,,DEM,Ballots Cast,3,9,24,36
Waller,105,Proposition #7,,DEM,Under Votes,0,1,2,3
Waller,105,Proposition #7,,DEM,Over Votes,0,0,0,0
Waller,105,Proposition #8,,DEM,Yes,2,10,25,37
Waller,105,Proposition #8,,DEM,No,0,0,0,0
Waller,105,Proposition #8,,DEM,Ballots Cast,2,10,25,37
Waller,105,Proposition #8,,DEM,Under Votes,1,0,1,2
Waller,105,Proposition #8,,DEM,Over Votes,0,0,0,0
Waller,105,Proposition #9,,DEM,Yes,2,10,24,36
Waller,105,Proposition #9,,DEM,No,0,0,0,0
Waller,105,Proposition #9,,DEM,Ballots Cast,2,10,24,36
Waller,105,Proposition #9,,DEM,Under Votes,1,0,2,3
Waller,105,Proposition #9,,DEM,Over Votes,0,0,0,0
Waller,105,Proposition #10,,DEM,Yes,3,9,25,37
Waller,105,Proposition #10,,DEM,No,0,1,0,1
Waller,105,Proposition #10,,DEM,Ballots Cast,3,10,25,38
Waller,105,Proposition #10,,DEM,Under Votes,0,0,1,1
Waller,105,Proposition #10,,DEM,Over Votes,0,0,0,0
Waller,105,Proposition #11,,DEM,Yes,2,8,24,34
Waller,105,Proposition #11,,DEM,No,0,1,1,2
Waller,105,Proposition #11,,DEM,Ballots Cast,2,9,25,36
Waller,105,Proposition #11,,DEM,Under Votes,1,1,1,3
Waller,105,Proposition #11,,DEM,Over Votes,0,0,0,0
Waller,105,Proposition 1,,REP,Yes,8,79,97,184
Waller,105,Proposition 1,,REP,No,1,11,17,29
Waller,105,Proposition 1,,REP,Ballots Cast,9,90,114,213
Waller,105,Proposition 1,,REP,Under Votes,2,3,1,6
Waller,105,Proposition 1,,REP,Over Votes,0,0,0,0
Waller,105,Proposition 2,,REP,Yes,8,78,98,184
Waller,105,Proposition 2,,REP,No,0,12,15,27
Waller,105,Proposition 2,,REP,Ballots Cast,8,90,113,211
Waller,105,Proposition 2,,REP,Under Votes,1,3,2,6
Waller,105,Proposition 2,,REP,Over Votes,2,0,0,2
Waller,105,Proposition 3,,REP,Yes,11,86,102,199
Waller,105,Proposition 3,,REP,No,0,5,7,12
Waller,105,Proposition 3,,REP,Ballots Cast,11,91,109,211
Waller,105,Proposition 3,,REP,Under Votes,0,2,6,8
Waller,105,Proposition 3,,REP,Over Votes,0,0,0,0
Waller,105,Proposition 4,,REP,Yes,10,83,109,202
Waller,105,Proposition 4,,REP,No,1,7,2,10
Waller,105,Proposition 4,,REP,Ballots Cast,11,90,111,212
Waller,105,Proposition 4,,REP,Under Votes,0,3,4,7
Waller,105,Proposition 4,,REP,Over Votes,0,0,0,0
Waller,105,Proposition 5,,REP,Yes,10,84,108,202
Waller,105,Proposition 5,,REP,No,1,7,5,13
Waller,105,Proposition 5,,REP,Ballots Cast,11,91,113,215
Waller,105,Proposition 5,,REP,Under Votes,0,2,2,4
Waller,105,Proposition 5,,REP,Over Votes,0,0,0,0
Waller,105,Proposition 6,,REP,Yes,11,86,101,198
Waller,105,Proposition 6,,REP,No,0,5,9,14
Waller,105,Proposition 6,,REP,Ballots Cast,11,91,110,212
Waller,105,Proposition 6,,REP,Under Votes,0,2,5,7
Waller,105,Proposition 6,,REP,Over Votes,0,0,0,0
Waller,105,Proposition 7,,REP,Yes,11,89,111,211
Waller,105,Proposition 7,,REP,No,0,2,1,3
Waller,105,Proposition 7,,REP,Ballots Cast,11,91,112,214
Waller,105,Proposition 7,,REP,Under Votes,0,2,3,5
Waller,105,Proposition 7,,REP,Over Votes,0,0,0,0
Waller,105,Proposition 8,,REP,Yes,11,90,112,213
Waller,105,Proposition 8,,REP,No,0,1,0,1
Waller,105,Proposition 8,,REP,Ballots Cast,11,91,112,214
Waller,105,Proposition 8,,REP,Under Votes,0,2,3,5
Waller,105,Proposition 8,,REP,Over Votes,0,0,0,0
Waller,105,Proposition 9,,REP,Yes,11,88,112,211
Waller,105,Proposition 9,,REP,No,0,2,1,3
Waller,105,Proposition 9,,REP,Ballots Cast,11,90,113,214
Waller,105,Proposition 9,,REP,Under Votes,0,3,2,5
Waller,105,Proposition 9,,REP,Over Votes,0,0,0,0
Waller,105,Proposition 10,,REP,Yes,9,85,107,201
Waller,105,Proposition 10,,REP,No,1,5,5,11
Waller,105,Proposition 10,,REP,Ballots Cast,10,90,112,212
Waller,105,Proposition 10,,REP,Under Votes,1,3,3,7
Waller,105,Proposition 10,,REP,Over Votes,0,0,0,0
Waller,206,President,,DEM,Michael Bennet,0,0,0,0
Waller,206,President,,DEM,Marianne Williamson,0,0,0,0
Waller,206,President,,DEM,Cory Booker,0,0,0,0
Waller,206,President,,DEM,Bernie Sanders,3,18,27,48
Waller,206,President,,DEM,Tulsi Gabbard,0,0,0,0
Waller,206,President,,DEM,Deval Patrick,0,0,0,0
Waller,206,President,,DEM,Amy Klobuchar,0,1,0,1
Waller,206,President,,DEM,Julián Castro,0,0,0,0
Waller,206,President,,DEM,Elizabeth Warren,3,5,5,13
Waller,206,President,,DEM,John K. Delaney,0,0,0,0
Waller,206,President,,DEM,Robby Wells,0,0,0,0
Waller,206,President,,DEM,"Roque ""Rocky"" De La Fuente",0,0,0,0
Waller,206,President,,DEM,Andrew Yang,0,0,0,0
Waller,206,President,,DEM,Joseph R. Biden,4,9,33,46
Waller,206,President,,DEM,Michael R. Bloomberg,5,7,12,24
Waller,206,President,,DEM,Tom Steyer,0,0,0,0
Waller,206,President,,DEM,Pete Buttigieg,0,4,1,5
Waller,206,President,,DEM,Ballots Cast,15,44,78,137
Waller,206,President,,DEM,Under Votes,0,0,0,0
Waller,206,President,,DEM,Over Votes,0,0,0,0
Waller,206,U.S. Senate,,DEM,Royce West,0,2,2,4
Waller,206,U.S. Senate,,DEM,"Annie ""Mamá"" Garcia",3,4,8,15
Waller,206,U.S. Senate,,DEM,D. R. Hunter,0,0,2,2
Waller,206,U.S. Senate,,DEM,Sema Hernandez,0,4,12,16
Waller,206,U.S. Senate,,DEM,Adrian Ocegueda,0,0,5,5
Waller,206,U.S. Senate,,DEM,Chris Bell,4,6,12,22
Waller,206,U.S. Senate,,DEM,Cristina Tzintzun Ramirez,0,4,3,7
Waller,206,U.S. Senate,,DEM,Jack Daniel Foster Jr,0,0,0,0
Waller,206,U.S. Senate,,DEM,Amanda K. Edwards,4,4,5,13
Waller,206,U.S. Senate,,DEM,Victor Hugo Harris,0,0,0,0
Waller,206,U.S. Senate,,DEM,"Mary ""MJ"" Hegar",3,17,14,34
Waller,206,U.S. Senate,,DEM,Michael Cooper,0,0,1,1
Waller,206,U.S. Senate,,DEM,Ballots Cast,14,41,64,119
Waller,206,U.S. Senate,,DEM,Under Votes,1,3,14,18
Waller,206,U.S. Senate,,DEM,Over Votes,0,0,0,0
Waller,206,U.S. House,10,DEM,Mike Siegel,9,22,27,58
Waller,206,U.S. House,10,DEM,Shannon Hutcheson,2,9,27,38
Waller,206,U.S. House,10,DEM,Pritesh Gandhi,2,11,13,26
Waller,206,U.S. House,10,DEM,Ballots Cast,13,42,67,122
Waller,206,U.S. House,10,DEM,Under Votes,2,2,11,15
Waller,206,U.S. House,10,DEM,Over Votes,0,0,0,0
Waller,206,Railroad Commissioner,,DEM,"Roberto R. ""Beto"" Alonzo",4,10,13,27
Waller,206,Railroad Commissioner,,DEM,Chrysta Castañeda,6,12,21,39
Waller,206,Railroad Commissioner,,DEM,Mark Watson,3,3,8,14
Waller,206,Railroad Commissioner,,DEM,Kelly Stone,0,12,21,33
Waller,206,Railroad Commissioner,,DEM,Ballots Cast,13,37,63,113
Waller,206,Railroad Commissioner,,DEM,Under Votes,2,7,15,24
Waller,206,Railroad Commissioner,,DEM,Over Votes,0,0,0,0
Waller,206,"Chief Justice, Supreme Court",,DEM,Jerry Zimmerer,3,5,11,19
Waller,206,"Chief Justice, Supreme Court",,DEM,Amy Clark Meachum,10,31,52,93
Waller,206,"Chief Justice, Supreme Court",,DEM,Ballots Cast,13,36,63,112
Waller,206,"Chief Justice, Supreme Court",,DEM,Under Votes,2,8,15,25
Waller,206,"Chief Justice, Supreme Court",,DEM,Over Votes,0,0,0,0
Waller,206,"Justice, Supreme Court, Place 6 Unexpired Term",,DEM,Kathy Cheng,10,31,51,92
Waller,206,"Justice, Supreme Court, Place 6 Unexpired Term",,DEM,Larry Praeger,3,6,11,20
Waller,206,"Justice, Supreme Court, Place 6 Unexpired Term",,DEM,Ballots Cast,13,37,62,112
Waller,206,"Justice, Supreme Court, Place 6 Unexpired Term",,DEM,Under Votes,2,7,16,25
Waller,206,"Justice, Supreme Court, Place 6 Unexpired Term",,DEM,Over Votes,0,0,0,0
Waller,206,"Justice, Supreme Court, Place 7",,DEM,Staci Williams,8,23,34,65
Waller,206,"Justice, Supreme Court, Place 7",,DEM,Brandy Voss,5,12,26,43
Waller,206,"Justice, Supreme Court, Place 7",,DEM,Ballots Cast,13,35,60,108
Waller,206,"Justice, Supreme Court, Place 7",,DEM,Under Votes,2,9,18,29
Waller,206,"Justice, Supreme Court, Place 7",,DEM,Over Votes,0,0,0,0
Waller,206,"Justice, Supreme Court, Place 8",,DEM,Gisela D. Triana,6,24,43,73
Waller,206,"Justice, Supreme Court, Place 8",,DEM,Peter Kelly,7,11,18,36
Waller,206,"Justice, Supreme Court, Place 8",,DEM,Ballots Cast,13,35,61,109
Waller,206,"Justice, Supreme Court, Place 8",,DEM,Under Votes,2,9,17,28
Waller,206,"Justice, Supreme Court, Place 8",,DEM,Over Votes,0,0,0,0
Waller,206,"Judge, Court of Criminal Appeals, Place 3",,DEM,Elizabeth Davis Frizell,7,25,48,80
Waller,206,"Judge, Court of Criminal Appeals, Place 3",,DEM,William Pieratt Demond,3,2,5,10
Waller,206,"Judge, Court of Criminal Appeals, Place 3",,DEM,Dan Wood,4,8,10,22
Waller,206,"Judge, Court of Criminal Appeals, Place 3",,DEM,Ballots Cast,14,35,63,112
Waller,206,"Judge, Court of Criminal Appeals, Place 3",,DEM,Under Votes,1,9,15,25
Waller,206,"Judge, Court of Criminal Appeals, Place 3",,DEM,Over Votes,0,0,0,0
Waller,206,"Judge, Court of Criminal Appeals, Place 4",,DEM,Steven Miears,2,6,12,20
Waller,206,"Judge, Court of Criminal Appeals, Place 4",,DEM,Tina Clinton,12,31,50,93
Waller,206,"Judge, Court of Criminal Appeals, Place 4",,DEM,Ballots Cast,14,37,62,113
Waller,206,"Judge, Court of Criminal Appeals, Place 4",,DEM,Under Votes,1,7,16,24
Waller,206,"Judge, Court of Criminal Appeals, Place 4",,DEM,Over Votes,0,0,0,0
Waller,206,"Judge, Court of Criminal Appeals, Place 9",,DEM,Brandon Birmingham,13,31,54,98
Waller,206,"Judge, Court of Criminal Appeals, Place 9",,DEM,Ballots Cast,13,31,54,98
Waller,206,"Judge, Court of Criminal Appeals, Place 9",,DEM,Under Votes,2,13,24,39
Waller,206,"Judge, Court of Criminal Appeals, Place 9",,DEM,Over Votes,0,0,0,0
Waller,206,"Member, State Board of Education, District 10",,DEM,Stephen Wyman,5,6,10,21
Waller,206,"Member, State Board of Education, District 10",,DEM,Marsha Burnett-Webster,8,31,51,90
Waller,206,"Member, State Board of Education, District 10",,DEM,Ballots Cast,13,37,61,111
Waller,206,"Member, State Board of Education, District 10",,DEM,Under Votes,2,7,17,26
Waller,206,"Member, State Board of Education, District 10",,DEM,Over Votes,0,0,0,0
Waller,206,State Senate,18,DEM,Michael Antalan,13,32,55,100
Waller,206,State Senate,18,DEM,Ballots Cast,13,32,55,100
Waller,206,State Senate,18,DEM,Under Votes,2,12,23,37
Waller,206,State Senate,18,DEM,Over Votes,0,0,0,0
Waller,206,State Representative,3,DEM,Martin Shupp,13,31,56,100
Waller,206,State Representative,3,DEM,Ballots Cast,13,31,56,100
Waller,206,State Representative,3,DEM,Under Votes,2,13,22,37
Waller,206,State Representative,3,DEM,Over Votes,0,0,0,0
Waller,206,"Chief Justice, 14th Court of Appeals District",,DEM,Jane Robinson,13,32,48,93
Waller,206,"Chief Justice, 14th Court of Appeals District",,DEM,Jim Evans,1,5,13,19
Waller,206,"Chief Justice, 14th Court of Appeals District",,DEM,Ballots Cast,14,37,61,112
Waller,206,"Chief Justice, 14th Court of Appeals District",,DEM,Under Votes,1,7,17,25
Waller,206,"Chief Justice, 14th Court of Appeals District",,DEM,Over Votes,0,0,0,0
Waller,206,"Justice, 1st Court of Appeals District, Place 3",,DEM,Jim Sharp,5,10,13,28
Waller,206,"Justice, 1st Court of Appeals District, Place 3",,DEM,Dinesh Singhal,2,11,10,23
Waller,206,"Justice, 1st Court of Appeals District, Place 3",,DEM,Veronica Rivas-Molloy,7,17,38,62
Waller,206,"Justice, 1st Court of Appeals District, Place 3",,DEM,Ballots Cast,14,38,61,113
Waller,206,"Justice, 1st Court of Appeals District, Place 3",,DEM,Under Votes,1,6,17,24
Waller,206,"Justice, 1st Court of Appeals District, Place 3",,DEM,Over Votes,0,0,0,0
Waller,206,"Justice, 1st Court of Appeals District, Place 5",,DEM,Tim Hootman,4,13,15,32
Waller,206,"Justice, 1st Court of Appeals District, Place 5",,DEM,Amparo Monique Guerra,9,23,46,78
Waller,206,"Justice, 1st Court of Appeals District, Place 5",,DEM,Ballots Cast,13,36,61,110
Waller,206,"Justice, 1st Court of Appeals District, Place 5",,DEM,Under Votes,2,8,17,27
Waller,206,"Justice, 1st Court of Appeals District, Place 5",,DEM,Over Votes,0,0,0,0
Waller,206,"Justice, 14th Court of Appeals District, Place 7",,DEM,"Tamika ""Tami"" Craft",5,12,21,38
Waller,206,"Justice, 14th Court of Appeals District, Place 7",,DEM,Wally Kronzer,3,7,7,17
Waller,206,"Justice, 14th Court of Appeals District, Place 7",,DEM,V.R. Faulkner,0,4,3,7
Waller,206,"Justice, 14th Court of Appeals District, Place 7",,DEM,Cheri Thomas,4,10,17,31
Waller,206,"Justice, 14th Court of Appeals District, Place 7",,DEM,Dominic J. Merino,1,1,7,9
Waller,206,"Justice, 14th Court of Appeals District, Place 7",,DEM,Lennon C. Wright,0,0,5,5
Waller,206,"Justice, 14th Court of Appeals District, Place 7",,DEM,Ballots Cast,13,34,60,107
Waller,206,"Justice, 14th Court of Appeals District, Place 7",,DEM,Under Votes,2,10,18,30
Waller,206,"Justice, 14th Court of Appeals District, Place 7",,DEM,Over Votes,0,0,0,0
Waller,206,Sheriff,,DEM,Cedric D. Watson,14,33,58,105
Waller,206,Sheriff,,DEM,Ballots Cast,14,33,58,105
Waller,206,Sheriff,,DEM,Under Votes,1,11,20,32
Waller,206,Sheriff,,DEM,Over Votes,0,0,0,0
Waller,206,County Chairman,,DEM,Rosa Patlan Harris,15,33,62,110
Waller,206,County Chairman,,DEM,Ballots Cast,15,33,62,110
Waller,206,County Chairman,,DEM,Under Votes,0,11,16,27
Waller,206,County Chairman,,DEM,Over Votes,0,0,0,0
Waller,206,President,,REP,Donald J. Trump,27,215,357,599
Waller,206,President,,REP,Joe Walsh,0,3,2,5
Waller,206,President,,REP,Bob Ely,0,0,0,0
Waller,206,President,,REP,"Roque ""Rocky"" De La Fuente Guerra",0,0,0,0
Waller,206,President,,REP,Zoltan G. Istvan,0,0,0,0
Waller,206,President,,REP,Matthew John Matern,0,0,0,0
Waller,206,President,,REP,Bill Weld,0,6,1,7
Waller,206,President,,REP,Uncommitted,0,6,10,16
Waller,206,President,,REP,Ballots Cast,27,230,370,627
Waller,206,President,,REP,Under Votes,0,2,0,2
Waller,206,President,,REP,Over Votes,0,0,0,0
Waller,206,U.S. Senate,,REP,Dwayne Stovall,2,40,89,131
Waller,206,U.S. Senate,,REP,Mark Yancey,3,19,22,44
Waller,206,U.S. Senate,,REP,Virgil Bierschwale,0,4,3,7
Waller,206,U.S. Senate,,REP,John Anthony Castro,0,8,10,18
Waller,206,U.S. Senate,,REP,John Cornyn,20,143,221,384
Waller,206,U.S. Senate,,REP,Ballots Cast,25,214,345,584
Waller,206,U.S. Senate,,REP,Under Votes,2,18,25,45
Waller,206,U.S. Senate,,REP,Over Votes,0,0,0,0
Waller,206,U.S. House,10,REP,Michael McCaul,24,212,341,577
Waller,206,U.S. House,10,REP,Ballots Cast,24,212,341,577
Waller,206,U.S. House,10,REP,Under Votes,3,20,29,52
Waller,206,U.S. House,10,REP,Over Votes,0,0,0,0
Waller,206,Railroad Commissioner,,REP,Ryan Sitton,17,102,190,309
Waller,206,Railroad Commissioner,,REP,"James ""Jim"" Wright",8,98,135,241
Waller,206,Railroad Commissioner,,REP,Ballots Cast,25,200,325,550
Waller,206,Railroad Commissioner,,REP,Under Votes,2,32,45,79
Waller,206,Railroad Commissioner,,REP,Over Votes,0,0,0,0
Waller,206,"Chief Justice, Supreme Court",,REP,Nathan Hecht,22,199,320,541
Waller,206,"Chief Justice, Supreme Court",,REP,Ballots Cast,22,199,320,541
Waller,206,"Chief Justice, Supreme Court",,REP,Under Votes,5,33,50,88
Waller,206,"Chief Justice, Supreme Court",,REP,Over Votes,0,0,0,0
Waller,206,"Justice, Supreme Court, Place 6 Unexpired Term",,REP,Jane Bland,22,194,313,529
Waller,206,"Justice, Supreme Court, Place 6 Unexpired Term",,REP,Ballots Cast,22,194,313,529
Waller,206,"Justice, Supreme Court, Place 6 Unexpired Term",,REP,Under Votes,5,38,57,100
Waller,206,"Justice, Supreme Court, Place 6 Unexpired Term",,REP,Over Votes,0,0,0,0
Waller,206,"Justice, Supreme Court, Place 7",,REP,Jeff Boyd,20,194,318,532
Waller,206,"Justice, Supreme Court, Place 7",,REP,Ballots Cast,20,194,318,532
Waller,206,"Justice, Supreme Court, Place 7",,REP,Under Votes,7,38,52,97
Waller,206,"Justice, Supreme Court, Place 7",,REP,Over Votes,0,0,0,0
Waller,206,"Justice, Supreme Court, Place 8",,REP,Brett Busby,20,188,314,522
Waller,206,"Justice, Supreme Court, Place 8",,REP,Ballots Cast,20,188,314,522
Waller,206,"Justice, Supreme Court, Place 8",,REP,Under Votes,7,44,56,107
Waller,206,"Justice, Supreme Court, Place 8",,REP,Over Votes,0,0,0,0
Waller,206,"Judge, Court of Criminal Appeals, Place 3",,REP,Gina Parker,8,87,145,240
Waller,206,"Judge, Court of Criminal Appeals, Place 3",,REP,Bert Richardson,16,113,171,300
Waller,206,"Judge, Court of Criminal Appeals, Place 3",,REP,Ballots Cast,24,200,316,540
Waller,206,"Judge, Court of Criminal Appeals, Place 3",,REP,Under Votes,3,32,54,89
Waller,206,"Judge, Court of Criminal Appeals, Place 3",,REP,Over Votes,0,0,0,0
Waller,206,"Judge, Court of Criminal Appeals, Place 4",,REP,Kevin Patrick Yeary,21,191,309,521
Waller,206,"Judge, Court of Criminal Appeals, Place 4",,REP,Ballots Cast,21,191,309,521
Waller,206,"Judge, Court of Criminal Appeals, Place 4",,REP,Under Votes,6,41,61,108
Waller,206,"Judge, Court of Criminal Appeals, Place 4",,REP,Over Votes,0,0,0,0
Waller,206,"Judge, Court of Criminal Appeals, Place 9",,REP,David Newell,20,188,308,516
Waller,206,"Judge, Court of Criminal Appeals, Place 9",,REP,Ballots Cast,20,188,308,516
Waller,206,"Judge, Court of Criminal Appeals, Place 9",,REP,Under Votes,7,44,62,113
Waller,206,"Judge, Court of Criminal Appeals, Place 9",,REP,Over Votes,0,0,0,0
Waller,206,"Member, State Board of Education, District 10",,REP,Tom Maynard,15,187,310,512
Waller,206,"Member, State Board of Education, District 10",,REP,Ballots Cast,15,187,310,512
Waller,206,"Member, State Board of Education, District 10",,REP,Under Votes,12,45,60,117
Waller,206,"Member, State Board of Education, District 10",,REP,Over Votes,0,0,0,0
Waller,206,State Senate,18,REP,Lois W. Kolkhorst,18,194,318,530
Waller,206,State Senate,18,REP,Ballots Cast,18,194,318,530
Waller,206,State Senate,18,REP,Under Votes,9,38,52,99
Waller,206,State Senate,18,REP,Over Votes,0,0,0,0
Waller,206,State Representative,3,REP,Cecil Bell Jr,18,198,326,542
Waller,206,State Representative,3,REP,Ballots Cast,18,198,326,542
Waller,206,State Representative,3,REP,Under Votes,9,34,44,87
Waller,206,State Representative,3,REP,Over Votes,0,0,0,0
Waller,206,"Chief Justice, 14th Court of Appeals District",,REP,Tracy Elizabeth Christopher,19,182,309,510
Waller,206,"Chief Justice, 14th Court of Appeals District",,REP,Ballots Cast,19,182,309,510
Waller,206,"Chief Justice, 14th Court of Appeals District",,REP,Under Votes,8,50,61,119
Waller,206,"Chief Justice, 14th Court of Appeals District",,REP,Over Votes,0,0,0,0
Waller,206,"Justice, 1st Court of Appeals District, Place 3",,REP,Russell Lloyd,18,181,307,506
Waller,206,"Justice, 1st Court of Appeals District, Place 3",,REP,Ballots Cast,18,181,307,506
Waller,206,"Justice, 1st Court of Appeals District, Place 3",,REP,Under Votes,9,51,63,123
Waller,206,"Justice, 1st Court of Appeals District, Place 3",,REP,Over Votes,0,0,0,0
Waller,206,"Justice, 1st Court of Appeals District, Place 5",,REP,Chad Bridges,6,72,107,185
Waller,206,"Justice, 1st Court of Appeals District, Place 5",,REP,James Lombardino,4,21,23,48
Waller,206,"Justice, 1st Court of Appeals District, Place 5",,REP,Levi J. Benton,2,32,47,81
Waller,206,"Justice, 1st Court of Appeals District, Place 5",,REP,Terry Adams,7,62,111,180
Waller,206,"Justice, 1st Court of Appeals District, Place 5",,REP,Ballots Cast,19,187,288,494
Waller,206,"Justice, 1st Court of Appeals District, Place 5",,REP,Under Votes,8,45,82,135
Waller,206,"Justice, 1st Court of Appeals District, Place 5",,REP,Over Votes,0,0,0,0
Waller,206,"Justice, 14th Court of Appeals District, Place 7",,REP,Ken Wise,18,181,306,505
Waller,206,"Justice, 14th Court of Appeals District, Place 7",,REP,Ballots Cast,18,181,306,505
Waller,206,"Justice, 14th Court of Appeals District, Place 7",,REP,Under Votes,9,51,64,124
Waller,206,"Justice, 14th Court of Appeals District, Place 7",,REP,Over Votes,0,0,0,0
Waller,206,"District Judge, 506th Judicial District",,REP,Gary W. Chaney,17,195,310,522
Waller,206,"District Judge, 506th Judicial District",,REP,Ballots Cast,17,195,310,522
Waller,206,"District Judge, 506th Judicial District",,REP,Under Votes,10,37,60,107
Waller,206,"District Judge, 506th Judicial District",,REP,Over Votes,0,0,0,0
Waller,206,Sheriff,,REP,Dan Porter,2,18,33,53
Waller,206,Sheriff,,REP,R. Glenn Smith,8,74,117,199
Waller,206,Sheriff,,REP,Troy Guidry,7,137,206,350
Waller,206,Sheriff,,REP,Ballots Cast,17,229,356,602
Waller,206,Sheriff,,REP,Under Votes,10,3,14,27
Waller,206,Sheriff,,REP,Over Votes,0,0,0,0
Waller,206,County Tax Assessor-Collector,,REP,Ellen Contreras Shelburne,16,128,220,364
Waller,206,County Tax Assessor-Collector,,REP,Carolyn Miedke,5,95,126,226
Waller,206,County Tax Assessor-Collector,,REP,Ballots Cast,21,223,346,590
Waller,206,County Tax Assessor-Collector,,REP,Under Votes,6,9,24,39
Waller,206,County Tax Assessor-Collector,,REP,Over Votes,0,0,0,0
Waller,206,"Constable, Precinct 2",,REP,Glenn White,14,203,330,547
Waller,206,"Constable, Precinct 2",,REP,Ballots Cast,14,203,330,547
Waller,206,"Constable, Precinct 2",,REP,Under Votes,13,29,40,82
Waller,206,"Constable, Precinct 2",,REP,Over Votes,0,0,0,0
Waller,206,County Chairman,,REP,David W. Luther,15,193,306,514
Waller,206,County Chairman,,REP,Ballots Cast,15,193,306,514
Waller,206,County Chairman,,REP,Under Votes,12,39,64,115
Waller,206,County Chairman,,REP,Over Votes,0,0,0,0
Waller,206,Proposition #1,,DEM,Yes,15,41,69,125
Waller,206,Proposition #1,,DEM,No,0,2,6,8
Waller,206,Proposition #1,,DEM,Ballots Cast,15,43,75,133
Waller,206,Proposition #1,,DEM,Under Votes,0,1,3,4
Waller,206,Proposition #1,,DEM,Over Votes,0,0,0,0
Waller,206,Proposition #2,,DEM,Yes,15,40,68,123
Waller,206,Proposition #2,,DEM,No,0,3,8,11
Waller,206,Proposition #2,,DEM,Ballots Cast,15,43,76,134
Waller,206,Proposition #2,,DEM,Under Votes,0,1,2,3
Waller,206,Proposition #2,,DEM,Over Votes,0,0,0,0
Waller,206,Proposition #3,,DEM,Yes,14,42,72,128
Waller,206,Proposition #3,,DEM,No,0,2,3,5
Waller,206,Proposition #3,,DEM,Ballots Cast,14,44,75,133
Waller,206,Proposition #3,,DEM,Under Votes,1,0,3,4
Waller,206,Proposition #3,,DEM,Over Votes,0,0,0,0
Waller,206,Proposition #4,,DEM,Yes,14,39,69,122
Waller,206,Proposition #4,,DEM,No,0,3,6,9
Waller,206,Proposition #4,,DEM,Ballots Cast,14,42,75,131
Waller,206,Proposition #4,,DEM,Under Votes,1,2,3,6
Waller,206,Proposition #4,,DEM,Over Votes,0,0,0,0
Waller,206,Proposition #5,,DEM,Yes,14,40,74,128
Waller,206,Proposition #5,,DEM,No,0,2,2,4
Waller,206,Proposition #5,,DEM,Ballots Cast,14,42,76,132
Waller,206,Proposition #5,,DEM,Under Votes,1,2,2,5
Waller,206,Proposition #5,,DEM,Over Votes,0,0,0,0
Waller,206,Proposition #6,,DEM,Yes,14,42,71,127
Waller,206,Proposition #6,,DEM,No,0,2,3,5
Waller,206,Proposition #6,,DEM,Ballots Cast,14,44,74,132
Waller,206,Proposition #6,,DEM,Under Votes,1,0,4,5
Waller,206,Proposition #6,,DEM,Over Votes,0,0,0,0
Waller,206,Proposition #7,,DEM,Yes,14,39,72,125
Waller,206,Proposition #7,,DEM,No,0,2,4,6
Waller,206,Proposition #7,,DEM,Ballots Cast,14,41,76,131
Waller,206,Proposition #7,,DEM,Under Votes,1,3,2,6
Waller,206,Proposition #7,,DEM,Over Votes,0,0,0,0
Waller,206,Proposition #8,,DEM,Yes,14,41,71,126
Waller,206,Proposition #8,,DEM,No,0,2,3,5
Waller,206,Proposition #8,,DEM,Ballots Cast,14,43,74,131
Waller,206,Proposition #8,,DEM,Under Votes,1,1,4,6
Waller,206,Proposition #8,,DEM,Over Votes,0,0,0,0
Waller,206,Proposition #9,,DEM,Yes,15,42,71,128
Waller,206,Proposition #9,,DEM,No,0,2,3,5
Waller,206,Proposition #9,,DEM,Ballots Cast,15,44,74,133
Waller,206,Proposition #9,,DEM,Under Votes,0,0,4,4
Waller,206,Proposition #9,,DEM,Over Votes,0,0,0,0
Waller,206,Proposition #10,,DEM,Yes,15,39,71,125
Waller,206,Proposition #10,,DEM,No,0,1,4,5
Waller,206,Proposition #10,,DEM,Ballots Cast,15,40,75,130
Waller,206,Proposition #10,,DEM,Under Votes,0,4,3,7
Waller,206,Proposition #10,,DEM,Over Votes,0,0,0,0
Waller,206,Proposition #11,,DEM,Yes,15,40,67,122
Waller,206,Proposition #11,,DEM,No,0,3,6,9
Waller,206,Proposition #11,,DEM,Ballots Cast,15,43,73,131
Waller,206,Proposition #11,,DEM,Under Votes,0,1,5,6
Waller,206,Proposition #11,,DEM,Over Votes,0,0,0,0
Waller,206,Proposition 1,,REP,Yes,24,206,319,549
Waller,206,Proposition 1,,REP,No,2,20,41,63
Waller,206,Proposition 1,,REP,Ballots Cast,26,226,360,612
Waller,206,Proposition 1,,REP,Under Votes,0,6,10,16
Waller,206,Proposition 1,,REP,Over Votes,1,0,0,1
Waller,206,Proposition 2,,REP,Yes,23,195,319,537
Waller,206,Proposition 2,,REP,No,4,32,42,78
Waller,206,Proposition 2,,REP,Ballots Cast,27,227,361,615
Waller,206,Proposition 2,,REP,Under Votes,0,5,9,14
Waller,206,Proposition 2,,REP,Over Votes,0,0,0,0
Waller,206,Proposition 3,,REP,Yes,26,217,345,588
Waller,206,Proposition 3,,REP,No,1,11,10,22
Waller,206,Proposition 3,,REP,Ballots Cast,27,228,355,610
Waller,206,Proposition 3,,REP,Under Votes,0,4,15,19
Waller,206,Proposition 3,,REP,Over Votes,0,0,0,0
Waller,206,Proposition 4,,REP,Yes,27,210,348,585
Waller,206,Proposition 4,,REP,No,0,18,10,28
Waller,206,Proposition 4,,REP,Ballots Cast,27,228,358,613
Waller,206,Proposition 4,,REP,Under Votes,0,4,12,16
Waller,206,Proposition 4,,REP,Over Votes,0,0,0,0
Waller,206,Proposition 5,,REP,Yes,25,205,332,562
Waller,206,Proposition 5,,REP,No,2,21,25,48
Waller,206,Proposition 5,,REP,Ballots Cast,27,226,357,610
Waller,206,Proposition 5,,REP,Under Votes,0,6,13,19
Waller,206,Proposition 5,,REP,Over Votes,0,0,0,0
Waller,206,Proposition 6,,REP,Yes,27,216,334,577
Waller,206,Proposition 6,,REP,No,0,10,22,32
Waller,206,Proposition 6,,REP,Ballots Cast,27,226,356,609
Waller,206,Proposition 6,,REP,Under Votes,0,6,14,20
Waller,206,Proposition 6,,REP,Over Votes,0,0,0,0
Waller,206,Proposition 7,,REP,Yes,27,221,357,605
Waller,206,Proposition 7,,REP,No,0,4,1,5
Waller,206,Proposition 7,,REP,Ballots Cast,27,225,358,610
Waller,206,Proposition 7,,REP,Under Votes,0,7,12,19
Waller,206,Proposition 7,,REP,Over Votes,0,0,0,0
Waller,206,Proposition 8,,REP,Yes,27,222,353,602
Waller,206,Proposition 8,,REP,No,0,6,5,11
Waller,206,Proposition 8,,REP,Ballots Cast,27,228,358,613
Waller,206,Proposition 8,,REP,Under Votes,0,4,12,16
Waller,206,Proposition 8,,REP,Over Votes,0,0,0,0
Waller,206,Proposition 9,,REP,Yes,26,222,345,593
Waller,206,Proposition 9,,REP,No,1,5,14,20
Waller,206,Proposition 9,,REP,Ballots Cast,27,227,359,613
Waller,206,Proposition 9,,REP,Under Votes,0,5,11,16
Waller,206,Proposition 9,,REP,Over Votes,0,0,0,0
Waller,206,Proposition 10,,REP,Yes,22,213,334,569
Waller,206,Proposition 10,,REP,No,5,11,19,35
Waller,206,Proposition 10,,REP,Ballots Cast,27,224,353,604
Waller,206,Proposition 10,,REP,Under Votes,0,8,17,25
Waller,206,Proposition 10,,REP,Over Votes,0,0,0,0
Waller,207,President,,DEM,Michael Bennet,0,0,0,0
Waller,207,President,,DEM,Marianne Williamson,0,0,0,0
Waller,207,President,,DEM,Cory Booker,0,0,0,0
Waller,207,President,,DEM,Bernie Sanders,1,5,26,32
Waller,207,President,,DEM,Tulsi Gabbard,0,0,1,1
Waller,207,President,,DEM,Deval Patrick,0,0,0,0
Waller,207,President,,DEM,Amy Klobuchar,0,1,0,1
Waller,207,President,,DEM,Julián Castro,0,0,0,0
Waller,207,President,,DEM,Elizabeth Warren,2,7,6,15
Waller,207,President,,DEM,John K. Delaney,0,0,0,0
Waller,207,President,,DEM,Robby Wells,0,0,0,0
Waller,207,President,,DEM,"Roque ""Rocky"" De La Fuente",0,0,0,0
Waller,207,President,,DEM,Andrew Yang,0,0,0,0
Waller,207,President,,DEM,Joseph R. Biden,5,7,40,52
Waller,207,President,,DEM,Michael R. Bloomberg,6,3,10,19
Waller,207,President,,DEM,Tom Steyer,0,0,1,1
Waller,207,President,,DEM,Pete Buttigieg,2,3,0,5
Waller,207,President,,DEM,Ballots Cast,16,26,84,126
Waller,207,President,,DEM,Under Votes,0,0,0,0
Waller,207,President,,DEM,Over Votes,0,0,0,0
Waller,207,U.S. Senate,,DEM,Royce West,0,0,2,2
Waller,207,U.S. Senate,,DEM,"Annie ""Mamá"" Garcia",2,2,9,13
Waller,207,U.S. Senate,,DEM,D. R. Hunter,0,0,2,2
Waller,207,U.S. Senate,,DEM,Sema Hernandez,0,3,7,10
Waller,207,U.S. Senate,,DEM,Adrian Ocegueda,0,0,0,0
Waller,207,U.S. Senate,,DEM,Chris Bell,3,7,21,31
Waller,207,U.S. Senate,,DEM,Cristina Tzintzun Ramirez,0,0,2,2
Waller,207,U.S. Senate,,DEM,Jack Daniel Foster Jr,0,0,4,4
Waller,207,U.S. Senate,,DEM,Amanda K. Edwards,1,2,6,9
Waller,207,U.S. Senate,,DEM,Victor Hugo Harris,0,0,2,2
Waller,207,U.S. Senate,,DEM,"Mary ""MJ"" Hegar",10,10,13,33
Waller,207,U.S. Senate,,DEM,Michael Cooper,0,0,4,4
Waller,207,U.S. Senate,,DEM,Ballots Cast,16,24,72,112
Waller,207,U.S. Senate,,DEM,Under Votes,0,2,12,14
Waller,207,U.S. Senate,,DEM,Over Votes,0,0,0,0
Waller,207,U.S. House,10,DEM,Mike Siegel,6,9,27,42
Waller,207,U.S. House,10,DEM,Shannon Hutcheson,6,7,24,37
Waller,207,U.S. House,10,DEM,Pritesh Gandhi,4,8,20,32
Waller,207,U.S. House,10,DEM,Ballots Cast,16,24,71,111
Waller,207,U.S. House,10,DEM,Under Votes,0,2,13,15
Waller,207,U.S. House,10,DEM,Over Votes,0,0,0,0
Waller,207,Railroad Commissioner,,DEM,"Roberto R. ""Beto"" Alonzo",1,3,24,28
Waller,207,Railroad Commissioner,,DEM,Chrysta Castañeda,5,6,15,26
Waller,207,Railroad Commissioner,,DEM,Mark Watson,3,6,14,23
Waller,207,Railroad Commissioner,,DEM,Kelly Stone,7,6,16,29
Waller,207,Railroad Commissioner,,DEM,Ballots Cast,16,21,69,106
Waller,207,Railroad Commissioner,,DEM,Under Votes,0,5,15,20
Waller,207,Railroad Commissioner,,DEM,Over Votes,0,0,0,0
Waller,207,"Chief Justice, Supreme Court",,DEM,Jerry Zimmerer,2,0,18,20
Waller,207,"Chief Justice, Supreme Court",,DEM,Amy Clark Meachum,14,23,53,90
Waller,207,"Chief Justice, Supreme Court",,DEM,Ballots Cast,16,23,71,110
Waller,207,"Chief Justice, Supreme Court",,DEM,Under Votes,0,3,13,16
Waller,207,"Chief Justice, Supreme Court",,DEM,Over Votes,0,0,0,0
Waller,207,"Justice, Supreme Court, Place 6 Unexpired Term",,DEM,Kathy Cheng,7,21,49,77
Waller,207,"Justice, Supreme Court, Place 6 Unexpired Term",,DEM,Larry Praeger,7,3,22,32
Waller,207,"Justice, Supreme Court, Place 6 Unexpired Term",,DEM,Ballots Cast,14,24,71,109
Waller,207,"Justice, Supreme Court, Place 6 Unexpired Term",,DEM,Under Votes,2,2,13,17
Waller,207,"Justice, Supreme Court, Place 6 Unexpired Term",,DEM,Over Votes,0,0,0,0
Waller,207,"Justice, Supreme Court, Place 7",,DEM,Staci Williams,7,14,41,62
Waller,207,"Justice, Supreme Court, Place 7",,DEM,Brandy Voss,8,6,27,41
Waller,207,"Justice, Supreme Court, Place 7",,DEM,Ballots Cast,15,20,68,103
Waller,207,"Justice, Supreme Court, Place 7",,DEM,Under Votes,1,6,16,23
Waller,207,"Justice, Supreme Court, Place 7",,DEM,Over Votes,0,0,0,0
Waller,207,"Justice, Supreme Court, Place 8",,DEM,Gisela D. Triana,10,16,44,70
Waller,207,"Justice, Supreme Court, Place 8",,DEM,Peter Kelly,5,4,24,33
Waller,207,"Justice, Supreme Court, Place 8",,DEM,Ballots Cast,15,20,68,103
Waller,207,"Justice, Supreme Court, Place 8",,DEM,Under Votes,1,6,16,23
Waller,207,"Justice, Supreme Court, Place 8",,DEM,Over Votes,0,0,0,0
Waller,207,"Judge, Court of Criminal Appeals, Place 3",,DEM,Elizabeth Davis Frizell,13,17,48,78
Waller,207,"Judge, Court of Criminal Appeals, Place 3",,DEM,William Pieratt Demond,0,2,8,10
Waller,207,"Judge, Court of Criminal Appeals, Place 3",,DEM,Dan Wood,2,2,15,19
Waller,207,"Judge, Court of Criminal Appeals, Place 3",,DEM,Ballots Cast,15,21,71,107
Waller,207,"Judge, Court of Criminal Appeals, Place 3",,DEM,Under Votes,1,5,13,19
Waller,207,"Judge, Court of Criminal Appeals, Place 3",,DEM,Over Votes,0,0,0,0
Waller,207,"Judge, Court of Criminal Appeals, Place 4",,DEM,Steven Miears,3,3,14,20
Waller,207,"Judge, Court of Criminal Appeals, Place 4",,DEM,Tina Clinton,13,19,53,85
Waller,207,"Judge, Court of Criminal Appeals, Place 4",,DEM,Ballots Cast,16,22,67,105
Waller,207,"Judge, Court of Criminal Appeals, Place 4",,DEM,Under Votes,0,4,17,21
Waller,207,"Judge, Court of Criminal Appeals, Place 4",,DEM,Over Votes,0,0,0,0
Waller,207,"Judge, Court of Criminal Appeals, Place 9",,DEM,Brandon Birmingham,13,17,62,92
Waller,207,"Judge, Court of Criminal Appeals, Place 9",,DEM,Ballots Cast,13,17,62,92
Waller,207,"Judge, Court of Criminal Appeals, Place 9",,DEM,Under Votes,3,9,22,34
Waller,207,"Judge, Court of Criminal Appeals, Place 9",,DEM,Over Votes,0,0,0,0
Waller,207,"Member, State Board of Education, District 10",,DEM,Stephen Wyman,2,2,17,21
Waller,207,"Member, State Board of Education, District 10",,DEM,Marsha Burnett-Webster,13,19,50,82
Waller,207,"Member, State Board of Education, District 10",,DEM,Ballots Cast,15,21,67,103
Waller,207,"Member, State Board of Education, District 10",,DEM,Under Votes,1,5,17,23
Waller,207,"Member, State Board of Education, District 10",,DEM,Over Votes,0,0,0,0
Waller,207,State Senate,18,DEM,Michael Antalan,11,19,61,91
Waller,207,State Senate,18,DEM,Ballots Cast,11,19,61,91
Waller,207,State Senate,18,DEM,Under Votes,5,7,23,35
Waller,207,State Senate,18,DEM,Over Votes,0,0,0,0
Waller,207,State Representative,3,DEM,Martin Shupp,12,18,59,89
Waller,207,State Representative,3,DEM,Ballots Cast,12,18,59,89
Waller,207,State Representative,3,DEM,Under Votes,4,8,25,37
Waller,207,State Representative,3,DEM,Over Votes,0,0,0,0
Waller,207,"Chief Justice, 14th Court of Appeals District",,DEM,Jane Robinson,11,20,51,82
Waller,207,"Chief Justice, 14th Court of Appeals District",,DEM,Jim Evans,5,4,17,26
Waller,207,"Chief Justice, 14th Court of Appeals District",,DEM,Ballots Cast,16,24,68,108
Waller,207,"Chief Justice, 14th Court of Appeals District",,DEM,Under Votes,0,2,16,18
Waller,207,"Chief Justice, 14th Court of Appeals District",,DEM,Over Votes,0,0,0,0
Waller,207,"Justice, 1st Court of Appeals District, Place 3",,DEM,Jim Sharp,5,4,19,28
Waller,207,"Justice, 1st Court of Appeals District, Place 3",,DEM,Dinesh Singhal,1,5,10,16
Waller,207,"Justice, 1st Court of Appeals District, Place 3",,DEM,Veronica Rivas-Molloy,9,14,39,62
Waller,207,"Justice, 1st Court of Appeals District, Place 3",,DEM,Ballots Cast,15,23,68,106
Waller,207,"Justice, 1st Court of Appeals District, Place 3",,DEM,Under Votes,1,3,16,20
Waller,207,"Justice, 1st Court of Appeals District, Place 3",,DEM,Over Votes,0,0,0,0
Waller,207,"Justice, 1st Court of Appeals District, Place 5",,DEM,Tim Hootman,9,6,25,40
Waller,207,"Justice, 1st Court of Appeals District, Place 5",,DEM,Amparo Monique Guerra,6,14,38,58
Waller,207,"Justice, 1st Court of Appeals District, Place 5",,DEM,Ballots Cast,15,20,63,98
Waller,207,"Justice, 1st Court of Appeals District, Place 5",,DEM,Under Votes,1,6,21,28
Waller,207,"Justice, 1st Court of Appeals District, Place 5",,DEM,Over Votes,0,0,0,0
Waller,207,"Justice, 14th Court of Appeals District, Place 7",,DEM,"Tamika ""Tami"" Craft",5,12,26,43
Waller,207,"Justice, 14th Court of Appeals District, Place 7",,DEM,Wally Kronzer,2,1,10,13
Waller,207,"Justice, 14th Court of Appeals District, Place 7",,DEM,V.R. Faulkner,2,0,3,5
Waller,207,"Justice, 14th Court of Appeals District, Place 7",,DEM,Cheri Thomas,6,5,19,30
Waller,207,"Justice, 14th Court of Appeals District, Place 7",,DEM,Dominic J. Merino,0,3,3,6
Waller,207,"Justice, 14th Court of Appeals District, Place 7",,DEM,Lennon C. Wright,0,2,1,3
Waller,207,"Justice, 14th Court of Appeals District, Place 7",,DEM,Ballots Cast,15,23,62,100
Waller,207,"Justice, 14th Court of Appeals District, Place 7",,DEM,Under Votes,1,3,22,26
Waller,207,"Justice, 14th Court of Appeals District, Place 7",,DEM,Over Votes,0,0,0,0
Waller,207,Sheriff,,DEM,Cedric D. Watson,12,19,61,92
Waller,207,Sheriff,,DEM,Ballots Cast,12,19,61,92
Waller,207,Sheriff,,DEM,Under Votes,4,7,23,34
Waller,207,Sheriff,,DEM,Over Votes,0,0,0,0
Waller,207,County Chairman,,DEM,Rosa Patlan Harris,11,20,64,95
Waller,207,County Chairman,,DEM,Ballots Cast,11,20,64,95
Waller,207,County Chairman,,DEM,Under Votes,5,6,20,31
Waller,207,County Chairman,,DEM,Over Votes,0,0,0,0
Waller,207,President,,REP,Donald J. Trump,51,308,325,684
Waller,207,President,,REP,Joe Walsh,0,2,0,2
Waller,207,President,,REP,Bob Ely,0,0,0,0
Waller,207,President,,REP,"Roque ""Rocky"" De La Fuente Guerra",0,0,0,0
Waller,207,President,,REP,Zoltan G. Istvan,0,0,0,0
Waller,207,President,,REP,Matthew John Matern,0,0,0,0
Waller,207,President,,REP,Bill Weld,0,0,2,2
Waller,207,President,,REP,Uncommitted,0,7,8,15
Waller,207,President,,REP,Ballots Cast,51,317,335,703
Waller,207,President,,REP,Under Votes,0,1,0,1
Waller,207,President,,REP,Over Votes,1,0,0,1
Waller,207,U.S. Senate,,REP,Dwayne Stovall,19,80,100,199
Waller,207,U.S. Senate,,REP,Mark Yancey,3,18,24,45
Waller,207,U.S. Senate,,REP,Virgil Bierschwale,0,1,0,1
Waller,207,U.S. Senate,,REP,John Anthony Castro,0,4,1,5
Waller,207,U.S. Senate,,REP,John Cornyn,30,199,187,416
Waller,207,U.S. Senate,,REP,Ballots Cast,52,302,312,666
Waller,207,U.S. Senate,,REP,Under Votes,0,16,23,39
Waller,207,U.S. Senate,,REP,Over Votes,0,0,0,0
Waller,207,U.S. House,10,REP,Michael McCaul,46,297,319,662
Waller,207,U.S. House,10,REP,Ballots Cast,46,297,319,662
Waller,207,U.S. House,10,REP,Under Votes,6,21,16,43
Waller,207,U.S. House,10,REP,Over Votes,0,0,0,0
Waller,207,Railroad Commissioner,,REP,Ryan Sitton,30,166,160,356
Waller,207,Railroad Commissioner,,REP,"James ""Jim"" Wright",17,122,134,273
Waller,207,Railroad Commissioner,,REP,Ballots Cast,47,288,294,629
Waller,207,Railroad Commissioner,,REP,Under Votes,5,30,41,76
Waller,207,Railroad Commissioner,,REP,Over Votes,0,0,0,0
Waller,207,"Chief Justice, Supreme Court",,REP,Nathan Hecht,46,282,300,628
Waller,207,"Chief Justice, Supreme Court",,REP,Ballots Cast,46,282,300,628
Waller,207,"Chief Justice, Supreme Court",,REP,Under Votes,6,36,35,77
Waller,207,"Chief Justice, Supreme Court",,REP,Over Votes,0,0,0,0
Waller,207,"Justice, Supreme Court, Place 6 Unexpired Term",,REP,Jane Bland,45,282,297,624
Waller,207,"Justice, Supreme Court, Place 6 Unexpired Term",,REP,Ballots Cast,45,282,297,624
Waller,207,"Justice, Supreme Court, Place 6 Unexpired Term",,REP,Under Votes,7,36,38,81
Waller,207,"Justice, Supreme Court, Place 6 Unexpired Term",,REP,Over Votes,0,0,0,0
Waller,207,"Justice, Supreme Court, Place 7",,REP,Jeff Boyd,46,277,299,622
Waller,207,"Justice, Supreme Court, Place 7",,REP,Ballots Cast,46,277,299,622
Waller,207,"Justice, Supreme Court, Place 7",,REP,Under Votes,6,41,36,83
Waller,207,"Justice, Supreme Court, Place 7",,REP,Over Votes,0,0,0,0
Waller,207,"Justice, Supreme Court, Place 8",,REP,Brett Busby,46,277,294,617
Waller,207,"Justice, Supreme Court, Place 8",,REP,Ballots Cast,46,277,294,617
Waller,207,"Justice, Supreme Court, Place 8",,REP,Under Votes,6,41,41,88
Waller,207,"Justice, Supreme Court, Place 8",,REP,Over Votes,0,0,0,0
Waller,207,"Judge, Court of Criminal Appeals, Place 3",,REP,Gina Parker,21,140,158,319
Waller,207,"Judge, Court of Criminal Appeals, Place 3",,REP,Bert Richardson,27,147,131,305
Waller,207,"Judge, Court of Criminal Appeals, Place 3",,REP,Ballots Cast,48,287,289,624
Waller,207,"Judge, Court of Criminal Appeals, Place 3",,REP,Under Votes,3,31,46,80
Waller,207,"Judge, Court of Criminal Appeals, Place 3",,REP,Over Votes,1,0,0,1
Waller,207,"Judge, Court of Criminal Appeals, Place 4",,REP,Kevin Patrick Yeary,45,273,297,615
Waller,207,"Judge, Court of Criminal Appeals, Place 4",,REP,Ballots Cast,45,273,297,615
Waller,207,"Judge, Court of Criminal Appeals, Place 4",,REP,Under Votes,7,45,38,90
Waller,207,"Judge, Court of Criminal Appeals, Place 4",,REP,Over Votes,0,0,0,0
Waller,207,"Judge, Court of Criminal Appeals, Place 9",,REP,David Newell,45,276,294,615
Waller,207,"Judge, Court of Criminal Appeals, Place 9",,REP,Ballots Cast,45,276,294,615
Waller,207,"Judge, Court of Criminal Appeals, Place 9",,REP,Under Votes,7,42,41,90
Waller,207,"Judge, Court of Criminal Appeals, Place 9",,REP,Over Votes,0,0,0,0
Waller,207,"Member, State Board of Education, District 10",,REP,Tom Maynard,44,273,295,612
Waller,207,"Member, State Board of Education, District 10",,REP,Ballots Cast,44,273,295,612
Waller,207,"Member, State Board of Education, District 10",,REP,Under Votes,8,45,40,93
Waller,207,"Member, State Board of Education, District 10",,REP,Over Votes,0,0,0,0
Waller,207,State Senate,18,REP,Lois W. Kolkhorst,44,280,298,622
Waller,207,State Senate,18,REP,Ballots Cast,44,280,298,622
Waller,207,State Senate,18,REP,Under Votes,8,38,37,83
Waller,207,State Senate,18,REP,Over Votes,0,0,0,0
Waller,207,State Representative,3,REP,Cecil Bell Jr,44,284,302,630
Waller,207,State Representative,3,REP,Ballots Cast,44,284,302,630
Waller,207,State Representative,3,REP,Under Votes,8,34,33,75
Waller,207,State Representative,3,REP,Over Votes,0,0,0,0
Waller,207,"Chief Justice, 14th Court of Appeals District",,REP,Tracy Elizabeth Christopher,45,275,291,611
Waller,207,"Chief Justice, 14th Court of Appeals District",,REP,Ballots Cast,45,275,291,611
Waller,207,"Chief Justice, 14th Court of Appeals District",,REP,Under Votes,7,43,44,94
Waller,207,"Chief Justice, 14th Court of Appeals District",,REP,Over Votes,0,0,0,0
Waller,207,"Justice, 1st Court of Appeals District, Place 3",,REP,Russell Lloyd,44,273,295,612
Waller,207,"Justice, 1st Court of Appeals District, Place 3",,REP,Ballots Cast,44,273,295,612
Waller,207,"Justice, 1st Court of Appeals District, Place 3",,REP,Under Votes,8,45,40,93
Waller,207,"Justice, 1st Court of Appeals District, Place 3",,REP,Over Votes,0,0,0,0
Waller,207,"Justice, 1st Court of Appeals District, Place 5",,REP,Chad Bridges,15,92,90,197
Waller,207,"Justice, 1st Court of Appeals District, Place 5",,REP,James Lombardino,4,29,33,66
Waller,207,"Justice, 1st Court of Appeals District, Place 5",,REP,Levi J. Benton,4,24,38,66
Waller,207,"Justice, 1st Court of Appeals District, Place 5",,REP,Terry Adams,20,129,106,255
Waller,207,"Justice, 1st Court of Appeals District, Place 5",,REP,Ballots Cast,43,274,267,584
Waller,207,"Justice, 1st Court of Appeals District, Place 5",,REP,Under Votes,8,44,68,120
Waller,207,"Justice, 1st Court of Appeals District, Place 5",,REP,Over Votes,1,0,0,1
Waller,207,"Justice, 14th Court of Appeals District, Place 7",,REP,Ken Wise,45,277,289,611
Waller,207,"Justice, 14th Court of Appeals District, Place 7",,REP,Ballots Cast,45,277,289,611
Waller,207,"Justice, 14th Court of Appeals District, Place 7",,REP,Under Votes,7,41,46,94
Waller,207,"Justice, 14th Court of Appeals District, Place 7",,REP,Over Votes,0,0,0,0
Waller,207,"District Judge, 506th Judicial District",,REP,Gary W. Chaney,43,281,294,618
Waller,207,"District Judge, 506th Judicial District",,REP,Ballots Cast,43,281,294,618
Waller,207,"District Judge, 506th Judicial District",,REP,Under Votes,9,37,41,87
Waller,207,"District Judge, 506th Judicial District",,REP,Over Votes,0,0,0,0
Waller,207,Sheriff,,REP,Dan Porter,6,15,34,55
Waller,207,Sheriff,,REP,R. Glenn Smith,20,96,105,221
Waller,207,Sheriff,,REP,Troy Guidry,23,199,187,409
Waller,207,Sheriff,,REP,Ballots Cast,49,310,326,685
Waller,207,Sheriff,,REP,Under Votes,3,8,9,20
Waller,207,Sheriff,,REP,Over Votes,0,0,0,0
Waller,207,County Tax Assessor-Collector,,REP,Ellen Contreras Shelburne,30,195,173,398
Waller,207,County Tax Assessor-Collector,,REP,Carolyn Miedke,18,107,128,253
Waller,207,County Tax Assessor-Collector,,REP,Ballots Cast,48,302,301,651
Waller,207,County Tax Assessor-Collector,,REP,Under Votes,4,16,34,54
Waller,207,County Tax Assessor-Collector,,REP,Over Votes,0,0,0,0
Waller,207,"Constable, Precinct 2",,REP,Glenn White,44,285,302,631
Waller,207,"Constable, Precinct 2",,REP,Ballots Cast,44,285,302,631
Waller,207,"Constable, Precinct 2",,REP,Under Votes,8,33,33,74
Waller,207,"Constable, Precinct 2",,REP,Over Votes,0,0,0,0
Waller,207,County Chairman,,REP,David W. Luther,43,281,293,617
Waller,207,County Chairman,,REP,Ballots Cast,43,281,293,617
Waller,207,County Chairman,,REP,Under Votes,9,37,42,88
Waller,207,County Chairman,,REP,Over Votes,0,0,0,0
Waller,207,Proposition #1,,DEM,Yes,16,25,71,112
Waller,207,Proposition #1,,DEM,No,0,1,8,9
Waller,207,Proposition #1,,DEM,Ballots Cast,16,26,79,121
Waller,207,Proposition #1,,DEM,Under Votes,0,0,5,5
Waller,207,Proposition #1,,DEM,Over Votes,0,0,0,0
Waller,207,Proposition #2,,DEM,Yes,16,25,70,111
Waller,207,Proposition #2,,DEM,No,0,1,9,10
Waller,207,Proposition #2,,DEM,Ballots Cast,16,26,79,121
Waller,207,Proposition #2,,DEM,Under Votes,0,0,5,5
Waller,207,Proposition #2,,DEM,Over Votes,0,0,0,0
Waller,207,Proposition #3,,DEM,Yes,16,26,75,117
Waller,207,Proposition #3,,DEM,No,0,0,5,5
Waller,207,Proposition #3,,DEM,Ballots Cast,16,26,80,122
Waller,207,Proposition #3,,DEM,Under Votes,0,0,4,4
Waller,207,Proposition #3,,DEM,Over Votes,0,0,0,0
Waller,207,Proposition #4,,DEM,Yes,15,25,66,106
Waller,207,Proposition #4,,DEM,No,1,1,12,14
Waller,207,Proposition #4,,DEM,Ballots Cast,16,26,78,120
Waller,207,Proposition #4,,DEM,Under Votes,0,0,6,6
Waller,207,Proposition #4,,DEM,Over Votes,0,0,0,0
Waller,207,Proposition #5,,DEM,Yes,15,26,71,112
Waller,207,Proposition #5,,DEM,No,1,0,8,9
Waller,207,Proposition #5,,DEM,Ballots Cast,16,26,79,121
Waller,207,Proposition #5,,DEM,Under Votes,0,0,5,5
Waller,207,Proposition #5,,DEM,Over Votes,0,0,0,0
Waller,207,Proposition #6,,DEM,Yes,16,25,75,116
Waller,207,Proposition #6,,DEM,No,0,1,4,5
Waller,207,Proposition #6,,DEM,Ballots Cast,16,26,79,121
Waller,207,Proposition #6,,DEM,Under Votes,0,0,5,5
Waller,207,Proposition #6,,DEM,Over Votes,0,0,0,0
Waller,207,Proposition #7,,DEM,Yes,15,25,66,106
Waller,207,Proposition #7,,DEM,No,1,1,12,14
Waller,207,Proposition #7,,DEM,Ballots Cast,16,26,78,120
Waller,207,Proposition #7,,DEM,Under Votes,0,0,6,6
Waller,207,Proposition #7,,DEM,Over Votes,0,0,0,0
Waller,207,Proposition #8,,DEM,Yes,15,26,70,111
Waller,207,Proposition #8,,DEM,No,1,0,9,10
Waller,207,Proposition #8,,DEM,Ballots Cast,16,26,79,121
Waller,207,Proposition #8,,DEM,Under Votes,0,0,5,5
Waller,207,Proposition #8,,DEM,Over Votes,0,0,0,0
Waller,207,Proposition #9,,DEM,Yes,15,26,71,112
Waller,207,Proposition #9,,DEM,No,1,0,7,8
Waller,207,Proposition #9,,DEM,Ballots Cast,16,26,78,120
Waller,207,Proposition #9,,DEM,Under Votes,0,0,6,6
Waller,207,Proposition #9,,DEM,Over Votes,0,0,0,0
Waller,207,Proposition #10,,DEM,Yes,15,25,70,110
Waller,207,Proposition #10,,DEM,No,1,1,9,11
Waller,207,Proposition #10,,DEM,Ballots Cast,16,26,79,121
Waller,207,Proposition #10,,DEM,Under Votes,0,0,5,5
Waller,207,Proposition #10,,DEM,Over Votes,0,0,0,0
Waller,207,Proposition #11,,DEM,Yes,14,25,69,108
Waller,207,Proposition #11,,DEM,No,2,1,9,12
Waller,207,Proposition #11,,DEM,Ballots Cast,16,26,78,120
Waller,207,Proposition #11,,DEM,Under Votes,0,0,6,6
Waller,207,Proposition #11,,DEM,Over Votes,0,0,0,0
Waller,207,Proposition 1,,REP,Yes,45,288,297,630
Waller,207,Proposition 1,,REP,No,7,25,35,67
Waller,207,Proposition 1,,REP,Ballots Cast,52,313,332,697
Waller,207,Proposition 1,,REP,Under Votes,0,5,3,8
Waller,207,Proposition 1,,REP,Over Votes,0,0,0,0
Waller,207,Proposition 2,,REP,Yes,47,287,306,640
Waller,207,Proposition 2,,REP,No,5,26,27,58
Waller,207,Proposition 2,,REP,Ballots Cast,52,313,333,698
Waller,207,Proposition 2,,REP,Under Votes,0,5,2,7
Waller,207,Proposition 2,,REP,Over Votes,0,0,0,0
Waller,207,Proposition 3,,REP,Yes,52,296,325,673
Waller,207,Proposition 3,,REP,No,0,12,6,18
Waller,207,Proposition 3,,REP,Ballots Cast,52,308,331,691
Waller,207,Proposition 3,,REP,Under Votes,0,10,4,14
Waller,207,Proposition 3,,REP,Over Votes,0,0,0,0
Waller,207,Proposition 4,,REP,Yes,51,306,320,677
Waller,207,Proposition 4,,REP,No,0,7,11,18
Waller,207,Proposition 4,,REP,Ballots Cast,51,313,331,695
Waller,207,Proposition 4,,REP,Under Votes,0,5,4,9
Waller,207,Proposition 4,,REP,Over Votes,1,0,0,1
Waller,207,Proposition 5,,REP,Yes,48,293,317,658
Waller,207,Proposition 5,,REP,No,4,18,13,35
Waller,207,Proposition 5,,REP,Ballots Cast,52,311,330,693
Waller,207,Proposition 5,,REP,Under Votes,0,7,5,12
Waller,207,Proposition 5,,REP,Over Votes,0,0,0,0
Waller,207,Proposition 6,,REP,Yes,52,296,320,668
Waller,207,Proposition 6,,REP,No,0,14,9,23
Waller,207,Proposition 6,,REP,Ballots Cast,52,310,329,691
Waller,207,Proposition 6,,REP,Under Votes,0,8,6,14
Waller,207,Proposition 6,,REP,Over Votes,0,0,0,0
Waller,207,Proposition 7,,REP,Yes,50,314,328,692
Waller,207,Proposition 7,,REP,No,2,0,2,4
Waller,207,Proposition 7,,REP,Ballots Cast,52,314,330,696
Waller,207,Proposition 7,,REP,Under Votes,0,4,5,9
Waller,207,Proposition 7,,REP,Over Votes,0,0,0,0
Waller,207,Proposition 8,,REP,Yes,52,312,327,691
Waller,207,Proposition 8,,REP,No,0,1,2,3
Waller,207,Proposition 8,,REP,Ballots Cast,52,313,329,694
Waller,207,Proposition 8,,REP,Under Votes,0,5,6,11
Waller,207,Proposition 8,,REP,Over Votes,0,0,0,0
Waller,207,Proposition 9,,REP,Yes,49,310,313,672
Waller,207,Proposition 9,,REP,No,2,4,15,21
Waller,207,Proposition 9,,REP,Ballots Cast,51,314,328,693
Waller,207,Proposition 9,,REP,Under Votes,0,4,7,11
Waller,207,Proposition 9,,REP,Over Votes,1,0,0,1
Waller,207,Proposition 10,,REP,Yes,51,301,308,660
Waller,207,Proposition 10,,REP,No,0,10,18,28
Waller,207,Proposition 10,,REP,Ballots Cast,51,311,326,688
Waller,207,Proposition 10,,REP,Under Votes,1,7,9,17
Waller,207,Proposition 10,,REP,Over Votes,0,0,0,0
Waller,208,President,,DEM,Michael Bennet,1,2,0,3
Waller,208,President,,DEM,Marianne Williamson,0,0,0,0
Waller,208,President,,DEM,Cory Booker,0,1,1,2
Waller,208,President,,DEM,Bernie Sanders,6,21,26,53
Waller,208,President,,DEM,Tulsi Gabbard,0,0,1,1
Waller,208,President,,DEM,Deval Patrick,0,0,1,1
Waller,208,President,,DEM,Amy Klobuchar,1,1,1,3
Waller,208,President,,DEM,Julián Castro,0,0,1,1
Waller,208,President,,DEM,Elizabeth Warren,2,2,5,9
Waller,208,President,,DEM,John K. Delaney,0,0,0,0
Waller,208,President,,DEM,Robby Wells,0,0,0,0
Waller,208,President,,DEM,"Roque ""Rocky"" De La Fuente",0,0,0,0
Waller,208,President,,DEM,Andrew Yang,0,0,1,1
Waller,208,President,,DEM,Joseph R. Biden,2,6,24,32
Waller,208,President,,DEM,Michael R. Bloomberg,5,11,10,26
Waller,208,President,,DEM,Tom Steyer,0,0,0,0
Waller,208,President,,DEM,Pete Buttigieg,0,2,1,3
Waller,208,President,,DEM,Ballots Cast,17,46,72,135
Waller,208,President,,DEM,Under Votes,0,1,0,1
Waller,208,President,,DEM,Over Votes,0,0,0,0
Waller,208,U.S. Senate,,DEM,Royce West,0,7,10,17
Waller,208,U.S. Senate,,DEM,"Annie ""Mamá"" Garcia",1,4,9,14
Waller,208,U.S. Senate,,DEM,D. R. Hunter,0,0,1,1
Waller,208,U.S. Senate,,DEM,Sema Hernandez,1,2,4,7
Waller,208,U.S. Senate,,DEM,Adrian Ocegueda,0,0,1,1
Waller,208,U.S. Senate,,DEM,Chris Bell,4,13,18,35
Waller,208,U.S. Senate,,DEM,Cristina Tzintzun Ramirez,1,6,7,14
Waller,208,U.S. Senate,,DEM,Jack Daniel Foster Jr,0,5,0,5
Waller,208,U.S. Senate,,DEM,Amanda K. Edwards,3,1,1,5
Waller,208,U.S. Senate,,DEM,Victor Hugo Harris,0,1,0,1
Waller,208,U.S. Senate,,DEM,"Mary ""MJ"" Hegar",6,5,12,23
Waller,208,U.S. Senate,,DEM,Michael Cooper,0,0,1,1
Waller,208,U.S. Senate,,DEM,Ballots Cast,16,44,64,124
Waller,208,U.S. Senate,,DEM,Under Votes,1,3,8,12
Waller,208,U.S. Senate,,DEM,Over Votes,0,0,0,0
Waller,208,U.S. House,10,DEM,Mike Siegel,9,21,24,54
Waller,208,U.S. House,10,DEM,Shannon Hutcheson,1,13,21,35
Waller,208,U.S. House,10,DEM,Pritesh Gandhi,6,12,21,39
Waller,208,U.S. House,10,DEM,Ballots Cast,16,46,66,128
Waller,208,U.S. House,10,DEM,Under Votes,1,1,6,8
Waller,208,U.S. House,10,DEM,Over Votes,0,0,0,0
Waller,208,Railroad Commissioner,,DEM,"Roberto R. ""Beto"" Alonzo",2,15,16,33
Waller,208,Railroad Commissioner,,DEM,Chrysta Castañeda,2,12,16,30
Waller,208,Railroad Commissioner,,DEM,Mark Watson,5,14,14,33
Waller,208,Railroad Commissioner,,DEM,Kelly Stone,5,3,18,26
Waller,208,Railroad Commissioner,,DEM,Ballots Cast,14,44,64,122
Waller,208,Railroad Commissioner,,DEM,Under Votes,3,3,8,14
Waller,208,Railroad Commissioner,,DEM,Over Votes,0,0,0,0
Waller,208,"Chief Justice, Supreme Court",,DEM,Jerry Zimmerer,3,14,14,31
Waller,208,"Chief Justice, Supreme Court",,DEM,Amy Clark Meachum,11,29,49,89
Waller,208,"Chief Justice, Supreme Court",,DEM,Ballots Cast,14,43,63,120
Waller,208,"Chief Justice, Supreme Court",,DEM,Under Votes,3,4,9,16
Waller,208,"Chief Justice, Supreme Court",,DEM,Over Votes,0,0,0,0
Waller,208,"Justice, Supreme Court, Place 6 Unexpired Term",,DEM,Kathy Cheng,9,37,51,97
Waller,208,"Justice, Supreme Court, Place 6 Unexpired Term",,DEM,Larry Praeger,5,6,11,22
Waller,208,"Justice, Supreme Court, Place 6 Unexpired Term",,DEM,Ballots Cast,14,43,62,119
Waller,208,"Justice, Supreme Court, Place 6 Unexpired Term",,DEM,Under Votes,3,4,10,17
Waller,208,"Justice, Supreme Court, Place 6 Unexpired Term",,DEM,Over Votes,0,0,0,0
Waller,208,"Justice, Supreme Court, Place 7",,DEM,Staci Williams,9,32,47,88
Waller,208,"Justice, Supreme Court, Place 7",,DEM,Brandy Voss,5,10,16,31
Waller,208,"Justice, Supreme Court, Place 7",,DEM,Ballots Cast,14,42,63,119
Waller,208,"Justice, Supreme Court, Place 7",,DEM,Under Votes,3,5,9,17
Waller,208,"Justice, Supreme Court, Place 7",,DEM,Over Votes,0,0,0,0
Waller,208,"Justice, Supreme Court, Place 8",,DEM,Gisela D. Triana,5,28,36,69
Waller,208,"Justice, Supreme Court, Place 8",,DEM,Peter Kelly,9,14,23,46
Waller,208,"Justice, Supreme Court, Place 8",,DEM,Ballots Cast,14,42,59,115
Waller,208,"Justice, Supreme Court, Place 8",,DEM,Under Votes,3,5,13,21
Waller,208,"Justice, Supreme Court, Place 8",,DEM,Over Votes,0,0,0,0
Waller,208,"Judge, Court of Criminal Appeals, Place 3",,DEM,Elizabeth Davis Frizell,5,28,36,69
Waller,208,"Judge, Court of Criminal Appeals, Place 3",,DEM,William Pieratt Demond,1,7,8,16
Waller,208,"Judge, Court of Criminal Appeals, Place 3",,DEM,Dan Wood,8,7,17,32
Waller,208,"Judge, Court of Criminal Appeals, Place 3",,DEM,Ballots Cast,14,42,61,117
Waller,208,"Judge, Court of Criminal Appeals, Place 3",,DEM,Under Votes,3,5,11,19
Waller,208,"Judge, Court of Criminal Appeals, Place 3",,DEM,Over Votes,0,0,0,0
Waller,208,"Judge, Court of Criminal Appeals, Place 4",,DEM,Steven Miears,4,15,12,31
Waller,208,"Judge, Court of Criminal Appeals, Place 4",,DEM,Tina Clinton,10,27,51,88
Waller,208,"Judge, Court of Criminal Appeals, Place 4",,DEM,Ballots Cast,14,42,63,119
Waller,208,"Judge, Court of Criminal Appeals, Place 4",,DEM,Under Votes,3,5,9,17
Waller,208,"Judge, Court of Criminal Appeals, Place 4",,DEM,Over Votes,0,0,0,0
Waller,208,"Judge, Court of Criminal Appeals, Place 9",,DEM,Brandon Birmingham,15,42,61,118
Waller,208,"Judge, Court of Criminal Appeals, Place 9",,DEM,Ballots Cast,15,42,61,118
Waller,208,"Judge, Court of Criminal Appeals, Place 9",,DEM,Under Votes,2,5,11,18
Waller,208,"Judge, Court of Criminal Appeals, Place 9",,DEM,Over Votes,0,0,0,0
Waller,208,"Member, State Board of Education, District 10",,DEM,Stephen Wyman,5,10,15,30
Waller,208,"Member, State Board of Education, District 10",,DEM,Marsha Burnett-Webster,9,32,48,89
Waller,208,"Member, State Board of Education, District 10",,DEM,Ballots Cast,14,42,63,119
Waller,208,"Member, State Board of Education, District 10",,DEM,Under Votes,3,5,9,17
Waller,208,"Member, State Board of Education, District 10",,DEM,Over Votes,0,0,0,0
Waller,208,State Senate,18,DEM,Michael Antalan,15,42,62,119
Waller,208,State Senate,18,DEM,Ballots Cast,15,42,62,119
Waller,208,State Senate,18,DEM,Under Votes,2,5,10,17
Waller,208,State Senate,18,DEM,Over Votes,0,0,0,0
Waller,208,State Representative,3,DEM,Martin Shupp,15,42,62,119
Waller,208,State Representative,3,DEM,Ballots Cast,15,42,62,119
Waller,208,State Representative,3,DEM,Under Votes,2,5,10,17
Waller,208,State Representative,3,DEM,Over Votes,0,0,0,0
Waller,208,"Chief Justice, 14th Court of Appeals District",,DEM,Jane Robinson,10,32,49,91
Waller,208,"Chief Justice, 14th Court of Appeals District",,DEM,Jim Evans,5,9,14,28
Waller,208,"Chief Justice, 14th Court of Appeals District",,DEM,Ballots Cast,15,41,63,119
Waller,208,"Chief Justice, 14th Court of Appeals District",,DEM,Under Votes,2,6,9,17
Waller,208,"Chief Justice, 14th Court of Appeals District",,DEM,Over Votes,0,0,0,0
Waller,208,"Justice, 1st Court of Appeals District, Place 3",,DEM,Jim Sharp,5,14,21,40
Waller,208,"Justice, 1st Court of Appeals District, Place 3",,DEM,Dinesh Singhal,5,8,16,29
Waller,208,"Justice, 1st Court of Appeals District, Place 3",,DEM,Veronica Rivas-Molloy,5,20,28,53
Waller,208,"Justice, 1st Court of Appeals District, Place 3",,DEM,Ballots Cast,15,42,65,122
Waller,208,"Justice, 1st Court of Appeals District, Place 3",,DEM,Under Votes,2,5,7,14
Waller,208,"Justice, 1st Court of Appeals District, Place 3",,DEM,Over Votes,0,0,0,0
Waller,208,"Justice, 1st Court of Appeals District, Place 5",,DEM,Tim Hootman,6,19,17,42
Waller,208,"Justice, 1st Court of Appeals District, Place 5",,DEM,Amparo Monique Guerra,8,23,46,77
Waller,208,"Justice, 1st Court of Appeals District, Place 5",,DEM,Ballots Cast,14,42,63,119
Waller,208,"Justice, 1st Court of Appeals District, Place 5",,DEM,Under Votes,3,5,9,17
Waller,208,"Justice, 1st Court of Appeals District, Place 5",,DEM,Over Votes,0,0,0,0
Waller,208,"Justice, 14th Court of Appeals District, Place 7",,DEM,"Tamika ""Tami"" Craft",1,14,22,37
Waller,208,"Justice, 14th Court of Appeals District, Place 7",,DEM,Wally Kronzer,4,1,3,8
Waller,208,"Justice, 14th Court of Appeals District, Place 7",,DEM,V.R. Faulkner,5,2,3,10
Waller,208,"Justice, 14th Court of Appeals District, Place 7",,DEM,Cheri Thomas,3,13,19,35
Waller,208,"Justice, 14th Court of Appeals District, Place 7",,DEM,Dominic J. Merino,0,4,4,8
Waller,208,"Justice, 14th Court of Appeals District, Place 7",,DEM,Lennon C. Wright,1,7,10,18
Waller,208,"Justice, 14th Court of Appeals District, Place 7",,DEM,Ballots Cast,14,41,61,116
Waller,208,"Justice, 14th Court of Appeals District, Place 7",,DEM,Under Votes,3,6,11,20
Waller,208,"Justice, 14th Court of Appeals District, Place 7",,DEM,Over Votes,0,0,0,0
Waller,208,Sheriff,,DEM,Cedric D. Watson,15,41,63,119
Waller,208,Sheriff,,DEM,Ballots Cast,15,41,63,119
Waller,208,Sheriff,,DEM,Under Votes,2,6,9,17
Waller,208,Sheriff,,DEM,Over Votes,0,0,0,0
Waller,208,County Chairman,,DEM,Rosa Patlan Harris,15,39,66,120
Waller,208,County Chairman,,DEM,Ballots Cast,15,39,66,120
Waller,208,County Chairman,,DEM,Under Votes,2,8,6,16
Waller,208,County Chairman,,DEM,Over Votes,0,0,0,0
Waller,208,President,,REP,Donald J. Trump,8,148,105,261
Waller,208,President,,REP,Joe Walsh,0,1,0,1
Waller,208,President,,REP,Bob Ely,0,0,0,0
Waller,208,President,,REP,"Roque ""Rocky"" De La Fuente Guerra",0,1,0,1
Waller,208,President,,REP,Zoltan G. Istvan,0,0,0,0
Waller,208,President,,REP,Matthew John Matern,0,0,0,0
Waller,208,President,,REP,Bill Weld,0,0,1,1
Waller,208,President,,REP,Uncommitted,0,6,6,12
Waller,208,President,,REP,Ballots Cast,8,156,112,276
Waller,208,President,,REP,Under Votes,0,1,2,3
Waller,208,President,,REP,Over Votes,0,0,0,0
Waller,208,U.S. Senate,,REP,Dwayne Stovall,0,34,23,57
Waller,208,U.S. Senate,,REP,Mark Yancey,0,6,9,15
Waller,208,U.S. Senate,,REP,Virgil Bierschwale,0,0,0,0
Waller,208,U.S. Senate,,REP,John Anthony Castro,0,3,6,9
Waller,208,U.S. Senate,,REP,John Cornyn,8,105,63,176
Waller,208,U.S. Senate,,REP,Ballots Cast,8,148,101,257
Waller,208,U.S. Senate,,REP,Under Votes,0,9,13,22
Waller,208,U.S. Senate,,REP,Over Votes,0,0,0,0
Waller,208,U.S. House,10,REP,Michael McCaul,8,149,104,261
Waller,208,U.S. House,10,REP,Ballots Cast,8,149,104,261
Waller,208,U.S. House,10,REP,Under Votes,0,8,10,18
Waller,208,U.S. House,10,REP,Over Votes,0,0,0,0
Waller,208,Railroad Commissioner,,REP,Ryan Sitton,7,88,60,155
Waller,208,Railroad Commissioner,,REP,"James ""Jim"" Wright",1,52,36,89
Waller,208,Railroad Commissioner,,REP,Ballots Cast,8,140,96,244
Waller,208,Railroad Commissioner,,REP,Under Votes,0,17,18,35
Waller,208,Railroad Commissioner,,REP,Over Votes,0,0,0,0
Waller,208,"Chief Justice, Supreme Court",,REP,Nathan Hecht,8,140,94,242
Waller,208,"Chief Justice, Supreme Court",,REP,Ballots Cast,8,140,94,242
Waller,208,"Chief Justice, Supreme Court",,REP,Under Votes,0,17,20,37
Waller,208,"Chief Justice, Supreme Court",,REP,Over Votes,0,0,0,0
Waller,208,"Justice, Supreme Court, Place 6 Unexpired Term",,REP,Jane Bland,8,140,89,237
Waller,208,"Justice, Supreme Court, Place 6 Unexpired Term",,REP,Ballots Cast,8,140,89,237
Waller,208,"Justice, Supreme Court, Place 6 Unexpired Term",,REP,Under Votes,0,17,25,42
Waller,208,"Justice, Supreme Court, Place 6 Unexpired Term",,REP,Over Votes,0,0,0,0
Waller,208,"Justice, Supreme Court, Place 7",,REP,Jeff Boyd,8,139,90,237
Waller,208,"Justice, Supreme Court, Place 7",,REP,Ballots Cast,8,139,90,237
Waller,208,"Justice, Supreme Court, Place 7",,REP,Under Votes,0,18,24,42
Waller,208,"Justice, Supreme Court, Place 7",,REP,Over Votes,0,0,0,0
Waller,208,"Justice, Supreme Court, Place 8",,REP,Brett Busby,8,140,91,239
Waller,208,"Justice, Supreme Court, Place 8",,REP,Ballots Cast,8,140,91,239
Waller,208,"Justice, Supreme Court, Place 8",,REP,Under Votes,0,17,23,40
Waller,208,"Justice, Supreme Court, Place 8",,REP,Over Votes,0,0,0,0
Waller,208,"Judge, Court of Criminal Appeals, Place 3",,REP,Gina Parker,1,68,44,113
Waller,208,"Judge, Court of Criminal Appeals, Place 3",,REP,Bert Richardson,7,66,52,125
Waller,208,"Judge, Court of Criminal Appeals, Place 3",,REP,Ballots Cast,8,134,96,238
Waller,208,"Judge, Court of Criminal Appeals, Place 3",,REP,Under Votes,0,23,18,41
Waller,208,"Judge, Court of Criminal Appeals, Place 3",,REP,Over Votes,0,0,0,0
Waller,208,"Judge, Court of Criminal Appeals, Place 4",,REP,Kevin Patrick Yeary,8,136,89,233
Waller,208,"Judge, Court of Criminal Appeals, Place 4",,REP,Ballots Cast,8,136,89,233
Waller,208,"Judge, Court of Criminal Appeals, Place 4",,REP,Under Votes,0,21,25,46
Waller,208,"Judge, Court of Criminal Appeals, Place 4",,REP,Over Votes,0,0,0,0
Waller,208,"Judge, Court of Criminal Appeals, Place 9",,REP,David Newell,8,137,89,234
Waller,208,"Judge, Court of Criminal Appeals, Place 9",,REP,Ballots Cast,8,137,89,234
Waller,208,"Judge, Court of Criminal Appeals, Place 9",,REP,Under Votes,0,20,25,45
Waller,208,"Judge, Court of Criminal Appeals, Place 9",,REP,Over Votes,0,0,0,0
Waller,208,"Member, State Board of Education, District 10",,REP,Tom Maynard,8,138,92,238
Waller,208,"Member, State Board of Education, District 10",,REP,Ballots Cast,8,138,92,238
Waller,208,"Member, State Board of Education, District 10",,REP,Under Votes,0,19,22,41
Waller,208,"Member, State Board of Education, District 10",,REP,Over Votes,0,0,0,0
Waller,208,State Senate,18,REP,Lois W. Kolkhorst,8,142,96,246
Waller,208,State Senate,18,REP,Ballots Cast,8,142,96,246
Waller,208,State Senate,18,REP,Under Votes,0,15,18,33
Waller,208,State Senate,18,REP,Over Votes,0,0,0,0
Waller,208,State Representative,3,REP,Cecil Bell Jr,8,144,98,250
Waller,208,State Representative,3,REP,Ballots Cast,8,144,98,250
Waller,208,State Representative,3,REP,Under Votes,0,13,16,29
Waller,208,State Representative,3,REP,Over Votes,0,0,0,0
Waller,208,"Chief Justice, 14th Court of Appeals District",,REP,Tracy Elizabeth Christopher,8,140,89,237
Waller,208,"Chief Justice, 14th Court of Appeals District",,REP,Ballots Cast,8,140,89,237
Waller,208,"Chief Justice, 14th Court of Appeals District",,REP,Under Votes,0,17,25,42
Waller,208,"Chief Justice, 14th Court of Appeals District",,REP,Over Votes,0,0,0,0
Waller,208,"Justice, 1st Court of Appeals District, Place 3",,REP,Russell Lloyd,8,138,90,236
Waller,208,"Justice, 1st Court of Appeals District, Place 3",,REP,Ballots Cast,8,138,90,236
Waller,208,"Justice, 1st Court of Appeals District, Place 3",,REP,Under Votes,0,19,24,43
Waller,208,"Justice, 1st Court of Appeals District, Place 3",,REP,Over Votes,0,0,0,0
Waller,208,"Justice, 1st Court of Appeals District, Place 5",,REP,Chad Bridges,2,49,29,80
Waller,208,"Justice, 1st Court of Appeals District, Place 5",,REP,James Lombardino,0,12,10,22
Waller,208,"Justice, 1st Court of Appeals District, Place 5",,REP,Levi J. Benton,4,27,14,45
Waller,208,"Justice, 1st Court of Appeals District, Place 5",,REP,Terry Adams,2,32,33,67
Waller,208,"Justice, 1st Court of Appeals District, Place 5",,REP,Ballots Cast,8,120,86,214
Waller,208,"Justice, 1st Court of Appeals District, Place 5",,REP,Under Votes,0,37,28,65
Waller,208,"Justice, 1st Court of Appeals District, Place 5",,REP,Over Votes,0,0,0,0
Waller,208,"Justice, 14th Court of Appeals District, Place 7",,REP,Ken Wise,8,137,85,230
Waller,208,"Justice, 14th Court of Appeals District, Place 7",,REP,Ballots Cast,8,137,85,230
Waller,208,"Justice, 14th Court of Appeals District, Place 7",,REP,Under Votes,0,20,29,49
Waller,208,"Justice, 14th Court of Appeals District, Place 7",,REP,Over Votes,0,0,0,0
Waller,208,"District Judge, 506th Judicial District",,REP,Gary W. Chaney,8,141,92,241
Waller,208,"District Judge, 506th Judicial District",,REP,Ballots Cast,8,141,92,241
Waller,208,"District Judge, 506th Judicial District",,REP,Under Votes,0,16,22,38
Waller,208,"District Judge, 506th Judicial District",,REP,Over Votes,0,0,0,0
Waller,208,Sheriff,,REP,Dan Porter,3,4,9,16
Waller,208,Sheriff,,REP,R. Glenn Smith,3,82,54,139
Waller,208,Sheriff,,REP,Troy Guidry,2,69,48,119
Waller,208,Sheriff,,REP,Ballots Cast,8,155,111,274
Waller,208,Sheriff,,REP,Under Votes,0,2,3,5
Waller,208,Sheriff,,REP,Over Votes,0,0,0,0
Waller,208,County Tax Assessor-Collector,,REP,Ellen Contreras Shelburne,8,95,61,164
Waller,208,County Tax Assessor-Collector,,REP,Carolyn Miedke,0,56,45,101
Waller,208,County Tax Assessor-Collector,,REP,Ballots Cast,8,151,106,265
Waller,208,County Tax Assessor-Collector,,REP,Under Votes,0,6,8,14
Waller,208,County Tax Assessor-Collector,,REP,Over Votes,0,0,0,0
Waller,208,"Constable, Precinct 2",,REP,Glenn White,8,141,98,247
Waller,208,"Constable, Precinct 2",,REP,Ballots Cast,8,141,98,247
Waller,208,"Constable, Precinct 2",,REP,Under Votes,0,16,16,32
Waller,208,"Constable, Precinct 2",,REP,Over Votes,0,0,0,0
Waller,208,County Chairman,,REP,David W. Luther,8,137,91,236
Waller,208,County Chairman,,REP,Ballots Cast,8,137,91,236
Waller,208,County Chairman,,REP,Under Votes,0,20,23,43
Waller,208,County Chairman,,REP,Over Votes,0,0,0,0
Waller,208,Proposition #1,,DEM,Yes,16,45,67,128
Waller,208,Proposition #1,,DEM,No,0,1,4,5
Waller,208,Proposition #1,,DEM,Ballots Cast,16,46,71,133
Waller,208,Proposition #1,,DEM,Under Votes,1,1,1,3
Waller,208,Proposition #1,,DEM,Over Votes,0,0,0,0
Waller,208,Proposition #2,,DEM,Yes,16,45,64,125
Waller,208,Proposition #2,,DEM,No,0,1,6,7
Waller,208,Proposition #2,,DEM,Ballots Cast,16,46,70,132
Waller,208,Proposition #2,,DEM,Under Votes,1,1,2,4
Waller,208,Proposition #2,,DEM,Over Votes,0,0,0,0
Waller,208,Proposition #3,,DEM,Yes,16,46,70,132
Waller,208,Proposition #3,,DEM,No,0,0,0,0
Waller,208,Proposition #3,,DEM,Ballots Cast,16,46,70,132
Waller,208,Proposition #3,,DEM,Under Votes,1,1,2,4
Waller,208,Proposition #3,,DEM,Over Votes,0,0,0,0
Waller,208,Proposition #4,,DEM,Yes,16,46,67,129
Waller,208,Proposition #4,,DEM,No,0,0,2,2
Waller,208,Proposition #4,,DEM,Ballots Cast,16,46,69,131
Waller,208,Proposition #4,,DEM,Under Votes,1,1,3,5
Waller,208,Proposition #4,,DEM,Over Votes,0,0,0,0
Waller,208,Proposition #5,,DEM,Yes,15,46,68,129
Waller,208,Proposition #5,,DEM,No,1,0,1,2
Waller,208,Proposition #5,,DEM,Ballots Cast,16,46,69,131
Waller,208,Proposition #5,,DEM,Under Votes,1,1,3,5
Waller,208,Proposition #5,,DEM,Over Votes,0,0,0,0
Waller,208,Proposition #6,,DEM,Yes,16,46,66,128
Waller,208,Proposition #6,,DEM,No,0,0,1,1
Waller,208,Proposition #6,,DEM,Ballots Cast,16,46,67,129
Waller,208,Proposition #6,,DEM,Under Votes,1,1,5,7
Waller,208,Proposition #6,,DEM,Over Votes,0,0,0,0
Waller,208,Proposition #7,,DEM,Yes,15,42,63,120
Waller,208,Proposition #7,,DEM,No,1,3,5,9
Waller,208,Proposition #7,,DEM,Ballots Cast,16,45,68,129
Waller,208,Proposition #7,,DEM,Under Votes,1,2,4,7
Waller,208,Proposition #7,,DEM,Over Votes,0,0,0,0
Waller,208,Proposition #8,,DEM,Yes,15,45,66,126
Waller,208,Proposition #8,,DEM,No,1,2,4,7
Waller,208,Proposition #8,,DEM,Ballots Cast,16,47,70,133
Waller,208,Proposition #8,,DEM,Under Votes,1,0,2,3
Waller,208,Proposition #8,,DEM,Over Votes,0,0,0,0
Waller,208,Proposition #9,,DEM,Yes,16,46,67,129
Waller,208,Proposition #9,,DEM,No,0,0,2,2
Waller,208,Proposition #9,,DEM,Ballots Cast,16,46,69,131
Waller,208,Proposition #9,,DEM,Under Votes,1,1,3,5
Waller,208,Proposition #9,,DEM,Over Votes,0,0,0,0
Waller,208,Proposition #10,,DEM,Yes,15,46,66,127
Waller,208,Proposition #10,,DEM,No,1,1,4,6
Waller,208,Proposition #10,,DEM,Ballots Cast,16,47,70,133
Waller,208,Proposition #10,,DEM,Under Votes,1,0,2,3
Waller,208,Proposition #10,,DEM,Over Votes,0,0,0,0
Waller,208,Proposition #11,,DEM,Yes,16,43,65,124
Waller,208,Proposition #11,,DEM,No,0,4,4,8
Waller,208,Proposition #11,,DEM,Ballots Cast,16,47,69,132
Waller,208,Proposition #11,,DEM,Under Votes,1,0,3,4
Waller,208,Proposition #11,,DEM,Over Votes,0,0,0,0
Waller,208,Proposition 1,,REP,Yes,8,130,93,231
Waller,208,Proposition 1,,REP,No,0,22,17,39
Waller,208,Proposition 1,,REP,Ballots Cast,8,152,110,270
Waller,208,Proposition 1,,REP,Under Votes,0,5,4,9
Waller,208,Proposition 1,,REP,Over Votes,0,0,0,0
Waller,208,Proposition 2,,REP,Yes,7,134,89,230
Waller,208,Proposition 2,,REP,No,0,19,18,37
Waller,208,Proposition 2,,REP,Ballots Cast,7,153,107,267
Waller,208,Proposition 2,,REP,Under Votes,0,4,7,11
Waller,208,Proposition 2,,REP,Over Votes,1,0,0,1
Waller,208,Proposition 3,,REP,Yes,8,143,101,252
Waller,208,Proposition 3,,REP,No,0,12,6,18
Waller,208,Proposition 3,,REP,Ballots Cast,8,155,107,270
Waller,208,Proposition 3,,REP,Under Votes,0,2,7,9
Waller,208,Proposition 3,,REP,Over Votes,0,0,0,0
Waller,208,Proposition 4,,REP,Yes,8,143,99,250
Waller,208,Proposition 4,,REP,No,0,11,9,20
Waller,208,Proposition 4,,REP,Ballots Cast,8,154,108,270
Waller,208,Proposition 4,,REP,Under Votes,0,3,6,9
Waller,208,Proposition 4,,REP,Over Votes,0,0,0,0
Waller,208,Proposition 5,,REP,Yes,7,140,96,243
Waller,208,Proposition 5,,REP,No,1,14,14,29
Waller,208,Proposition 5,,REP,Ballots Cast,8,154,110,272
Waller,208,Proposition 5,,REP,Under Votes,0,3,4,7
Waller,208,Proposition 5,,REP,Over Votes,0,0,0,0
Waller,208,Proposition 6,,REP,Yes,8,138,101,247
Waller,208,Proposition 6,,REP,No,0,13,8,21
Waller,208,Proposition 6,,REP,Ballots Cast,8,151,109,268
Waller,208,Proposition 6,,REP,Under Votes,0,6,5,11
Waller,208,Proposition 6,,REP,Over Votes,0,0,0,0
Waller,208,Proposition 7,,REP,Yes,8,149,110,267
Waller,208,Proposition 7,,REP,No,0,3,1,4
Waller,208,Proposition 7,,REP,Ballots Cast,8,152,111,271
Waller,208,Proposition 7,,REP,Under Votes,0,5,3,8
Waller,208,Proposition 7,,REP,Over Votes,0,0,0,0
Waller,208,Proposition 8,,REP,Yes,8,150,111,269
Waller,208,Proposition 8,,REP,No,0,3,1,4
Waller,208,Proposition 8,,REP,Ballots Cast,8,153,112,273
Waller,208,Proposition 8,,REP,Under Votes,0,4,2,6
Waller,208,Proposition 8,,REP,Over Votes,0,0,0,0
Waller,208,Proposition 9,,REP,Yes,8,151,102,261
Waller,208,Proposition 9,,REP,No,0,1,7,8
Waller,208,Proposition 9,,REP,Ballots Cast,8,152,109,269
Waller,208,Proposition 9,,REP,Under Votes,0,5,5,10
Waller,208,Proposition 9,,REP,Over Votes,0,0,0,0
Waller,208,Proposition 10,,REP,Yes,8,145,101,254
Waller,208,Proposition 10,,REP,No,0,9,7,16
Waller,208,Proposition 10,,REP,Ballots Cast,8,154,108,270
Waller,208,Proposition 10,,REP,Under Votes,0,3,6,9
Waller,208,Proposition 10,,REP,Over Votes,0,0,0,0
Waller,309,President,,DEM,Michael Bennet,0,0,4,4
Waller,309,President,,DEM,Marianne Williamson,0,3,0,3
Waller,309,President,,DEM,Cory Booker,0,3,4,7
Waller,309,President,,DEM,Bernie Sanders,0,101,191,292
Waller,309,President,,DEM,Tulsi Gabbard,0,0,1,1
Waller,309,President,,DEM,Deval Patrick,0,0,0,0
Waller,309,President,,DEM,Amy Klobuchar,0,0,0,0
Waller,309,President,,DEM,Julián Castro,0,2,1,3
Waller,309,President,,DEM,Elizabeth Warren,1,15,30,46
Waller,309,President,,DEM,John K. Delaney,0,0,0,0
Waller,309,President,,DEM,Robby Wells,0,0,0,0
Waller,309,President,,DEM,"Roque ""Rocky"" De La Fuente",0,0,0,0
Waller,309,President,,DEM,Andrew Yang,0,0,1,1
Waller,309,President,,DEM,Joseph R. Biden,2,19,93,114
Waller,309,President,,DEM,Michael R. Bloomberg,1,8,7,16
Waller,309,President,,DEM,Tom Steyer,0,1,1,2
Waller,309,President,,DEM,Pete Buttigieg,1,5,3,9
Waller,309,President,,DEM,Ballots Cast,5,157,336,498
Waller,309,President,,DEM,Under Votes,0,6,3,9
Waller,309,President,,DEM,Over Votes,0,0,0,0
Waller,309,U.S. Senate,,DEM,Royce West,1,96,170,267
Waller,309,U.S. Senate,,DEM,"Annie ""Mamá"" Garcia",0,6,46,52
Waller,309,U.S. Senate,,DEM,D. R. Hunter,0,1,7,8
Waller,309,U.S. Senate,,DEM,Sema Hernandez,1,1,8,10
Waller,309,U.S. Senate,,DEM,Adrian Ocegueda,0,2,6,8
Waller,309,U.S. Senate,,DEM,Chris Bell,1,12,19,32
Waller,309,U.S. Senate,,DEM,Cristina Tzintzun Ramirez,0,2,11,13
Waller,309,U.S. Senate,,DEM,Jack Daniel Foster Jr,0,3,12,15
Waller,309,U.S. Senate,,DEM,Amanda K. Edwards,0,4,15,19
Waller,309,U.S. Senate,,DEM,Victor Hugo Harris,0,0,7,7
Waller,309,U.S. Senate,,DEM,"Mary ""MJ"" Hegar",1,5,4,10
Waller,309,U.S. Senate,,DEM,Michael Cooper,1,8,12,21
Waller,309,U.S. Senate,,DEM,Ballots Cast,5,140,317,462
Waller,309,U.S. Senate,,DEM,Under Votes,0,23,22,45
Waller,309,U.S. Senate,,DEM,Over Votes,0,0,0,0
Waller,309,U.S. House,10,DEM,Mike Siegel,2,74,171,247
Waller,309,U.S. House,10,DEM,Shannon Hutcheson,2,43,104,149
Waller,309,U.S. House,10,DEM,Pritesh Gandhi,1,12,39,52
Waller,309,U.S. House,10,DEM,Ballots Cast,5,129,314,448
Waller,309,U.S. House,10,DEM,Under Votes,0,34,25,59
Waller,309,U.S. House,10,DEM,Over Votes,0,0,0,0
Waller,309,Railroad Commissioner,,DEM,"Roberto R. ""Beto"" Alonzo",2,55,142,199
Waller,309,Railroad Commissioner,,DEM,Chrysta Castañeda,2,17,42,61
Waller,309,Railroad Commissioner,,DEM,Mark Watson,1,28,55,84
Waller,309,Railroad Commissioner,,DEM,Kelly Stone,0,20,61,81
Waller,309,Railroad Commissioner,,DEM,Ballots Cast,5,120,300,425
Waller,309,Railroad Commissioner,,DEM,Under Votes,0,43,39,82
Waller,309,Railroad Commissioner,,DEM,Over Votes,0,0,0,0
Waller,309,"Chief Justice, Supreme Court",,DEM,Jerry Zimmerer,1,28,56,85
Waller,309,"Chief Justice, Supreme Court",,DEM,Amy Clark Meachum,4,89,239,332
Waller,309,"Chief Justice, Supreme Court",,DEM,Ballots Cast,5,117,295,417
Waller,309,"Chief Justice, Supreme Court",,DEM,Under Votes,0,46,44,90
Waller,309,"Chief Justice, Supreme Court",,DEM,Over Votes,0,0,0,0
Waller,309,"Justice, Supreme Court, Place 6 Unexpired Term",,DEM,Kathy Cheng,3,90,237,330
Waller,309,"Justice, Supreme Court, Place 6 Unexpired Term",,DEM,Larry Praeger,2,26,55,83
Waller,309,"Justice, Supreme Court, Place 6 Unexpired Term",,DEM,Ballots Cast,5,116,292,413
Waller,309,"Justice, Supreme Court, Place 6 Unexpired Term",,DEM,Under Votes,0,47,47,94
Waller,309,"Justice, Supreme Court, Place 6 Unexpired Term",,DEM,Over Votes,0,0,0,0
Waller,309,"Justice, Supreme Court, Place 7",,DEM,Staci Williams,2,85,192,279
Waller,309,"Justice, Supreme Court, Place 7",,DEM,Brandy Voss,2,35,103,140
Waller,309,"Justice, Supreme Court, Place 7",,DEM,Ballots Cast,4,120,295,419
Waller,309,"Justice, Supreme Court, Place 7",,DEM,Under Votes,1,43,44,88
Waller,309,"Justice, Supreme Court, Place 7",,DEM,Over Votes,0,0,0,0
Waller,309,"Justice, Supreme Court, Place 8",,DEM,Gisela D. Triana,3,77,206,286
Waller,309,"Justice, Supreme Court, Place 8",,DEM,Peter Kelly,2,37,79,118
Waller,309,"Justice, Supreme Court, Place 8",,DEM,Ballots Cast,5,114,285,404
Waller,309,"Justice, Supreme Court, Place 8",,DEM,Under Votes,0,49,54,103
Waller,309,"Justice, Supreme Court, Place 8",,DEM,Over Votes,0,0,0,0
Waller,309,"Judge, Court of Criminal Appeals, Place 3",,DEM,Elizabeth Davis Frizell,3,67,184,254
Waller,309,"Judge, Court of Criminal Appeals, Place 3",,DEM,William Pieratt Demond,0,31,68,99
Waller,309,"Judge, Court of Criminal Appeals, Place 3",,DEM,Dan Wood,2,16,41,59
Waller,309,"Judge, Court of Criminal Appeals, Place 3",,DEM,Ballots Cast,5,114,293,412
Waller,309,"Judge, Court of Criminal Appeals, Place 3",,DEM,Under Votes,0,49,46,95
Waller,309,"Judge, Court of Criminal Appeals, Place 3",,DEM,Over Votes,0,0,0,0
Waller,309,"Judge, Court of Criminal Appeals, Place 4",,DEM,Steven Miears,2,39,77,118
Waller,309,"Judge, Court of Criminal Appeals, Place 4",,DEM,Tina Clinton,3,74,211,288
Waller,309,"Judge, Court of Criminal Appeals, Place 4",,DEM,Ballots Cast,5,113,288,406
Waller,309,"Judge, Court of Criminal Appeals, Place 4",,DEM,Under Votes,0,50,51,101
Waller,309,"Judge, Court of Criminal Appeals, Place 4",,DEM,Over Votes,0,0,0,0
Waller,309,"Judge, Court of Criminal Appeals, Place 9",,DEM,Brandon Birmingham,3,114,282,399
Waller,309,"Judge, Court of Criminal Appeals, Place 9",,DEM,Ballots Cast,3,114,282,399
Waller,309,"Judge, Court of Criminal Appeals, Place 9",,DEM,Under Votes,2,49,57,108
Waller,309,"Judge, Court of Criminal Appeals, Place 9",,DEM,Over Votes,0,0,0,0
Waller,309,"Member, State Board of Education, District 10",,DEM,Stephen Wyman,1,31,73,105
Waller,309,"Member, State Board of Education, District 10",,DEM,Marsha Burnett-Webster,3,84,216,303
Waller,309,"Member, State Board of Education, District 10",,DEM,Ballots Cast,4,115,289,408
Waller,309,"Member, State Board of Education, District 10",,DEM,Under Votes,1,48,50,99
Waller,309,"Member, State Board of Education, District 10",,DEM,Over Votes,0,0,0,0
Waller,309,State Senate,18,DEM,Michael Antalan,2,108,282,392
Waller,309,State Senate,18,DEM,Ballots Cast,2,108,282,392
Waller,309,State Senate,18,DEM,Under Votes,3,55,57,115
Waller,309,State Senate,18,DEM,Over Votes,0,0,0,0
Waller,309,State Representative,3,DEM,Martin Shupp,2,112,280,394
Waller,309,State Representative,3,DEM,Ballots Cast,2,112,280,394
Waller,309,State Representative,3,DEM,Under Votes,3,51,59,113
Waller,309,State Representative,3,DEM,Over Votes,0,0,0,0
Waller,309,"Chief Justice, 14th Court of Appeals District",,DEM,Jane Robinson,4,86,231,321
Waller,309,"Chief Justice, 14th Court of Appeals District",,DEM,Jim Evans,0,24,50,74
Waller,309,"Chief Justice, 14th Court of Appeals District",,DEM,Ballots Cast,4,110,281,395
Waller,309,"Chief Justice, 14th Court of Appeals District",,DEM,Under Votes,1,53,58,112
Waller,309,"Chief Justice, 14th Court of Appeals District",,DEM,Over Votes,0,0,0,0
Waller,309,"Justice, 1st Court of Appeals District, Place 3",,DEM,Jim Sharp,1,39,69,109
Waller,309,"Justice, 1st Court of Appeals District, Place 3",,DEM,Dinesh Singhal,0,23,61,84
Waller,309,"Justice, 1st Court of Appeals District, Place 3",,DEM,Veronica Rivas-Molloy,3,48,153,204
Waller,309,"Justice, 1st Court of Appeals District, Place 3",,DEM,Ballots Cast,4,110,283,397
Waller,309,"Justice, 1st Court of Appeals District, Place 3",,DEM,Under Votes,1,53,56,110
Waller,309,"Justice, 1st Court of Appeals District, Place 3",,DEM,Over Votes,0,0,0,0
Waller,309,"Justice, 1st Court of Appeals District, Place 5",,DEM,Tim Hootman,3,44,121,168
Waller,309,"Justice, 1st Court of Appeals District, Place 5",,DEM,Amparo Monique Guerra,1,60,154,215
Waller,309,"Justice, 1st Court of Appeals District, Place 5",,DEM,Ballots Cast,4,104,275,383
Waller,309,"Justice, 1st Court of Appeals District, Place 5",,DEM,Under Votes,1,59,64,124
Waller,309,"Justice, 1st Court of Appeals District, Place 5",,DEM,Over Votes,0,0,0,0
Waller,309,"Justice, 14th Court of Appeals District, Place 7",,DEM,"Tamika ""Tami"" Craft",1,57,171,229
Waller,309,"Justice, 14th Court of Appeals District, Place 7",,DEM,Wally Kronzer,0,2,4,6
Waller,309,"Justice, 14th Court of Appeals District, Place 7",,DEM,V.R. Faulkner,1,5,14,20
Waller,309,"Justice, 14th Court of Appeals District, Place 7",,DEM,Cheri Thomas,2,23,46,71
Waller,309,"Justice, 14th Court of Appeals District, Place 7",,DEM,Dominic J. Merino,0,5,17,22
Waller,309,"Justice, 14th Court of Appeals District, Place 7",,DEM,Lennon C. Wright,0,18,30,48
Waller,309,"Justice, 14th Court of Appeals District, Place 7",,DEM,Ballots Cast,4,110,282,396
Waller,309,"Justice, 14th Court of Appeals District, Place 7",,DEM,Under Votes,1,53,57,111
Waller,309,"Justice, 14th Court of Appeals District, Place 7",,DEM,Over Votes,0,0,0,0
Waller,309,Sheriff,,DEM,Cedric D. Watson,2,122,290,414
Waller,309,Sheriff,,DEM,Ballots Cast,2,122,290,414
Waller,309,Sheriff,,DEM,Under Votes,3,41,49,93
Waller,309,Sheriff,,DEM,Over Votes,0,0,0,0
Waller,309,"County Commissioner, Precinct 3",,DEM,Christian Charleston,2,14,52,68
Waller,309,"County Commissioner, Precinct 3",,DEM,Darryl S. Johnson,0,16,31,47
Waller,309,"County Commissioner, Precinct 3",,DEM,Kendric D. Jones,2,130,246,378
Waller,309,"County Commissioner, Precinct 3",,DEM,Ballots Cast,4,160,329,493
Waller,309,"County Commissioner, Precinct 3",,DEM,Under Votes,1,3,10,14
Waller,309,"County Commissioner, Precinct 3",,DEM,Over Votes,0,0,0,0
Waller,309,"Constable, Precinct 3",,DEM,Herschel Smith,3,109,230,342
Waller,309,"Constable, Precinct 3",,DEM,Scott H. Green,1,28,76,105
Waller,309,"Constable, Precinct 3",,DEM,Ballots Cast,4,137,306,447
Waller,309,"Constable, Precinct 3",,DEM,Under Votes,1,26,33,60
Waller,309,"Constable, Precinct 3",,DEM,Over Votes,0,0,0,0
Waller,309,County Chairman,,DEM,Rosa Patlan Harris,2,112,288,402
Waller,309,County Chairman,,DEM,Ballots Cast,2,112,288,402
Waller,309,County Chairman,,DEM,Under Votes,3,51,51,105
Waller,309,County Chairman,,DEM,Over Votes,0,0,0,0
Waller,309,President,,REP,Donald J. Trump,0,6,2,8
Waller,309,President,,REP,Joe Walsh,0,1,0,1
Waller,309,President,,REP,Bob Ely,0,0,0,0
Waller,309,President,,REP,"Roque ""Rocky"" De La Fuente Guerra",0,0,2,2
Waller,309,President,,REP,Zoltan G. Istvan,0,0,0,0
Waller,309,President,,REP,Matthew John Matern,0,1,1,2
Waller,309,President,,REP,Bill Weld,0,0,1,1
Waller,309,President,,REP,Uncommitted,0,2,2,4
Waller,309,President,,REP,Ballots Cast,0,10,8,18
Waller,309,President,,REP,Under Votes,0,2,0,2
Waller,309,President,,REP,Over Votes,0,0,0,0
Waller,309,U.S. Senate,,REP,Dwayne Stovall,0,2,3,5
Waller,309,U.S. Senate,,REP,Mark Yancey,0,0,0,0
Waller,309,U.S. Senate,,REP,Virgil Bierschwale,0,0,0,0
Waller,309,U.S. Senate,,REP,John Anthony Castro,0,0,3,3
Waller,309,U.S. Senate,,REP,John Cornyn,0,7,2,9
Waller,309,U.S. Senate,,REP,Ballots Cast,0,9,8,17
Waller,309,U.S. Senate,,REP,Under Votes,0,3,0,3
Waller,309,U.S. Senate,,REP,Over Votes,0,0,0,0
Waller,309,U.S. House,10,REP,Michael McCaul,0,11,8,19
Waller,309,U.S. House,10,REP,Ballots Cast,0,11,8,19
Waller,309,U.S. House,10,REP,Under Votes,0,1,0,1
Waller,309,U.S. House,10,REP,Over Votes,0,0,0,0
Waller,309,Railroad Commissioner,,REP,Ryan Sitton,0,3,3,6
Waller,309,Railroad Commissioner,,REP,"James ""Jim"" Wright",0,3,5,8
Waller,309,Railroad Commissioner,,REP,Ballots Cast,0,6,8,14
Waller,309,Railroad Commissioner,,REP,Under Votes,0,6,0,6
Waller,309,Railroad Commissioner,,REP,Over Votes,0,0,0,0
Waller,309,"Chief Justice, Supreme Court",,REP,Nathan Hecht,0,7,7,14
Waller,309,"Chief Justice, Supreme Court",,REP,Ballots Cast,0,7,7,14
Waller,309,"Chief Justice, Supreme Court",,REP,Under Votes,0,5,1,6
Waller,309,"Chief Justice, Supreme Court",,REP,Over Votes,0,0,0,0
Waller,309,"Justice, Supreme Court, Place 6 Unexpired Term",,REP,Jane Bland,0,7,7,14
Waller,309,"Justice, Supreme Court, Place 6 Unexpired Term",,REP,Ballots Cast,0,7,7,14
Waller,309,"Justice, Supreme Court, Place 6 Unexpired Term",,REP,Under Votes,0,5,1,6
Waller,309,"Justice, Supreme Court, Place 6 Unexpired Term",,REP,Over Votes,0,0,0,0
Waller,309,"Justice, Supreme Court, Place 7",,REP,Jeff Boyd,0,7,7,14
Waller,309,"Justice, Supreme Court, Place 7",,REP,Ballots Cast,0,7,7,14
Waller,309,"Justice, Supreme Court, Place 7",,REP,Under Votes,0,5,1,6
Waller,309,"Justice, Supreme Court, Place 7",,REP,Over Votes,0,0,0,0
Waller,309,"Justice, Supreme Court, Place 8",,REP,Brett Busby,0,7,7,14
Waller,309,"Justice, Supreme Court, Place 8",,REP,Ballots Cast,0,7,7,14
Waller,309,"Justice, Supreme Court, Place 8",,REP,Under Votes,0,5,1,6
Waller,309,"Justice, Supreme Court, Place 8",,REP,Over Votes,0,0,0,0
Waller,309,"Judge, Court of Criminal Appeals, Place 3",,REP,Gina Parker,0,1,5,6
Waller,309,"Judge, Court of Criminal Appeals, Place 3",,REP,Bert Richardson,0,5,2,7
Waller,309,"Judge, Court of Criminal Appeals, Place 3",,REP,Ballots Cast,0,6,7,13
Waller,309,"Judge, Court of Criminal Appeals, Place 3",,REP,Under Votes,0,6,1,7
Waller,309,"Judge, Court of Criminal Appeals, Place 3",,REP,Over Votes,0,0,0,0
Waller,309,"Judge, Court of Criminal Appeals, Place 4",,REP,Kevin Patrick Yeary,0,7,7,14
Waller,309,"Judge, Court of Criminal Appeals, Place 4",,REP,Ballots Cast,0,7,7,14
Waller,309,"Judge, Court of Criminal Appeals, Place 4",,REP,Under Votes,0,5,1,6
Waller,309,"Judge, Court of Criminal Appeals, Place 4",,REP,Over Votes,0,0,0,0
Waller,309,"Judge, Court of Criminal Appeals, Place 9",,REP,David Newell,0,7,7,14
Waller,309,"Judge, Court of Criminal Appeals, Place 9",,REP,Ballots Cast,0,7,7,14
Waller,309,"Judge, Court of Criminal Appeals, Place 9",,REP,Under Votes,0,5,1,6
Waller,309,"Judge, Court of Criminal Appeals, Place 9",,REP,Over Votes,0,0,0,0
Waller,309,"Member, State Board of Education, District 10",,REP,Tom Maynard,0,7,7,14
Waller,309,"Member, State Board of Education, District 10",,REP,Ballots Cast,0,7,7,14
Waller,309,"Member, State Board of Education, District 10",,REP,Under Votes,0,5,1,6
Waller,309,"Member, State Board of Education, District 10",,REP,Over Votes,0,0,0,0
Waller,309,State Senate,18,REP,Lois W. Kolkhorst,0,10,7,17
Waller,309,State Senate,18,REP,Ballots Cast,0,10,7,17
Waller,309,State Senate,18,REP,Under Votes,0,2,1,3
Waller,309,State Senate,18,REP,Over Votes,0,0,0,0
Waller,309,State Representative,3,REP,Cecil Bell Jr,0,11,7,18
Waller,309,State Representative,3,REP,Ballots Cast,0,11,7,18
Waller,309,State Representative,3,REP,Under Votes,0,1,1,2
Waller,309,State Representative,3,REP,Over Votes,0,0,0,0
Waller,309,"Chief Justice, 14th Court of Appeals District",,REP,Tracy Elizabeth Christopher,0,6,7,13
Waller,309,"Chief Justice, 14th Court of Appeals District",,REP,Ballots Cast,0,6,7,13
Waller,309,"Chief Justice, 14th Court of Appeals District",,REP,Under Votes,0,6,1,7
Waller,309,"Chief Justice, 14th Court of Appeals District",,REP,Over Votes,0,0,0,0
Waller,309,"Justice, 1st Court of Appeals District, Place 3",,REP,Russell Lloyd,0,6,7,13
Waller,309,"Justice, 1st Court of Appeals District, Place 3",,REP,Ballots Cast,0,6,7,13
Waller,309,"Justice, 1st Court of Appeals District, Place 3",,REP,Under Votes,0,6,1,7
Waller,309,"Justice, 1st Court of Appeals District, Place 3",,REP,Over Votes,0,0,0,0
Waller,309,"Justice, 1st Court of Appeals District, Place 5",,REP,Chad Bridges,0,3,2,5
Waller,309,"Justice, 1st Court of Appeals District, Place 5",,REP,James Lombardino,0,0,2,2
Waller,309,"Justice, 1st Court of Appeals District, Place 5",,REP,Levi J. Benton,0,4,0,4
Waller,309,"Justice, 1st Court of Appeals District, Place 5",,REP,Terry Adams,0,2,3,5
Waller,309,"Justice, 1st Court of Appeals District, Place 5",,REP,Ballots Cast,0,9,7,16
Waller,309,"Justice, 1st Court of Appeals District, Place 5",,REP,Under Votes,0,3,1,4
Waller,309,"Justice, 1st Court of Appeals District, Place 5",,REP,Over Votes,0,0,0,0
Waller,309,"Justice, 14th Court of Appeals District, Place 7",,REP,Ken Wise,0,6,7,13
Waller,309,"Justice, 14th Court of Appeals District, Place 7",,REP,Ballots Cast,0,6,7,13
Waller,309,"Justice, 14th Court of Appeals District, Place 7",,REP,Under Votes,0,6,1,7
Waller,309,"Justice, 14th Court of Appeals District, Place 7",,REP,Over Votes,0,0,0,0
Waller,309,"District Judge, 506th Judicial District",,REP,Gary W. Chaney,0,10,7,17
Waller,309,"District Judge, 506th Judicial District",,REP,Ballots Cast,0,10,7,17
Waller,309,"District Judge, 506th Judicial District",,REP,Under Votes,0,2,1,3
Waller,309,"District Judge, 506th Judicial District",,REP,Over Votes,0,0,0,0
Waller,309,Sheriff,,REP,Dan Porter,0,2,2,4
Waller,309,Sheriff,,REP,R. Glenn Smith,0,7,3,10
Waller,309,Sheriff,,REP,Troy Guidry,0,3,2,5
Waller,309,Sheriff,,REP,Ballots Cast,0,12,7,19
Waller,309,Sheriff,,REP,Under Votes,0,0,1,1
Waller,309,Sheriff,,REP,Over Votes,0,0,0,0
Waller,309,County Tax Assessor-Collector,,REP,Ellen Contreras Shelburne,0,7,3,10
Waller,309,County Tax Assessor-Collector,,REP,Carolyn Miedke,0,5,4,9
Waller,309,County Tax Assessor-Collector,,REP,Ballots Cast,0,12,7,19
Waller,309,County Tax Assessor-Collector,,REP,Under Votes,0,0,1,1
Waller,309,County Tax Assessor-Collector,,REP,Over Votes,0,0,0,0
Waller,309,"County Commissioner, Precinct 3",,REP,Jeron Barnett,0,10,7,17
Waller,309,"County Commissioner, Precinct 3",,REP,Ballots Cast,0,10,7,17
Waller,309,"County Commissioner, Precinct 3",,REP,Under Votes,0,2,1,3
Waller,309,"County Commissioner, Precinct 3",,REP,Over Votes,0,0,0,0
Waller,309,"Constable, Precinct 3",,REP,Marvin Hood,0,6,7,13
Waller,309,"Constable, Precinct 3",,REP,Ballots Cast,0,6,7,13
Waller,309,"Constable, Precinct 3",,REP,Under Votes,0,6,1,7
Waller,309,"Constable, Precinct 3",,REP,Over Votes,0,0,0,0
Waller,309,County Chairman,,REP,David W. Luther,0,9,7,16
Waller,309,County Chairman,,REP,Ballots Cast,0,9,7,16
Waller,309,County Chairman,,REP,Under Votes,0,3,1,4
Waller,309,County Chairman,,REP,Over Votes,0,0,0,0
Waller,309,Proposition #1,,DEM,Yes,5,159,329,493
Waller,309,Proposition #1,,DEM,No,0,1,3,4
Waller,309,Proposition #1,,DEM,Ballots Cast,5,160,332,497
Waller,309,Proposition #1,,DEM,Under Votes,0,3,7,10
Waller,309,Proposition #1,,DEM,Over Votes,0,0,0,0
Waller,309,Proposition #2,,DEM,Yes,5,160,327,492
Waller,309,Proposition #2,,DEM,No,0,0,5,5
Waller,309,Proposition #2,,DEM,Ballots Cast,5,160,332,497
Waller,309,Proposition #2,,DEM,Under Votes,0,3,7,10
Waller,309,Proposition #2,,DEM,Over Votes,0,0,0,0
Waller,309,Proposition #3,,DEM,Yes,5,157,332,494
Waller,309,Proposition #3,,DEM,No,0,1,0,1
Waller,309,Proposition #3,,DEM,Ballots Cast,5,158,332,495
Waller,309,Proposition #3,,DEM,Under Votes,0,5,7,12
Waller,309,Proposition #3,,DEM,Over Votes,0,0,0,0
Waller,309,Proposition #4,,DEM,Yes,5,154,326,485
Waller,309,Proposition #4,,DEM,No,0,5,3,8
Waller,309,Proposition #4,,DEM,Ballots Cast,5,159,329,493
Waller,309,Proposition #4,,DEM,Under Votes,0,4,10,14
Waller,309,Proposition #4,,DEM,Over Votes,0,0,0,0
Waller,309,Proposition #5,,DEM,Yes,5,158,329,492
Waller,309,Proposition #5,,DEM,No,0,3,2,5
Waller,309,Proposition #5,,DEM,Ballots Cast,5,161,331,497
Waller,309,Proposition #5,,DEM,Under Votes,0,2,8,10
Waller,309,Proposition #5,,DEM,Over Votes,0,0,0,0
Waller,309,Proposition #6,,DEM,Yes,5,160,328,493
Waller,309,Proposition #6,,DEM,No,0,0,3,3
Waller,309,Proposition #6,,DEM,Ballots Cast,5,160,331,496
Waller,309,Proposition #6,,DEM,Under Votes,0,3,8,11
Waller,309,Proposition #6,,DEM,Over Votes,0,0,0,0
Waller,309,Proposition #7,,DEM,Yes,5,154,325,484
Waller,309,Proposition #7,,DEM,No,0,3,3,6
Waller,309,Proposition #7,,DEM,Ballots Cast,5,157,328,490
Waller,309,Proposition #7,,DEM,Under Votes,0,6,11,17
Waller,309,Proposition #7,,DEM,Over Votes,0,0,0,0
Waller,309,Proposition #8,,DEM,Yes,5,155,327,487
Waller,309,Proposition #8,,DEM,No,0,4,2,6
Waller,309,Proposition #8,,DEM,Ballots Cast,5,159,329,493
Waller,309,Proposition #8,,DEM,Under Votes,0,4,10,14
Waller,309,Proposition #8,,DEM,Over Votes,0,0,0,0
Waller,309,Proposition #9,,DEM,Yes,5,159,327,491
Waller,309,Proposition #9,,DEM,No,0,0,1,1
Waller,309,Proposition #9,,DEM,Ballots Cast,5,159,328,492
Waller,309,Proposition #9,,DEM,Under Votes,0,4,11,15
Waller,309,Proposition #9,,DEM,Over Votes,0,0,0,0
Waller,309,Proposition #10,,DEM,Yes,5,152,320,477
Waller,309,Proposition #10,,DEM,No,0,7,8,15
Waller,309,Proposition #10,,DEM,Ballots Cast,5,159,328,492
Waller,309,Proposition #10,,DEM,Under Votes,0,4,11,15
Waller,309,Proposition #10,,DEM,Over Votes,0,0,0,0
Waller,309,Proposition #11,,DEM,Yes,4,146,300,450
Waller,309,Proposition #11,,DEM,No,1,10,27,38
Waller,309,Proposition #11,,DEM,Ballots Cast,5,156,327,488
Waller,309,Proposition #11,,DEM,Under Votes,0,7,12,19
Waller,309,Proposition #11,,DEM,Over Votes,0,0,0,0
Waller,309,Proposition 1,,REP,Yes,0,5,6,11
Waller,309,Proposition 1,,REP,No,0,7,2,9
Waller,309,Proposition 1,,REP,Ballots Cast,0,12,8,20
Waller,309,Proposition 1,,REP,Under Votes,0,0,0,0
Waller,309,Proposition 1,,REP,Over Votes,0,0,0,0
Waller,309,Proposition 2,,REP,Yes,0,6,6,12
Waller,309,Proposition 2,,REP,No,0,5,2,7
Waller,309,Proposition 2,,REP,Ballots Cast,0,11,8,19
Waller,309,Proposition 2,,REP,Under Votes,0,1,0,1
Waller,309,Proposition 2,,REP,Over Votes,0,0,0,0
Waller,309,Proposition 3,,REP,Yes,0,8,5,13
Waller,309,Proposition 3,,REP,No,0,2,3,5
Waller,309,Proposition 3,,REP,Ballots Cast,0,10,8,18
Waller,309,Proposition 3,,REP,Under Votes,0,2,0,2
Waller,309,Proposition 3,,REP,Over Votes,0,0,0,0
Waller,309,Proposition 4,,REP,Yes,0,9,5,14
Waller,309,Proposition 4,,REP,No,0,2,3,5
Waller,309,Proposition 4,,REP,Ballots Cast,0,11,8,19
Waller,309,Proposition 4,,REP,Under Votes,0,1,0,1
Waller,309,Proposition 4,,REP,Over Votes,0,0,0,0
Waller,309,Proposition 5,,REP,Yes,0,11,7,18
Waller,309,Proposition 5,,REP,No,0,1,1,2
Waller,309,Proposition 5,,REP,Ballots Cast,0,12,8,20
Waller,309,Proposition 5,,REP,Under Votes,0,0,0,0
Waller,309,Proposition 5,,REP,Over Votes,0,0,0,0
Waller,309,Proposition 6,,REP,Yes,0,9,5,14
Waller,309,Proposition 6,,REP,No,0,2,3,5
Waller,309,Proposition 6,,REP,Ballots Cast,0,11,8,19
Waller,309,Proposition 6,,REP,Under Votes,0,1,0,1
Waller,309,Proposition 6,,REP,Over Votes,0,0,0,0
Waller,309,Proposition 7,,REP,Yes,0,10,8,18
Waller,309,Proposition 7,,REP,No,0,1,0,1
Waller,309,Proposition 7,,REP,Ballots Cast,0,11,8,19
Waller,309,Proposition 7,,REP,Under Votes,0,1,0,1
Waller,309,Proposition 7,,REP,Over Votes,0,0,0,0
Waller,309,Proposition 8,,REP,Yes,0,10,5,15
Waller,309,Proposition 8,,REP,No,0,0,3,3
Waller,309,Proposition 8,,REP,Ballots Cast,0,10,8,18
Waller,309,Proposition 8,,REP,Under Votes,0,2,0,2
Waller,309,Proposition 8,,REP,Over Votes,0,0,0,0
Waller,309,Proposition 9,,REP,Yes,0,9,8,17
Waller,309,Proposition 9,,REP,No,0,2,0,2
Waller,309,Proposition 9,,REP,Ballots Cast,0,11,8,19
Waller,309,Proposition 9,,REP,Under Votes,0,1,0,1
Waller,309,Proposition 9,,REP,Over Votes,0,0,0,0
Waller,309,Proposition 10,,REP,Yes,0,10,5,15
Waller,309,Proposition 10,,REP,No,0,1,3,4
Waller,309,Proposition 10,,REP,Ballots Cast,0,11,8,19
Waller,309,Proposition 10,,REP,Under Votes,0,1,0,1
Waller,309,Proposition 10,,REP,Over Votes,0,0,0,0
Waller,310,President,,DEM,Michael Bennet,0,4,2,6
Waller,310,President,,DEM,Marianne Williamson,0,0,1,1
Waller,310,President,,DEM,Cory Booker,0,4,1,5
Waller,310,President,,DEM,Bernie Sanders,2,50,35,87
Waller,310,President,,DEM,Tulsi Gabbard,0,2,0,2
Waller,310,President,,DEM,Deval Patrick,0,0,0,0
Waller,310,President,,DEM,Amy Klobuchar,0,3,1,4
Waller,310,President,,DEM,Julián Castro,0,1,1,2
Waller,310,President,,DEM,Elizabeth Warren,0,9,5,14
Waller,310,President,,DEM,John K. Delaney,0,0,0,0
Waller,310,President,,DEM,Robby Wells,0,0,0,0
Waller,310,President,,DEM,"Roque ""Rocky"" De La Fuente",0,0,0,0
Waller,310,President,,DEM,Andrew Yang,0,0,0,0
Waller,310,President,,DEM,Joseph R. Biden,12,49,62,123
Waller,310,President,,DEM,Michael R. Bloomberg,5,30,7,42
Waller,310,President,,DEM,Tom Steyer,0,1,0,1
Waller,310,President,,DEM,Pete Buttigieg,0,3,0,3
Waller,310,President,,DEM,Ballots Cast,19,156,115,290
Waller,310,President,,DEM,Under Votes,0,8,1,9
Waller,310,President,,DEM,Over Votes,0,0,0,0
Waller,310,U.S. Senate,,DEM,Royce West,7,88,37,132
Waller,310,U.S. Senate,,DEM,"Annie ""Mamá"" Garcia",1,10,12,23
Waller,310,U.S. Senate,,DEM,D. R. Hunter,0,2,0,2
Waller,310,U.S. Senate,,DEM,Sema Hernandez,0,2,5,7
Waller,310,U.S. Senate,,DEM,Adrian Ocegueda,0,3,1,4
Waller,310,U.S. Senate,,DEM,Chris Bell,2,14,28,44
Waller,310,U.S. Senate,,DEM,Cristina Tzintzun Ramirez,1,4,5,10
Waller,310,U.S. Senate,,DEM,Jack Daniel Foster Jr,0,3,1,4
Waller,310,U.S. Senate,,DEM,Amanda K. Edwards,1,8,4,13
Waller,310,U.S. Senate,,DEM,Victor Hugo Harris,0,1,1,2
Waller,310,U.S. Senate,,DEM,"Mary ""MJ"" Hegar",3,9,8,20
Waller,310,U.S. Senate,,DEM,Michael Cooper,1,2,3,6
Waller,310,U.S. Senate,,DEM,Ballots Cast,16,146,105,267
Waller,310,U.S. Senate,,DEM,Under Votes,3,18,11,32
Waller,310,U.S. Senate,,DEM,Over Votes,0,0,0,0
Waller,310,U.S. House,10,DEM,Mike Siegel,7,98,44,149
Waller,310,U.S. House,10,DEM,Shannon Hutcheson,5,22,40,67
Waller,310,U.S. House,10,DEM,Pritesh Gandhi,4,25,23,52
Waller,310,U.S. House,10,DEM,Ballots Cast,16,145,107,268
Waller,310,U.S. House,10,DEM,Under Votes,2,19,9,30
Waller,310,U.S. House,10,DEM,Over Votes,1,0,0,1
Waller,310,Railroad Commissioner,,DEM,"Roberto R. ""Beto"" Alonzo",3,44,31,78
Waller,310,Railroad Commissioner,,DEM,Chrysta Castañeda,3,27,21,51
Waller,310,Railroad Commissioner,,DEM,Mark Watson,7,39,31,77
Waller,310,Railroad Commissioner,,DEM,Kelly Stone,3,29,15,47
Waller,310,Railroad Commissioner,,DEM,Ballots Cast,16,139,98,253
Waller,310,Railroad Commissioner,,DEM,Under Votes,3,25,18,46
Waller,310,Railroad Commissioner,,DEM,Over Votes,0,0,0,0
Waller,310,"Chief Justice, Supreme Court",,DEM,Jerry Zimmerer,4,26,23,53
Waller,310,"Chief Justice, Supreme Court",,DEM,Amy Clark Meachum,11,111,82,204
Waller,310,"Chief Justice, Supreme Court",,DEM,Ballots Cast,15,137,105,257
Waller,310,"Chief Justice, Supreme Court",,DEM,Under Votes,4,27,11,42
Waller,310,"Chief Justice, Supreme Court",,DEM,Over Votes,0,0,0,0
Waller,310,"Justice, Supreme Court, Place 6 Unexpired Term",,DEM,Kathy Cheng,13,113,82,208
Waller,310,"Justice, Supreme Court, Place 6 Unexpired Term",,DEM,Larry Praeger,2,23,18,43
Waller,310,"Justice, Supreme Court, Place 6 Unexpired Term",,DEM,Ballots Cast,15,136,100,251
Waller,310,"Justice, Supreme Court, Place 6 Unexpired Term",,DEM,Under Votes,4,28,16,48
Waller,310,"Justice, Supreme Court, Place 6 Unexpired Term",,DEM,Over Votes,0,0,0,0
Waller,310,"Justice, Supreme Court, Place 7",,DEM,Staci Williams,11,108,81,200
Waller,310,"Justice, Supreme Court, Place 7",,DEM,Brandy Voss,4,28,20,52
Waller,310,"Justice, Supreme Court, Place 7",,DEM,Ballots Cast,15,136,101,252
Waller,310,"Justice, Supreme Court, Place 7",,DEM,Under Votes,4,28,15,47
Waller,310,"Justice, Supreme Court, Place 7",,DEM,Over Votes,0,0,0,0
Waller,310,"Justice, Supreme Court, Place 8",,DEM,Gisela D. Triana,8,90,68,166
Waller,310,"Justice, Supreme Court, Place 8",,DEM,Peter Kelly,7,42,30,79
Waller,310,"Justice, Supreme Court, Place 8",,DEM,Ballots Cast,15,132,98,245
Waller,310,"Justice, Supreme Court, Place 8",,DEM,Under Votes,4,32,18,54
Waller,310,"Justice, Supreme Court, Place 8",,DEM,Over Votes,0,0,0,0
Waller,310,"Judge, Court of Criminal Appeals, Place 3",,DEM,Elizabeth Davis Frizell,8,91,69,168
Waller,310,"Judge, Court of Criminal Appeals, Place 3",,DEM,William Pieratt Demond,1,19,14,34
Waller,310,"Judge, Court of Criminal Appeals, Place 3",,DEM,Dan Wood,6,22,15,43
Waller,310,"Judge, Court of Criminal Appeals, Place 3",,DEM,Ballots Cast,15,132,98,245
Waller,310,"Judge, Court of Criminal Appeals, Place 3",,DEM,Under Votes,4,32,18,54
Waller,310,"Judge, Court of Criminal Appeals, Place 3",,DEM,Over Votes,0,0,0,0
Waller,310,"Judge, Court of Criminal Appeals, Place 4",,DEM,Steven Miears,2,30,17,49
Waller,310,"Judge, Court of Criminal Appeals, Place 4",,DEM,Tina Clinton,14,101,81,196
Waller,310,"Judge, Court of Criminal Appeals, Place 4",,DEM,Ballots Cast,16,131,98,245
Waller,310,"Judge, Court of Criminal Appeals, Place 4",,DEM,Under Votes,3,33,18,54
Waller,310,"Judge, Court of Criminal Appeals, Place 4",,DEM,Over Votes,0,0,0,0
Waller,310,"Judge, Court of Criminal Appeals, Place 9",,DEM,Brandon Birmingham,14,125,92,231
Waller,310,"Judge, Court of Criminal Appeals, Place 9",,DEM,Ballots Cast,14,125,92,231
Waller,310,"Judge, Court of Criminal Appeals, Place 9",,DEM,Under Votes,5,39,24,68
Waller,310,"Judge, Court of Criminal Appeals, Place 9",,DEM,Over Votes,0,0,0,0
Waller,310,"Member, State Board of Education, District 10",,DEM,Stephen Wyman,2,20,20,42
Waller,310,"Member, State Board of Education, District 10",,DEM,Marsha Burnett-Webster,13,119,80,212
Waller,310,"Member, State Board of Education, District 10",,DEM,Ballots Cast,15,139,100,254
Waller,310,"Member, State Board of Education, District 10",,DEM,Under Votes,4,25,16,45
Waller,310,"Member, State Board of Education, District 10",,DEM,Over Votes,0,0,0,0
Waller,310,State Senate,18,DEM,Michael Antalan,12,124,89,225
Waller,310,State Senate,18,DEM,Ballots Cast,12,124,89,225
Waller,310,State Senate,18,DEM,Under Votes,7,40,27,74
Waller,310,State Senate,18,DEM,Over Votes,0,0,0,0
Waller,310,State Representative,3,DEM,Martin Shupp,12,126,91,229
Waller,310,State Representative,3,DEM,Ballots Cast,12,126,91,229
Waller,310,State Representative,3,DEM,Under Votes,7,38,25,70
Waller,310,State Representative,3,DEM,Over Votes,0,0,0,0
Waller,310,"Chief Justice, 14th Court of Appeals District",,DEM,Jane Robinson,12,104,83,199
Waller,310,"Chief Justice, 14th Court of Appeals District",,DEM,Jim Evans,3,28,15,46
Waller,310,"Chief Justice, 14th Court of Appeals District",,DEM,Ballots Cast,15,132,98,245
Waller,310,"Chief Justice, 14th Court of Appeals District",,DEM,Under Votes,4,32,18,54
Waller,310,"Chief Justice, 14th Court of Appeals District",,DEM,Over Votes,0,0,0,0
Waller,310,"Justice, 1st Court of Appeals District, Place 3",,DEM,Jim Sharp,7,42,24,73
Waller,310,"Justice, 1st Court of Appeals District, Place 3",,DEM,Dinesh Singhal,4,29,24,57
Waller,310,"Justice, 1st Court of Appeals District, Place 3",,DEM,Veronica Rivas-Molloy,5,63,54,122
Waller,310,"Justice, 1st Court of Appeals District, Place 3",,DEM,Ballots Cast,16,134,102,252
Waller,310,"Justice, 1st Court of Appeals District, Place 3",,DEM,Under Votes,3,30,14,47
Waller,310,"Justice, 1st Court of Appeals District, Place 3",,DEM,Over Votes,0,0,0,0
Waller,310,"Justice, 1st Court of Appeals District, Place 5",,DEM,Tim Hootman,4,46,39,89
Waller,310,"Justice, 1st Court of Appeals District, Place 5",,DEM,Amparo Monique Guerra,12,80,58,150
Waller,310,"Justice, 1st Court of Appeals District, Place 5",,DEM,Ballots Cast,16,126,97,239
Waller,310,"Justice, 1st Court of Appeals District, Place 5",,DEM,Under Votes,3,38,19,60
Waller,310,"Justice, 1st Court of Appeals District, Place 5",,DEM,Over Votes,0,0,0,0
Waller,310,"Justice, 14th Court of Appeals District, Place 7",,DEM,"Tamika ""Tami"" Craft",9,74,57,140
Waller,310,"Justice, 14th Court of Appeals District, Place 7",,DEM,Wally Kronzer,0,2,2,4
Waller,310,"Justice, 14th Court of Appeals District, Place 7",,DEM,V.R. Faulkner,0,8,1,9
Waller,310,"Justice, 14th Court of Appeals District, Place 7",,DEM,Cheri Thomas,3,25,17,45
Waller,310,"Justice, 14th Court of Appeals District, Place 7",,DEM,Dominic J. Merino,3,6,7,16
Waller,310,"Justice, 14th Court of Appeals District, Place 7",,DEM,Lennon C. Wright,1,16,14,31
Waller,310,"Justice, 14th Court of Appeals District, Place 7",,DEM,Ballots Cast,16,131,98,245
Waller,310,"Justice, 14th Court of Appeals District, Place 7",,DEM,Under Votes,3,33,18,54
Waller,310,"Justice, 14th Court of Appeals District, Place 7",,DEM,Over Votes,0,0,0,0
Waller,310,Sheriff,,DEM,Cedric D. Watson,14,128,102,244
Waller,310,Sheriff,,DEM,Ballots Cast,14,128,102,244
Waller,310,Sheriff,,DEM,Under Votes,5,36,14,55
Waller,310,Sheriff,,DEM,Over Votes,0,0,0,0
Waller,310,"County Commissioner, Precinct 3",,DEM,Christian Charleston,5,36,27,68
Waller,310,"County Commissioner, Precinct 3",,DEM,Darryl S. Johnson,12,73,40,125
Waller,310,"County Commissioner, Precinct 3",,DEM,Kendric D. Jones,1,49,44,94
Waller,310,"County Commissioner, Precinct 3",,DEM,Ballots Cast,18,158,111,287
Waller,310,"County Commissioner, Precinct 3",,DEM,Under Votes,1,6,5,12
Waller,310,"County Commissioner, Precinct 3",,DEM,Over Votes,0,0,0,0
Waller,310,"Constable, Precinct 3",,DEM,Herschel Smith,17,141,93,251
Waller,310,"Constable, Precinct 3",,DEM,Scott H. Green,1,17,17,35
Waller,310,"Constable, Precinct 3",,DEM,Ballots Cast,18,158,110,286
Waller,310,"Constable, Precinct 3",,DEM,Under Votes,1,6,6,13
Waller,310,"Constable, Precinct 3",,DEM,Over Votes,0,0,0,0
Waller,310,County Chairman,,DEM,Rosa Patlan Harris,10,133,93,236
Waller,310,County Chairman,,DEM,Ballots Cast,10,133,93,236
Waller,310,County Chairman,,DEM,Under Votes,9,31,23,63
Waller,310,County Chairman,,DEM,Over Votes,0,0,0,0
Waller,310,President,,REP,Donald J. Trump,3,46,19,68
Waller,310,President,,REP,Joe Walsh,0,2,0,2
Waller,310,President,,REP,Bob Ely,0,0,0,0
Waller,310,President,,REP,"Roque ""Rocky"" De La Fuente Guerra",0,0,0,0
Waller,310,President,,REP,Zoltan G. Istvan,0,0,0,0
Waller,310,President,,REP,Matthew John Matern,0,0,0,0
Waller,310,President,,REP,Bill Weld,0,0,0,0
Waller,310,President,,REP,Uncommitted,0,3,1,4
Waller,310,President,,REP,Ballots Cast,3,51,20,74
Waller,310,President,,REP,Under Votes,0,1,0,1
Waller,310,President,,REP,Over Votes,0,0,0,0
Waller,310,U.S. Senate,,REP,Dwayne Stovall,0,10,9,19
Waller,310,U.S. Senate,,REP,Mark Yancey,0,4,3,7
Waller,310,U.S. Senate,,REP,Virgil Bierschwale,0,0,1,1
Waller,310,U.S. Senate,,REP,John Anthony Castro,0,1,0,1
Waller,310,U.S. Senate,,REP,John Cornyn,2,30,6,38
Waller,310,U.S. Senate,,REP,Ballots Cast,2,45,19,66
Waller,310,U.S. Senate,,REP,Under Votes,1,7,1,9
Waller,310,U.S. Senate,,REP,Over Votes,0,0,0,0
Waller,310,U.S. House,10,REP,Michael McCaul,2,46,19,67
Waller,310,U.S. House,10,REP,Ballots Cast,2,46,19,67
Waller,310,U.S. House,10,REP,Under Votes,1,6,1,8
Waller,310,U.S. House,10,REP,Over Votes,0,0,0,0
Waller,310,Railroad Commissioner,,REP,Ryan Sitton,1,26,8,35
Waller,310,Railroad Commissioner,,REP,"James ""Jim"" Wright",1,14,10,25
Waller,310,Railroad Commissioner,,REP,Ballots Cast,2,40,18,60
Waller,310,Railroad Commissioner,,REP,Under Votes,1,12,2,15
Waller,310,Railroad Commissioner,,REP,Over Votes,0,0,0,0
Waller,310,"Chief Justice, Supreme Court",,REP,Nathan Hecht,2,43,18,63
Waller,310,"Chief Justice, Supreme Court",,REP,Ballots Cast,2,43,18,63
Waller,310,"Chief Justice, Supreme Court",,REP,Under Votes,1,9,2,12
Waller,310,"Chief Justice, Supreme Court",,REP,Over Votes,0,0,0,0
Waller,310,"Justice, Supreme Court, Place 6 Unexpired Term",,REP,Jane Bland,2,44,18,64
Waller,310,"Justice, Supreme Court, Place 6 Unexpired Term",,REP,Ballots Cast,2,44,18,64
Waller,310,"Justice, Supreme Court, Place 6 Unexpired Term",,REP,Under Votes,1,8,2,11
Waller,310,"Justice, Supreme Court, Place 6 Unexpired Term",,REP,Over Votes,0,0,0,0
Waller,310,"Justice, Supreme Court, Place 7",,REP,Jeff Boyd,2,43,18,63
Waller,310,"Justice, Supreme Court, Place 7",,REP,Ballots Cast,2,43,18,63
Waller,310,"Justice, Supreme Court, Place 7",,REP,Under Votes,1,9,2,12
Waller,310,"Justice, Supreme Court, Place 7",,REP,Over Votes,0,0,0,0
Waller,310,"Justice, Supreme Court, Place 8",,REP,Brett Busby,2,44,17,63
Waller,310,"Justice, Supreme Court, Place 8",,REP,Ballots Cast,2,44,17,63
Waller,310,"Justice, Supreme Court, Place 8",,REP,Under Votes,1,8,3,12
Waller,310,"Justice, Supreme Court, Place 8",,REP,Over Votes,0,0,0,0
Waller,310,"Judge, Court of Criminal Appeals, Place 3",,REP,Gina Parker,0,24,8,32
Waller,310,"Judge, Court of Criminal Appeals, Place 3",,REP,Bert Richardson,2,18,10,30
Waller,310,"Judge, Court of Criminal Appeals, Place 3",,REP,Ballots Cast,2,42,18,62
Waller,310,"Judge, Court of Criminal Appeals, Place 3",,REP,Under Votes,1,10,2,13
Waller,310,"Judge, Court of Criminal Appeals, Place 3",,REP,Over Votes,0,0,0,0
Waller,310,"Judge, Court of Criminal Appeals, Place 4",,REP,Kevin Patrick Yeary,2,44,18,64
Waller,310,"Judge, Court of Criminal Appeals, Place 4",,REP,Ballots Cast,2,44,18,64
Waller,310,"Judge, Court of Criminal Appeals, Place 4",,REP,Under Votes,1,8,2,11
Waller,310,"Judge, Court of Criminal Appeals, Place 4",,REP,Over Votes,0,0,0,0
Waller,310,"Judge, Court of Criminal Appeals, Place 9",,REP,David Newell,2,42,18,62
Waller,310,"Judge, Court of Criminal Appeals, Place 9",,REP,Ballots Cast,2,42,18,62
Waller,310,"Judge, Court of Criminal Appeals, Place 9",,REP,Under Votes,1,10,2,13
Waller,310,"Judge, Court of Criminal Appeals, Place 9",,REP,Over Votes,0,0,0,0
Waller,310,"Member, State Board of Education, District 10",,REP,Tom Maynard,2,42,18,62
Waller,310,"Member, State Board of Education, District 10",,REP,Ballots Cast,2,42,18,62
Waller,310,"Member, State Board of Education, District 10",,REP,Under Votes,1,10,2,13
Waller,310,"Member, State Board of Education, District 10",,REP,Over Votes,0,0,0,0
Waller,310,State Senate,18,REP,Lois W. Kolkhorst,2,42,18,62
Waller,310,State Senate,18,REP,Ballots Cast,2,42,18,62
Waller,310,State Senate,18,REP,Under Votes,1,10,2,13
Waller,310,State Senate,18,REP,Over Votes,0,0,0,0
Waller,310,State Representative,3,REP,Cecil Bell Jr,2,44,18,64
Waller,310,State Representative,3,REP,Ballots Cast,2,44,18,64
Waller,310,State Representative,3,REP,Under Votes,1,8,2,11
Waller,310,State Representative,3,REP,Over Votes,0,0,0,0
Waller,310,"Chief Justice, 14th Court of Appeals District",,REP,Tracy Elizabeth Christopher,2,43,18,63
Waller,310,"Chief Justice, 14th Court of Appeals District",,REP,Ballots Cast,2,43,18,63
Waller,310,"Chief Justice, 14th Court of Appeals District",,REP,Under Votes,1,9,2,12
Waller,310,"Chief Justice, 14th Court of Appeals District",,REP,Over Votes,0,0,0,0
Waller,310,"Justice, 1st Court of Appeals District, Place 3",,REP,Russell Lloyd,2,42,18,62
Waller,310,"Justice, 1st Court of Appeals District, Place 3",,REP,Ballots Cast,2,42,18,62
Waller,310,"Justice, 1st Court of Appeals District, Place 3",,REP,Under Votes,1,10,2,13
Waller,310,"Justice, 1st Court of Appeals District, Place 3",,REP,Over Votes,0,0,0,0
Waller,310,"Justice, 1st Court of Appeals District, Place 5",,REP,Chad Bridges,1,20,10,31
Waller,310,"Justice, 1st Court of Appeals District, Place 5",,REP,James Lombardino,0,6,0,6
Waller,310,"Justice, 1st Court of Appeals District, Place 5",,REP,Levi J. Benton,0,2,2,4
Waller,310,"Justice, 1st Court of Appeals District, Place 5",,REP,Terry Adams,1,14,4,19
Waller,310,"Justice, 1st Court of Appeals District, Place 5",,REP,Ballots Cast,2,42,16,60
Waller,310,"Justice, 1st Court of Appeals District, Place 5",,REP,Under Votes,1,10,4,15
Waller,310,"Justice, 1st Court of Appeals District, Place 5",,REP,Over Votes,0,0,0,0
Waller,310,"Justice, 14th Court of Appeals District, Place 7",,REP,Ken Wise,2,43,17,62
Waller,310,"Justice, 14th Court of Appeals District, Place 7",,REP,Ballots Cast,2,43,17,62
Waller,310,"Justice, 14th Court of Appeals District, Place 7",,REP,Under Votes,1,9,3,13
Waller,310,"Justice, 14th Court of Appeals District, Place 7",,REP,Over Votes,0,0,0,0
Waller,310,"District Judge, 506th Judicial District",,REP,Gary W. Chaney,2,44,17,63
Waller,310,"District Judge, 506th Judicial District",,REP,Ballots Cast,2,44,17,63
Waller,310,"District Judge, 506th Judicial District",,REP,Under Votes,1,8,3,12
Waller,310,"District Judge, 506th Judicial District",,REP,Over Votes,0,0,0,0
Waller,310,Sheriff,,REP,Dan Porter,0,5,1,6
Waller,310,Sheriff,,REP,R. Glenn Smith,2,19,11,32
Waller,310,Sheriff,,REP,Troy Guidry,1,27,7,35
Waller,310,Sheriff,,REP,Ballots Cast,3,51,19,73
Waller,310,Sheriff,,REP,Under Votes,0,1,1,2
Waller,310,Sheriff,,REP,Over Votes,0,0,0,0
Waller,310,County Tax Assessor-Collector,,REP,Ellen Contreras Shelburne,2,25,7,34
Waller,310,County Tax Assessor-Collector,,REP,Carolyn Miedke,1,25,13,39
Waller,310,County Tax Assessor-Collector,,REP,Ballots Cast,3,50,20,73
Waller,310,County Tax Assessor-Collector,,REP,Under Votes,0,2,0,2
Waller,310,County Tax Assessor-Collector,,REP,Over Votes,0,0,0,0
Waller,310,"County Commissioner, Precinct 3",,REP,Jeron Barnett,2,43,17,62
Waller,310,"County Commissioner, Precinct 3",,REP,Ballots Cast,2,43,17,62
Waller,310,"County Commissioner, Precinct 3",,REP,Under Votes,1,9,3,13
Waller,310,"County Commissioner, Precinct 3",,REP,Over Votes,0,0,0,0
Waller,310,"Constable, Precinct 3",,REP,Marvin Hood,2,45,17,64
Waller,310,"Constable, Precinct 3",,REP,Ballots Cast,2,45,17,64
Waller,310,"Constable, Precinct 3",,REP,Under Votes,1,7,3,11
Waller,310,"Constable, Precinct 3",,REP,Over Votes,0,0,0,0
Waller,310,County Chairman,,REP,David W. Luther,2,42,17,61
Waller,310,County Chairman,,REP,Ballots Cast,2,42,17,61
Waller,310,County Chairman,,REP,Under Votes,1,10,3,14
Waller,310,County Chairman,,REP,Over Votes,0,0,0,0
Waller,310,Proposition #1,,DEM,Yes,19,151,112,282
Waller,310,Proposition #1,,DEM,No,0,7,2,9
Waller,310,Proposition #1,,DEM,Ballots Cast,19,158,114,291
Waller,310,Proposition #1,,DEM,Under Votes,0,6,2,8
Waller,310,Proposition #1,,DEM,Over Votes,0,0,0,0
Waller,310,Proposition #2,,DEM,Yes,19,151,112,282
Waller,310,Proposition #2,,DEM,No,0,6,1,7
Waller,310,Proposition #2,,DEM,Ballots Cast,19,157,113,289
Waller,310,Proposition #2,,DEM,Under Votes,0,7,3,10
Waller,310,Proposition #2,,DEM,Over Votes,0,0,0,0
Waller,310,Proposition #3,,DEM,Yes,19,153,112,284
Waller,310,Proposition #3,,DEM,No,0,3,0,3
Waller,310,Proposition #3,,DEM,Ballots Cast,19,156,112,287
Waller,310,Proposition #3,,DEM,Under Votes,0,8,4,12
Waller,310,Proposition #3,,DEM,Over Votes,0,0,0,0
Waller,310,Proposition #4,,DEM,Yes,19,158,113,290
Waller,310,Proposition #4,,DEM,No,0,3,1,4
Waller,310,Proposition #4,,DEM,Ballots Cast,19,161,114,294
Waller,310,Proposition #4,,DEM,Under Votes,0,3,2,5
Waller,310,Proposition #4,,DEM,Over Votes,0,0,0,0
Waller,310,Proposition #5,,DEM,Yes,19,155,112,286
Waller,310,Proposition #5,,DEM,No,0,4,1,5
Waller,310,Proposition #5,,DEM,Ballots Cast,19,159,113,291
Waller,310,Proposition #5,,DEM,Under Votes,0,5,3,8
Waller,310,Proposition #5,,DEM,Over Votes,0,0,0,0
Waller,310,Proposition #6,,DEM,Yes,19,155,113,287
Waller,310,Proposition #6,,DEM,No,0,4,0,4
Waller,310,Proposition #6,,DEM,Ballots Cast,19,159,113,291
Waller,310,Proposition #6,,DEM,Under Votes,0,5,3,8
Waller,310,Proposition #6,,DEM,Over Votes,0,0,0,0
Waller,310,Proposition #7,,DEM,Yes,18,156,112,286
Waller,310,Proposition #7,,DEM,No,0,3,0,3
Waller,310,Proposition #7,,DEM,Ballots Cast,18,159,112,289
Waller,310,Proposition #7,,DEM,Under Votes,1,5,4,10
Waller,310,Proposition #7,,DEM,Over Votes,0,0,0,0
Waller,310,Proposition #8,,DEM,Yes,18,150,113,281
Waller,310,Proposition #8,,DEM,No,0,5,1,6
Waller,310,Proposition #8,,DEM,Ballots Cast,18,155,114,287
Waller,310,Proposition #8,,DEM,Under Votes,1,9,2,12
Waller,310,Proposition #8,,DEM,Over Votes,0,0,0,0
Waller,310,Proposition #9,,DEM,Yes,18,152,114,284
Waller,310,Proposition #9,,DEM,No,0,5,0,5
Waller,310,Proposition #9,,DEM,Ballots Cast,18,157,114,289
Waller,310,Proposition #9,,DEM,Under Votes,1,7,2,10
Waller,310,Proposition #9,,DEM,Over Votes,0,0,0,0
Waller,310,Proposition #10,,DEM,Yes,17,149,112,278
Waller,310,Proposition #10,,DEM,No,1,7,2,10
Waller,310,Proposition #10,,DEM,Ballots Cast,18,156,114,288
Waller,310,Proposition #10,,DEM,Under Votes,1,8,2,11
Waller,310,Proposition #10,,DEM,Over Votes,0,0,0,0
Waller,310,Proposition #11,,DEM,Yes,17,141,105,263
Waller,310,Proposition #11,,DEM,No,1,16,6,23
Waller,310,Proposition #11,,DEM,Ballots Cast,18,157,111,286
Waller,310,Proposition #11,,DEM,Under Votes,1,7,5,13
Waller,310,Proposition #11,,DEM,Over Votes,0,0,0,0
Waller,310,Proposition 1,,REP,Yes,3,44,18,65
Waller,310,Proposition 1,,REP,No,0,6,2,8
Waller,310,Proposition 1,,REP,Ballots Cast,3,50,20,73
Waller,310,Proposition 1,,REP,Under Votes,0,2,0,2
Waller,310,Proposition 1,,REP,Over Votes,0,0,0,0
Waller,310,Proposition 2,,REP,Yes,3,40,17,60
Waller,310,Proposition 2,,REP,No,0,12,3,15
Waller,310,Proposition 2,,REP,Ballots Cast,3,52,20,75
Waller,310,Proposition 2,,REP,Under Votes,0,0,0,0
Waller,310,Proposition 2,,REP,Over Votes,0,0,0,0
Waller,310,Proposition 3,,REP,Yes,3,49,19,71
Waller,310,Proposition 3,,REP,No,0,2,0,2
Waller,310,Proposition 3,,REP,Ballots Cast,3,51,19,73
Waller,310,Proposition 3,,REP,Under Votes,0,1,1,2
Waller,310,Proposition 3,,REP,Over Votes,0,0,0,0
Waller,310,Proposition 4,,REP,Yes,2,47,19,68
Waller,310,Proposition 4,,REP,No,1,4,1,6
Waller,310,Proposition 4,,REP,Ballots Cast,3,51,20,74
Waller,310,Proposition 4,,REP,Under Votes,0,1,0,1
Waller,310,Proposition 4,,REP,Over Votes,0,0,0,0
Waller,310,Proposition 5,,REP,Yes,3,45,19,67
Waller,310,Proposition 5,,REP,No,0,6,0,6
Waller,310,Proposition 5,,REP,Ballots Cast,3,51,19,73
Waller,310,Proposition 5,,REP,Under Votes,0,1,1,2
Waller,310,Proposition 5,,REP,Over Votes,0,0,0,0
Waller,310,Proposition 6,,REP,Yes,2,50,18,70
Waller,310,Proposition 6,,REP,No,0,1,2,3
Waller,310,Proposition 6,,REP,Ballots Cast,2,51,20,73
Waller,310,Proposition 6,,REP,Under Votes,0,1,0,1
Waller,310,Proposition 6,,REP,Over Votes,0,0,0,0
Waller,310,Proposition 7,,REP,Yes,2,49,20,71
Waller,310,Proposition 7,,REP,No,0,2,0,2
Waller,310,Proposition 7,,REP,Ballots Cast,2,51,20,73
Waller,310,Proposition 7,,REP,Under Votes,0,1,0,1
Waller,310,Proposition 7,,REP,Over Votes,0,0,0,0
Waller,310,Proposition 8,,REP,Yes,2,49,19,70
Waller,310,Proposition 8,,REP,No,0,0,0,0
Waller,310,Proposition 8,,REP,Ballots Cast,2,49,19,70
Waller,310,Proposition 8,,REP,Under Votes,0,3,1,4
Waller,310,Proposition 8,,REP,Over Votes,0,0,0,0
Waller,310,Proposition 9,,REP,Yes,2,46,17,65
Waller,310,Proposition 9,,REP,No,0,3,2,5
Waller,310,Proposition 9,,REP,Ballots Cast,2,49,19,70
Waller,310,Proposition 9,,REP,Under Votes,0,3,1,4
Waller,310,Proposition 9,,REP,Over Votes,0,0,0,0
Waller,310,Proposition 10,,REP,Yes,2,46,14,62
Waller,310,Proposition 10,,REP,No,0,4,6,10
Waller,310,Proposition 10,,REP,Ballots Cast,2,50,20,72
Waller,310,Proposition 10,,REP,Under Votes,0,2,0,2
Waller,310,Proposition 10,,REP,Over Votes,0,0,0,0
Waller,311,President,,DEM,Michael Bennet,0,1,0,1
Waller,311,President,,DEM,Marianne Williamson,0,0,0,0
Waller,311,President,,DEM,Cory Booker,0,0,0,0
Waller,311,President,,DEM,Bernie Sanders,0,3,18,21
Waller,311,President,,DEM,Tulsi Gabbard,0,0,0,0
Waller,311,President,,DEM,Deval Patrick,0,0,0,0
Waller,311,President,,DEM,Amy Klobuchar,0,0,0,0
Waller,311,President,,DEM,Julián Castro,0,0,2,2
Waller,311,President,,DEM,Elizabeth Warren,0,0,5,5
Waller,311,President,,DEM,John K. Delaney,0,0,0,0
Waller,311,President,,DEM,Robby Wells,0,0,0,0
Waller,311,President,,DEM,"Roque ""Rocky"" De La Fuente",0,0,0,0
Waller,311,President,,DEM,Andrew Yang,0,0,0,0
Waller,311,President,,DEM,Joseph R. Biden,0,5,24,29
Waller,311,President,,DEM,Michael R. Bloomberg,4,4,4,12
Waller,311,President,,DEM,Tom Steyer,0,0,0,0
Waller,311,President,,DEM,Pete Buttigieg,1,1,0,2
Waller,311,President,,DEM,Ballots Cast,5,14,53,72
Waller,311,President,,DEM,Under Votes,0,0,0,0
Waller,311,President,,DEM,Over Votes,0,0,0,0
Waller,311,U.S. Senate,,DEM,Royce West,0,0,1,1
Waller,311,U.S. Senate,,DEM,"Annie ""Mamá"" Garcia",1,1,3,5
Waller,311,U.S. Senate,,DEM,D. R. Hunter,1,1,1,3
Waller,311,U.S. Senate,,DEM,Sema Hernandez,0,1,6,7
Waller,311,U.S. Senate,,DEM,Adrian Ocegueda,0,0,1,1
Waller,311,U.S. Senate,,DEM,Chris Bell,1,3,16,20
Waller,311,U.S. Senate,,DEM,Cristina Tzintzun Ramirez,0,2,5,7
Waller,311,U.S. Senate,,DEM,Jack Daniel Foster Jr,0,0,2,2
Waller,311,U.S. Senate,,DEM,Amanda K. Edwards,0,0,0,0
Waller,311,U.S. Senate,,DEM,Victor Hugo Harris,1,0,2,3
Waller,311,U.S. Senate,,DEM,"Mary ""MJ"" Hegar",1,6,5,12
Waller,311,U.S. Senate,,DEM,Michael Cooper,0,0,4,4
Waller,311,U.S. Senate,,DEM,Ballots Cast,5,14,46,65
Waller,311,U.S. Senate,,DEM,Under Votes,0,0,7,7
Waller,311,U.S. Senate,,DEM,Over Votes,0,0,0,0
Waller,311,U.S. House,10,DEM,Mike Siegel,2,3,15,20
Waller,311,U.S. House,10,DEM,Shannon Hutcheson,0,6,14,20
Waller,311,U.S. House,10,DEM,Pritesh Gandhi,3,4,18,25
Waller,311,U.S. House,10,DEM,Ballots Cast,5,13,47,65
Waller,311,U.S. House,10,DEM,Under Votes,0,1,6,7
Waller,311,U.S. House,10,DEM,Over Votes,0,0,0,0
Waller,311,Railroad Commissioner,,DEM,"Roberto R. ""Beto"" Alonzo",4,3,10,17
Waller,311,Railroad Commissioner,,DEM,Chrysta Castañeda,1,5,10,16
Waller,311,Railroad Commissioner,,DEM,Mark Watson,0,2,13,15
Waller,311,Railroad Commissioner,,DEM,Kelly Stone,0,4,11,15
Waller,311,Railroad Commissioner,,DEM,Ballots Cast,5,14,44,63
Waller,311,Railroad Commissioner,,DEM,Under Votes,0,0,9,9
Waller,311,Railroad Commissioner,,DEM,Over Votes,0,0,0,0
Waller,311,"Chief Justice, Supreme Court",,DEM,Jerry Zimmerer,4,4,14,22
Waller,311,"Chief Justice, Supreme Court",,DEM,Amy Clark Meachum,1,10,32,43
Waller,311,"Chief Justice, Supreme Court",,DEM,Ballots Cast,5,14,46,65
Waller,311,"Chief Justice, Supreme Court",,DEM,Under Votes,0,0,7,7
Waller,311,"Chief Justice, Supreme Court",,DEM,Over Votes,0,0,0,0
Waller,311,"Justice, Supreme Court, Place 6 Unexpired Term",,DEM,Kathy Cheng,3,13,35,51
Waller,311,"Justice, Supreme Court, Place 6 Unexpired Term",,DEM,Larry Praeger,2,0,10,12
Waller,311,"Justice, Supreme Court, Place 6 Unexpired Term",,DEM,Ballots Cast,5,13,45,63
Waller,311,"Justice, Supreme Court, Place 6 Unexpired Term",,DEM,Under Votes,0,1,8,9
Waller,311,"Justice, Supreme Court, Place 6 Unexpired Term",,DEM,Over Votes,0,0,0,0
Waller,311,"Justice, Supreme Court, Place 7",,DEM,Staci Williams,1,9,32,42
Waller,311,"Justice, Supreme Court, Place 7",,DEM,Brandy Voss,4,4,14,22
Waller,311,"Justice, Supreme Court, Place 7",,DEM,Ballots Cast,5,13,46,64
Waller,311,"Justice, Supreme Court, Place 7",,DEM,Under Votes,0,1,7,8
Waller,311,"Justice, Supreme Court, Place 7",,DEM,Over Votes,0,0,0,0
Waller,311,"Justice, Supreme Court, Place 8",,DEM,Gisela D. Triana,2,9,25,36
Waller,311,"Justice, Supreme Court, Place 8",,DEM,Peter Kelly,3,4,20,27
Waller,311,"Justice, Supreme Court, Place 8",,DEM,Ballots Cast,5,13,45,63
Waller,311,"Justice, Supreme Court, Place 8",,DEM,Under Votes,0,1,8,9
Waller,311,"Justice, Supreme Court, Place 8",,DEM,Over Votes,0,0,0,0
Waller,311,"Judge, Court of Criminal Appeals, Place 3",,DEM,Elizabeth Davis Frizell,2,12,25,39
Waller,311,"Judge, Court of Criminal Appeals, Place 3",,DEM,William Pieratt Demond,1,1,6,8
Waller,311,"Judge, Court of Criminal Appeals, Place 3",,DEM,Dan Wood,2,1,14,17
Waller,311,"Judge, Court of Criminal Appeals, Place 3",,DEM,Ballots Cast,5,14,45,64
Waller,311,"Judge, Court of Criminal Appeals, Place 3",,DEM,Under Votes,0,0,8,8
Waller,311,"Judge, Court of Criminal Appeals, Place 3",,DEM,Over Votes,0,0,0,0
Waller,311,"Judge, Court of Criminal Appeals, Place 4",,DEM,Steven Miears,2,0,17,19
Waller,311,"Judge, Court of Criminal Appeals, Place 4",,DEM,Tina Clinton,3,14,29,46
Waller,311,"Judge, Court of Criminal Appeals, Place 4",,DEM,Ballots Cast,5,14,46,65
Waller,311,"Judge, Court of Criminal Appeals, Place 4",,DEM,Under Votes,0,0,7,7
Waller,311,"Judge, Court of Criminal Appeals, Place 4",,DEM,Over Votes,0,0,0,0
Waller,311,"Judge, Court of Criminal Appeals, Place 9",,DEM,Brandon Birmingham,4,11,39,54
Waller,311,"Judge, Court of Criminal Appeals, Place 9",,DEM,Ballots Cast,4,11,39,54
Waller,311,"Judge, Court of Criminal Appeals, Place 9",,DEM,Under Votes,1,3,14,18
Waller,311,"Judge, Court of Criminal Appeals, Place 9",,DEM,Over Votes,0,0,0,0
Waller,311,"Member, State Board of Education, District 10",,DEM,Stephen Wyman,1,1,10,12
Waller,311,"Member, State Board of Education, District 10",,DEM,Marsha Burnett-Webster,4,12,35,51
Waller,311,"Member, State Board of Education, District 10",,DEM,Ballots Cast,5,13,45,63
Waller,311,"Member, State Board of Education, District 10",,DEM,Under Votes,0,1,8,9
Waller,311,"Member, State Board of Education, District 10",,DEM,Over Votes,0,0,0,0
Waller,311,State Senate,18,DEM,Michael Antalan,4,11,38,53
Waller,311,State Senate,18,DEM,Ballots Cast,4,11,38,53
Waller,311,State Senate,18,DEM,Under Votes,1,3,15,19
Waller,311,State Senate,18,DEM,Over Votes,0,0,0,0
Waller,311,State Representative,3,DEM,Martin Shupp,4,11,42,57
Waller,311,State Representative,3,DEM,Ballots Cast,4,11,42,57
Waller,311,State Representative,3,DEM,Under Votes,1,3,11,15
Waller,311,State Representative,3,DEM,Over Votes,0,0,0,0
Waller,311,"Chief Justice, 14th Court of Appeals District",,DEM,Jane Robinson,4,14,31,49
Waller,311,"Chief Justice, 14th Court of Appeals District",,DEM,Jim Evans,1,0,15,16
Waller,311,"Chief Justice, 14th Court of Appeals District",,DEM,Ballots Cast,5,14,46,65
Waller,311,"Chief Justice, 14th Court of Appeals District",,DEM,Under Votes,0,0,7,7
Waller,311,"Chief Justice, 14th Court of Appeals District",,DEM,Over Votes,0,0,0,0
Waller,311,"Justice, 1st Court of Appeals District, Place 3",,DEM,Jim Sharp,2,3,23,28
Waller,311,"Justice, 1st Court of Appeals District, Place 3",,DEM,Dinesh Singhal,2,3,11,16
Waller,311,"Justice, 1st Court of Appeals District, Place 3",,DEM,Veronica Rivas-Molloy,1,7,10,18
Waller,311,"Justice, 1st Court of Appeals District, Place 3",,DEM,Ballots Cast,5,13,44,62
Waller,311,"Justice, 1st Court of Appeals District, Place 3",,DEM,Under Votes,0,1,9,10
Waller,311,"Justice, 1st Court of Appeals District, Place 3",,DEM,Over Votes,0,0,0,0
Waller,311,"Justice, 1st Court of Appeals District, Place 5",,DEM,Tim Hootman,2,8,17,27
Waller,311,"Justice, 1st Court of Appeals District, Place 5",,DEM,Amparo Monique Guerra,3,5,26,34
Waller,311,"Justice, 1st Court of Appeals District, Place 5",,DEM,Ballots Cast,5,13,43,61
Waller,311,"Justice, 1st Court of Appeals District, Place 5",,DEM,Under Votes,0,1,10,11
Waller,311,"Justice, 1st Court of Appeals District, Place 5",,DEM,Over Votes,0,0,0,0
Waller,311,"Justice, 14th Court of Appeals District, Place 7",,DEM,"Tamika ""Tami"" Craft",0,3,11,14
Waller,311,"Justice, 14th Court of Appeals District, Place 7",,DEM,Wally Kronzer,1,2,3,6
Waller,311,"Justice, 14th Court of Appeals District, Place 7",,DEM,V.R. Faulkner,1,0,4,5
Waller,311,"Justice, 14th Court of Appeals District, Place 7",,DEM,Cheri Thomas,1,6,8,15
Waller,311,"Justice, 14th Court of Appeals District, Place 7",,DEM,Dominic J. Merino,0,3,6,9
Waller,311,"Justice, 14th Court of Appeals District, Place 7",,DEM,Lennon C. Wright,2,0,6,8
Waller,311,"Justice, 14th Court of Appeals District, Place 7",,DEM,Ballots Cast,5,14,38,57
Waller,311,"Justice, 14th Court of Appeals District, Place 7",,DEM,Under Votes,0,0,15,15
Waller,311,"Justice, 14th Court of Appeals District, Place 7",,DEM,Over Votes,0,0,0,0
Waller,311,Sheriff,,DEM,Cedric D. Watson,3,11,41,55
Waller,311,Sheriff,,DEM,Ballots Cast,3,11,41,55
Waller,311,Sheriff,,DEM,Under Votes,2,3,12,17
Waller,311,Sheriff,,DEM,Over Votes,0,0,0,0
Waller,311,"County Commissioner, Precinct 3",,DEM,Christian Charleston,1,3,10,14
Waller,311,"County Commissioner, Precinct 3",,DEM,Darryl S. Johnson,4,4,14,22
Waller,311,"County Commissioner, Precinct 3",,DEM,Kendric D. Jones,0,6,20,26
Waller,311,"County Commissioner, Precinct 3",,DEM,Ballots Cast,5,13,44,62
Waller,311,"County Commissioner, Precinct 3",,DEM,Under Votes,0,1,9,10
Waller,311,"County Commissioner, Precinct 3",,DEM,Over Votes,0,0,0,0
Waller,311,"Constable, Precinct 3",,DEM,Herschel Smith,3,6,33,42
Waller,311,"Constable, Precinct 3",,DEM,Scott H. Green,2,7,11,20
Waller,311,"Constable, Precinct 3",,DEM,Ballots Cast,5,13,44,62
Waller,311,"Constable, Precinct 3",,DEM,Under Votes,0,1,9,10
Waller,311,"Constable, Precinct 3",,DEM,Over Votes,0,0,0,0
Waller,311,County Chairman,,DEM,Rosa Patlan Harris,5,12,39,56
Waller,311,County Chairman,,DEM,Ballots Cast,5,12,39,56
Waller,311,County Chairman,,DEM,Under Votes,0,2,14,16
Waller,311,County Chairman,,DEM,Over Votes,0,0,0,0
Waller,311,President,,REP,Donald J. Trump,0,63,99,162
Waller,311,President,,REP,Joe Walsh,0,0,0,0
Waller,311,President,,REP,Bob Ely,0,0,0,0
Waller,311,President,,REP,"Roque ""Rocky"" De La Fuente Guerra",0,1,0,1
Waller,311,President,,REP,Zoltan G. Istvan,0,0,0,0
Waller,311,President,,REP,Matthew John Matern,0,0,0,0
Waller,311,President,,REP,Bill Weld,0,1,0,1
Waller,311,President,,REP,Uncommitted,0,1,4,5
Waller,311,President,,REP,Ballots Cast,0,66,103,169
Waller,311,President,,REP,Under Votes,0,1,1,2
Waller,311,President,,REP,Over Votes,0,0,0,0
Waller,311,U.S. Senate,,REP,Dwayne Stovall,0,14,29,43
Waller,311,U.S. Senate,,REP,Mark Yancey,0,4,3,7
Waller,311,U.S. Senate,,REP,Virgil Bierschwale,0,1,0,1
Waller,311,U.S. Senate,,REP,John Anthony Castro,0,5,3,8
Waller,311,U.S. Senate,,REP,John Cornyn,0,40,59,99
Waller,311,U.S. Senate,,REP,Ballots Cast,0,64,94,158
Waller,311,U.S. Senate,,REP,Under Votes,0,3,10,13
Waller,311,U.S. Senate,,REP,Over Votes,0,0,0,0
Waller,311,U.S. House,10,REP,Michael McCaul,0,63,93,156
Waller,311,U.S. House,10,REP,Ballots Cast,0,63,93,156
Waller,311,U.S. House,10,REP,Under Votes,0,4,11,15
Waller,311,U.S. House,10,REP,Over Votes,0,0,0,0
Waller,311,Railroad Commissioner,,REP,Ryan Sitton,0,32,50,82
Waller,311,Railroad Commissioner,,REP,"James ""Jim"" Wright",0,28,37,65
Waller,311,Railroad Commissioner,,REP,Ballots Cast,0,60,87,147
Waller,311,Railroad Commissioner,,REP,Under Votes,0,7,17,24
Waller,311,Railroad Commissioner,,REP,Over Votes,0,0,0,0
Waller,311,"Chief Justice, Supreme Court",,REP,Nathan Hecht,0,60,90,150
Waller,311,"Chief Justice, Supreme Court",,REP,Ballots Cast,0,60,90,150
Waller,311,"Chief Justice, Supreme Court",,REP,Under Votes,0,7,14,21
Waller,311,"Chief Justice, Supreme Court",,REP,Over Votes,0,0,0,0
Waller,311,"Justice, Supreme Court, Place 6 Unexpired Term",,REP,Jane Bland,0,61,89,150
Waller,311,"Justice, Supreme Court, Place 6 Unexpired Term",,REP,Ballots Cast,0,61,89,150
Waller,311,"Justice, Supreme Court, Place 6 Unexpired Term",,REP,Under Votes,0,6,15,21
Waller,311,"Justice, Supreme Court, Place 6 Unexpired Term",,REP,Over Votes,0,0,0,0
Waller,311,"Justice, Supreme Court, Place 7",,REP,Jeff Boyd,0,61,89,150
Waller,311,"Justice, Supreme Court, Place 7",,REP,Ballots Cast,0,61,89,150
Waller,311,"Justice, Supreme Court, Place 7",,REP,Under Votes,0,6,15,21
Waller,311,"Justice, Supreme Court, Place 7",,REP,Over Votes,0,0,0,0
Waller,311,"Justice, Supreme Court, Place 8",,REP,Brett Busby,0,61,91,152
Waller,311,"Justice, Supreme Court, Place 8",,REP,Ballots Cast,0,61,91,152
Waller,311,"Justice, Supreme Court, Place 8",,REP,Under Votes,0,6,13,19
Waller,311,"Justice, Supreme Court, Place 8",,REP,Over Votes,0,0,0,0
Waller,311,"Judge, Court of Criminal Appeals, Place 3",,REP,Gina Parker,0,32,44,76
Waller,311,"Judge, Court of Criminal Appeals, Place 3",,REP,Bert Richardson,0,27,40,67
Waller,311,"Judge, Court of Criminal Appeals, Place 3",,REP,Ballots Cast,0,59,84,143
Waller,311,"Judge, Court of Criminal Appeals, Place 3",,REP,Under Votes,0,8,20,28
Waller,311,"Judge, Court of Criminal Appeals, Place 3",,REP,Over Votes,0,0,0,0
Waller,311,"Judge, Court of Criminal Appeals, Place 4",,REP,Kevin Patrick Yeary,0,61,85,146
Waller,311,"Judge, Court of Criminal Appeals, Place 4",,REP,Ballots Cast,0,61,85,146
Waller,311,"Judge, Court of Criminal Appeals, Place 4",,REP,Under Votes,0,6,19,25
Waller,311,"Judge, Court of Criminal Appeals, Place 4",,REP,Over Votes,0,0,0,0
Waller,311,"Judge, Court of Criminal Appeals, Place 9",,REP,David Newell,0,61,86,147
Waller,311,"Judge, Court of Criminal Appeals, Place 9",,REP,Ballots Cast,0,61,86,147
Waller,311,"Judge, Court of Criminal Appeals, Place 9",,REP,Under Votes,0,6,18,24
Waller,311,"Judge, Court of Criminal Appeals, Place 9",,REP,Over Votes,0,0,0,0
Waller,311,"Member, State Board of Education, District 10",,REP,Tom Maynard,0,61,88,149
Waller,311,"Member, State Board of Education, District 10",,REP,Ballots Cast,0,61,88,149
Waller,311,"Member, State Board of Education, District 10",,REP,Under Votes,0,6,16,22
Waller,311,"Member, State Board of Education, District 10",,REP,Over Votes,0,0,0,0
Waller,311,State Senate,18,REP,Lois W. Kolkhorst,0,60,87,147
Waller,311,State Senate,18,REP,Ballots Cast,0,60,87,147
Waller,311,State Senate,18,REP,Under Votes,0,7,17,24
Waller,311,State Senate,18,REP,Over Votes,0,0,0,0
Waller,311,State Representative,3,REP,Cecil Bell Jr,0,58,84,142
Waller,311,State Representative,3,REP,Ballots Cast,0,58,84,142
Waller,311,State Representative,3,REP,Under Votes,0,9,20,29
Waller,311,State Representative,3,REP,Over Votes,0,0,0,0
Waller,311,"Chief Justice, 14th Court of Appeals District",,REP,Tracy Elizabeth Christopher,0,60,85,145
Waller,311,"Chief Justice, 14th Court of Appeals District",,REP,Ballots Cast,0,60,85,145
Waller,311,"Chief Justice, 14th Court of Appeals District",,REP,Under Votes,0,7,19,26
Waller,311,"Chief Justice, 14th Court of Appeals District",,REP,Over Votes,0,0,0,0
Waller,311,"Justice, 1st Court of Appeals District, Place 3",,REP,Russell Lloyd,0,60,87,147
Waller,311,"Justice, 1st Court of Appeals District, Place 3",,REP,Ballots Cast,0,60,87,147
Waller,311,"Justice, 1st Court of Appeals District, Place 3",,REP,Under Votes,0,7,17,24
Waller,311,"Justice, 1st Court of Appeals District, Place 3",,REP,Over Votes,0,0,0,0
Waller,311,"Justice, 1st Court of Appeals District, Place 5",,REP,Chad Bridges,0,24,35,59
Waller,311,"Justice, 1st Court of Appeals District, Place 5",,REP,James Lombardino,0,9,4,13
Waller,311,"Justice, 1st Court of Appeals District, Place 5",,REP,Levi J. Benton,0,8,13,21
Waller,311,"Justice, 1st Court of Appeals District, Place 5",,REP,Terry Adams,0,14,30,44
Waller,311,"Justice, 1st Court of Appeals District, Place 5",,REP,Ballots Cast,0,55,82,137
Waller,311,"Justice, 1st Court of Appeals District, Place 5",,REP,Under Votes,0,12,22,34
Waller,311,"Justice, 1st Court of Appeals District, Place 5",,REP,Over Votes,0,0,0,0
Waller,311,"Justice, 14th Court of Appeals District, Place 7",,REP,Ken Wise,0,61,85,146
Waller,311,"Justice, 14th Court of Appeals District, Place 7",,REP,Ballots Cast,0,61,85,146
Waller,311,"Justice, 14th Court of Appeals District, Place 7",,REP,Under Votes,0,6,19,25
Waller,311,"Justice, 14th Court of Appeals District, Place 7",,REP,Over Votes,0,0,0,0
Waller,311,"District Judge, 506th Judicial District",,REP,Gary W. Chaney,0,60,90,150
Waller,311,"District Judge, 506th Judicial District",,REP,Ballots Cast,0,60,90,150
Waller,311,"District Judge, 506th Judicial District",,REP,Under Votes,0,7,14,21
Waller,311,"District Judge, 506th Judicial District",,REP,Over Votes,0,0,0,0
Waller,311,Sheriff,,REP,Dan Porter,0,10,18,28
Waller,311,Sheriff,,REP,R. Glenn Smith,0,21,48,69
Waller,311,Sheriff,,REP,Troy Guidry,0,34,36,70
Waller,311,Sheriff,,REP,Ballots Cast,0,65,102,167
Waller,311,Sheriff,,REP,Under Votes,0,2,2,4
Waller,311,Sheriff,,REP,Over Votes,0,0,0,0
Waller,311,County Tax Assessor-Collector,,REP,Ellen Contreras Shelburne,0,28,58,86
Waller,311,County Tax Assessor-Collector,,REP,Carolyn Miedke,0,38,41,79
Waller,311,County Tax Assessor-Collector,,REP,Ballots Cast,0,66,99,165
Waller,311,County Tax Assessor-Collector,,REP,Under Votes,0,1,5,6
Waller,311,County Tax Assessor-Collector,,REP,Over Votes,0,0,0,0
Waller,311,"County Commissioner, Precinct 3",,REP,Jeron Barnett,0,58,84,142
Waller,311,"County Commissioner, Precinct 3",,REP,Ballots Cast,0,58,84,142
Waller,311,"County Commissioner, Precinct 3",,REP,Under Votes,0,9,20,29
Waller,311,"County Commissioner, Precinct 3",,REP,Over Votes,0,0,0,0
Waller,311,"Constable, Precinct 3",,REP,Marvin Hood,0,60,81,141
Waller,311,"Constable, Precinct 3",,REP,Ballots Cast,0,60,81,141
Waller,311,"Constable, Precinct 3",,REP,Under Votes,0,7,23,30
Waller,311,"Constable, Precinct 3",,REP,Over Votes,0,0,0,0
Waller,311,County Chairman,,REP,David W. Luther,0,58,83,141
Waller,311,County Chairman,,REP,Ballots Cast,0,58,83,141
Waller,311,County Chairman,,REP,Under Votes,0,9,21,30
Waller,311,County Chairman,,REP,Over Votes,0,0,0,0
Waller,311,Proposition #1,,DEM,Yes,5,13,50,68
Waller,311,Proposition #1,,DEM,No,0,1,1,2
Waller,311,Proposition #1,,DEM,Ballots Cast,5,14,51,70
Waller,311,Proposition #1,,DEM,Under Votes,0,0,2,2
Waller,311,Proposition #1,,DEM,Over Votes,0,0,0,0
Waller,311,Proposition #2,,DEM,Yes,4,13,45,62
Waller,311,Proposition #2,,DEM,No,1,1,5,7
Waller,311,Proposition #2,,DEM,Ballots Cast,5,14,50,69
Waller,311,Proposition #2,,DEM,Under Votes,0,0,3,3
Waller,311,Proposition #2,,DEM,Over Votes,0,0,0,0
Waller,311,Proposition #3,,DEM,Yes,5,14,47,66
Waller,311,Proposition #3,,DEM,No,0,0,2,2
Waller,311,Proposition #3,,DEM,Ballots Cast,5,14,49,68
Waller,311,Proposition #3,,DEM,Under Votes,0,0,4,4
Waller,311,Proposition #3,,DEM,Over Votes,0,0,0,0
Waller,311,Proposition #4,,DEM,Yes,5,13,46,64
Waller,311,Proposition #4,,DEM,No,0,1,4,5
Waller,311,Proposition #4,,DEM,Ballots Cast,5,14,50,69
Waller,311,Proposition #4,,DEM,Under Votes,0,0,3,3
Waller,311,Proposition #4,,DEM,Over Votes,0,0,0,0
Waller,311,Proposition #5,,DEM,Yes,5,14,48,67
Waller,311,Proposition #5,,DEM,No,0,0,2,2
Waller,311,Proposition #5,,DEM,Ballots Cast,5,14,50,69
Waller,311,Proposition #5,,DEM,Under Votes,0,0,3,3
Waller,311,Proposition #5,,DEM,Over Votes,0,0,0,0
Waller,311,Proposition #6,,DEM,Yes,5,13,48,66
Waller,311,Proposition #6,,DEM,No,0,0,2,2
Waller,311,Proposition #6,,DEM,Ballots Cast,5,13,50,68
Waller,311,Proposition #6,,DEM,Under Votes,0,1,3,4
Waller,311,Proposition #6,,DEM,Over Votes,0,0,0,0
Waller,311,Proposition #7,,DEM,Yes,5,12,46,63
Waller,311,Proposition #7,,DEM,No,0,1,4,5
Waller,311,Proposition #7,,DEM,Ballots Cast,5,13,50,68
Waller,311,Proposition #7,,DEM,Under Votes,0,1,3,4
Waller,311,Proposition #7,,DEM,Over Votes,0,0,0,0
Waller,311,Proposition #8,,DEM,Yes,5,14,46,65
Waller,311,Proposition #8,,DEM,No,0,0,4,4
Waller,311,Proposition #8,,DEM,Ballots Cast,5,14,50,69
Waller,311,Proposition #8,,DEM,Under Votes,0,0,3,3
Waller,311,Proposition #8,,DEM,Over Votes,0,0,0,0
Waller,311,Proposition #9,,DEM,Yes,5,13,46,64
Waller,311,Proposition #9,,DEM,No,0,1,3,4
Waller,311,Proposition #9,,DEM,Ballots Cast,5,14,49,68
Waller,311,Proposition #9,,DEM,Under Votes,0,0,4,4
Waller,311,Proposition #9,,DEM,Over Votes,0,0,0,0
Waller,311,Proposition #10,,DEM,Yes,5,13,45,63
Waller,311,Proposition #10,,DEM,No,0,1,5,6
Waller,311,Proposition #10,,DEM,Ballots Cast,5,14,50,69
Waller,311,Proposition #10,,DEM,Under Votes,0,0,3,3
Waller,311,Proposition #10,,DEM,Over Votes,0,0,0,0
Waller,311,Proposition #11,,DEM,Yes,5,11,43,59
Waller,311,Proposition #11,,DEM,No,0,2,6,8
Waller,311,Proposition #11,,DEM,Ballots Cast,5,13,49,67
Waller,311,Proposition #11,,DEM,Under Votes,0,1,4,5
Waller,311,Proposition #11,,DEM,Over Votes,0,0,0,0
Waller,311,Proposition 1,,REP,Yes,0,60,87,147
Waller,311,Proposition 1,,REP,No,0,6,12,18
Waller,311,Proposition 1,,REP,Ballots Cast,0,66,99,165
Waller,311,Proposition 1,,REP,Under Votes,0,1,5,6
Waller,311,Proposition 1,,REP,Over Votes,0,0,0,0
Waller,311,Proposition 2,,REP,Yes,0,58,90,148
Waller,311,Proposition 2,,REP,No,0,8,8,16
Waller,311,Proposition 2,,REP,Ballots Cast,0,66,98,164
Waller,311,Proposition 2,,REP,Under Votes,0,1,6,7
Waller,311,Proposition 2,,REP,Over Votes,0,0,0,0
Waller,311,Proposition 3,,REP,Yes,0,64,95,159
Waller,311,Proposition 3,,REP,No,0,2,5,7
Waller,311,Proposition 3,,REP,Ballots Cast,0,66,100,166
Waller,311,Proposition 3,,REP,Under Votes,0,1,4,5
Waller,311,Proposition 3,,REP,Over Votes,0,0,0,0
Waller,311,Proposition 4,,REP,Yes,0,61,95,156
Waller,311,Proposition 4,,REP,No,0,4,5,9
Waller,311,Proposition 4,,REP,Ballots Cast,0,65,100,165
Waller,311,Proposition 4,,REP,Under Votes,0,2,4,6
Waller,311,Proposition 4,,REP,Over Votes,0,0,0,0
Waller,311,Proposition 5,,REP,Yes,0,55,87,142
Waller,311,Proposition 5,,REP,No,0,9,11,20
Waller,311,Proposition 5,,REP,Ballots Cast,0,64,98,162
Waller,311,Proposition 5,,REP,Under Votes,0,3,6,9
Waller,311,Proposition 5,,REP,Over Votes,0,0,0,0
Waller,311,Proposition 6,,REP,Yes,0,64,92,156
Waller,311,Proposition 6,,REP,No,0,2,8,10
Waller,311,Proposition 6,,REP,Ballots Cast,0,66,100,166
Waller,311,Proposition 6,,REP,Under Votes,0,1,4,5
Waller,311,Proposition 6,,REP,Over Votes,0,0,0,0
Waller,311,Proposition 7,,REP,Yes,0,65,99,164
Waller,311,Proposition 7,,REP,No,0,1,0,1
Waller,311,Proposition 7,,REP,Ballots Cast,0,66,99,165
Waller,311,Proposition 7,,REP,Under Votes,0,1,5,6
Waller,311,Proposition 7,,REP,Over Votes,0,0,0,0
Waller,311,Proposition 8,,REP,Yes,0,62,98,160
Waller,311,Proposition 8,,REP,No,0,2,1,3
Waller,311,Proposition 8,,REP,Ballots Cast,0,64,99,163
Waller,311,Proposition 8,,REP,Under Votes,0,3,5,8
Waller,311,Proposition 8,,REP,Over Votes,0,0,0,0
Waller,311,Proposition 9,,REP,Yes,0,64,94,158
Waller,311,Proposition 9,,REP,No,0,1,6,7
Waller,311,Proposition 9,,REP,Ballots Cast,0,65,100,165
Waller,311,Proposition 9,,REP,Under Votes,0,2,4,6
Waller,311,Proposition 9,,REP,Over Votes,0,0,0,0
Waller,311,Proposition 10,,REP,Yes,0,58,92,150
Waller,311,Proposition 10,,REP,No,0,5,5,10
Waller,311,Proposition 10,,REP,Ballots Cast,0,63,97,160
Waller,311,Proposition 10,,REP,Under Votes,0,4,7,11
Waller,311,Proposition 10,,REP,Over Votes,0,0,0,0
Waller,312,President,,DEM,Michael Bennet,0,1,0,1
Waller,312,President,,DEM,Marianne Williamson,0,0,0,0
Waller,312,President,,DEM,Cory Booker,0,0,0,0
Waller,312,President,,DEM,Bernie Sanders,0,5,16,21
Waller,312,President,,DEM,Tulsi Gabbard,0,1,0,1
Waller,312,President,,DEM,Deval Patrick,0,0,0,0
Waller,312,President,,DEM,Amy Klobuchar,0,2,1,3
Waller,312,President,,DEM,Julián Castro,0,0,0,0
Waller,312,President,,DEM,Elizabeth Warren,0,4,3,7
Waller,312,President,,DEM,John K. Delaney,0,0,0,0
Waller,312,President,,DEM,Robby Wells,0,0,0,0
Waller,312,President,,DEM,"Roque ""Rocky"" De La Fuente",0,0,0,0
Waller,312,President,,DEM,Andrew Yang,0,0,0,0
Waller,312,President,,DEM,Joseph R. Biden,4,5,22,31
Waller,312,President,,DEM,Michael R. Bloomberg,4,4,4,12
Waller,312,President,,DEM,Tom Steyer,0,0,0,0
Waller,312,President,,DEM,Pete Buttigieg,0,2,0,2
Waller,312,President,,DEM,Ballots Cast,8,24,46,78
Waller,312,President,,DEM,Under Votes,0,1,1,2
Waller,312,President,,DEM,Over Votes,0,0,0,0
Waller,312,U.S. Senate,,DEM,Royce West,2,0,1,3
Waller,312,U.S. Senate,,DEM,"Annie ""Mamá"" Garcia",0,2,3,5
Waller,312,U.S. Senate,,DEM,D. R. Hunter,1,2,0,3
Waller,312,U.S. Senate,,DEM,Sema Hernandez,1,1,7,9
Waller,312,U.S. Senate,,DEM,Adrian Ocegueda,0,0,0,0
Waller,312,U.S. Senate,,DEM,Chris Bell,1,6,13,20
Waller,312,U.S. Senate,,DEM,Cristina Tzintzun Ramirez,0,2,3,5
Waller,312,U.S. Senate,,DEM,Jack Daniel Foster Jr,0,0,2,2
Waller,312,U.S. Senate,,DEM,Amanda K. Edwards,0,2,1,3
Waller,312,U.S. Senate,,DEM,Victor Hugo Harris,0,0,1,1
Waller,312,U.S. Senate,,DEM,"Mary ""MJ"" Hegar",2,4,10,16
Waller,312,U.S. Senate,,DEM,Michael Cooper,0,1,1,2
Waller,312,U.S. Senate,,DEM,Ballots Cast,7,20,42,69
Waller,312,U.S. Senate,,DEM,Under Votes,1,5,5,11
Waller,312,U.S. Senate,,DEM,Over Votes,0,0,0,0
Waller,312,U.S. House,10,DEM,Mike Siegel,3,10,24,37
Waller,312,U.S. House,10,DEM,Shannon Hutcheson,2,7,11,20
Waller,312,U.S. House,10,DEM,Pritesh Gandhi,2,4,8,14
Waller,312,U.S. House,10,DEM,Ballots Cast,7,21,43,71
Waller,312,U.S. House,10,DEM,Under Votes,1,4,4,9
Waller,312,U.S. House,10,DEM,Over Votes,0,0,0,0
Waller,312,Railroad Commissioner,,DEM,"Roberto R. ""Beto"" Alonzo",2,7,14,23
Waller,312,Railroad Commissioner,,DEM,Chrysta Castañeda,1,4,7,12
Waller,312,Railroad Commissioner,,DEM,Mark Watson,3,3,8,14
Waller,312,Railroad Commissioner,,DEM,Kelly Stone,1,4,10,15
Waller,312,Railroad Commissioner,,DEM,Ballots Cast,7,18,39,64
Waller,312,Railroad Commissioner,,DEM,Under Votes,1,7,8,16
Waller,312,Railroad Commissioner,,DEM,Over Votes,0,0,0,0
Waller,312,"Chief Justice, Supreme Court",,DEM,Jerry Zimmerer,2,2,15,19
Waller,312,"Chief Justice, Supreme Court",,DEM,Amy Clark Meachum,4,14,24,42
Waller,312,"Chief Justice, Supreme Court",,DEM,Ballots Cast,6,16,39,61
Waller,312,"Chief Justice, Supreme Court",,DEM,Under Votes,2,9,8,19
Waller,312,"Chief Justice, Supreme Court",,DEM,Over Votes,0,0,0,0
Waller,312,"Justice, Supreme Court, Place 6 Unexpired Term",,DEM,Kathy Cheng,3,12,31,46
Waller,312,"Justice, Supreme Court, Place 6 Unexpired Term",,DEM,Larry Praeger,3,4,6,13
Waller,312,"Justice, Supreme Court, Place 6 Unexpired Term",,DEM,Ballots Cast,6,16,37,59
Waller,312,"Justice, Supreme Court, Place 6 Unexpired Term",,DEM,Under Votes,2,9,10,21
Waller,312,"Justice, Supreme Court, Place 6 Unexpired Term",,DEM,Over Votes,0,0,0,0
Waller,312,"Justice, Supreme Court, Place 7",,DEM,Staci Williams,6,8,25,39
Waller,312,"Justice, Supreme Court, Place 7",,DEM,Brandy Voss,1,8,11,20
Waller,312,"Justice, Supreme Court, Place 7",,DEM,Ballots Cast,7,16,36,59
Waller,312,"Justice, Supreme Court, Place 7",,DEM,Under Votes,1,9,11,21
Waller,312,"Justice, Supreme Court, Place 7",,DEM,Over Votes,0,0,0,0
Waller,312,"Justice, Supreme Court, Place 8",,DEM,Gisela D. Triana,2,16,23,41
Waller,312,"Justice, Supreme Court, Place 8",,DEM,Peter Kelly,3,1,12,16
Waller,312,"Justice, Supreme Court, Place 8",,DEM,Ballots Cast,5,17,35,57
Waller,312,"Justice, Supreme Court, Place 8",,DEM,Under Votes,3,8,12,23
Waller,312,"Justice, Supreme Court, Place 8",,DEM,Over Votes,0,0,0,0
Waller,312,"Judge, Court of Criminal Appeals, Place 3",,DEM,Elizabeth Davis Frizell,4,12,20,36
Waller,312,"Judge, Court of Criminal Appeals, Place 3",,DEM,William Pieratt Demond,0,1,7,8
Waller,312,"Judge, Court of Criminal Appeals, Place 3",,DEM,Dan Wood,2,2,8,12
Waller,312,"Judge, Court of Criminal Appeals, Place 3",,DEM,Ballots Cast,6,15,35,56
Waller,312,"Judge, Court of Criminal Appeals, Place 3",,DEM,Under Votes,2,10,12,24
Waller,312,"Judge, Court of Criminal Appeals, Place 3",,DEM,Over Votes,0,0,0,0
Waller,312,"Judge, Court of Criminal Appeals, Place 4",,DEM,Steven Miears,1,4,6,11
Waller,312,"Judge, Court of Criminal Appeals, Place 4",,DEM,Tina Clinton,5,12,29,46
Waller,312,"Judge, Court of Criminal Appeals, Place 4",,DEM,Ballots Cast,6,16,35,57
Waller,312,"Judge, Court of Criminal Appeals, Place 4",,DEM,Under Votes,2,9,12,23
Waller,312,"Judge, Court of Criminal Appeals, Place 4",,DEM,Over Votes,0,0,0,0
Waller,312,"Judge, Court of Criminal Appeals, Place 9",,DEM,Brandon Birmingham,4,16,31,51
Waller,312,"Judge, Court of Criminal Appeals, Place 9",,DEM,Ballots Cast,4,16,31,51
Waller,312,"Judge, Court of Criminal Appeals, Place 9",,DEM,Under Votes,4,9,16,29
Waller,312,"Judge, Court of Criminal Appeals, Place 9",,DEM,Over Votes,0,0,0,0
Waller,312,"Member, State Board of Education, District 10",,DEM,Stephen Wyman,2,3,13,18
Waller,312,"Member, State Board of Education, District 10",,DEM,Marsha Burnett-Webster,2,13,21,36
Waller,312,"Member, State Board of Education, District 10",,DEM,Ballots Cast,4,16,34,54
Waller,312,"Member, State Board of Education, District 10",,DEM,Under Votes,4,9,13,26
Waller,312,"Member, State Board of Education, District 10",,DEM,Over Votes,0,0,0,0
Waller,312,State Senate,18,DEM,Michael Antalan,3,15,32,50
Waller,312,State Senate,18,DEM,Ballots Cast,3,15,32,50
Waller,312,State Senate,18,DEM,Under Votes,5,10,15,30
Waller,312,State Senate,18,DEM,Over Votes,0,0,0,0
Waller,312,State Representative,3,DEM,Martin Shupp,3,15,31,49
Waller,312,State Representative,3,DEM,Ballots Cast,3,15,31,49
Waller,312,State Representative,3,DEM,Under Votes,5,10,16,31
Waller,312,State Representative,3,DEM,Over Votes,0,0,0,0
Waller,312,"Chief Justice, 14th Court of Appeals District",,DEM,Jane Robinson,3,13,25,41
Waller,312,"Chief Justice, 14th Court of Appeals District",,DEM,Jim Evans,3,3,10,16
Waller,312,"Chief Justice, 14th Court of Appeals District",,DEM,Ballots Cast,6,16,35,57
Waller,312,"Chief Justice, 14th Court of Appeals District",,DEM,Under Votes,2,9,12,23
Waller,312,"Chief Justice, 14th Court of Appeals District",,DEM,Over Votes,0,0,0,0
Waller,312,"Justice, 1st Court of Appeals District, Place 3",,DEM,Jim Sharp,2,3,13,18
Waller,312,"Justice, 1st Court of Appeals District, Place 3",,DEM,Dinesh Singhal,2,3,4,9
Waller,312,"Justice, 1st Court of Appeals District, Place 3",,DEM,Veronica Rivas-Molloy,2,11,20,33
Waller,312,"Justice, 1st Court of Appeals District, Place 3",,DEM,Ballots Cast,6,17,37,60
Waller,312,"Justice, 1st Court of Appeals District, Place 3",,DEM,Under Votes,2,8,10,20
Waller,312,"Justice, 1st Court of Appeals District, Place 3",,DEM,Over Votes,0,0,0,0
Waller,312,"Justice, 1st Court of Appeals District, Place 5",,DEM,Tim Hootman,3,3,15,21
Waller,312,"Justice, 1st Court of Appeals District, Place 5",,DEM,Amparo Monique Guerra,2,14,19,35
Waller,312,"Justice, 1st Court of Appeals District, Place 5",,DEM,Ballots Cast,5,17,34,56
Waller,312,"Justice, 1st Court of Appeals District, Place 5",,DEM,Under Votes,3,8,13,24
Waller,312,"Justice, 1st Court of Appeals District, Place 5",,DEM,Over Votes,0,0,0,0
Waller,312,"Justice, 14th Court of Appeals District, Place 7",,DEM,"Tamika ""Tami"" Craft",0,3,11,14
Waller,312,"Justice, 14th Court of Appeals District, Place 7",,DEM,Wally Kronzer,0,1,6,7
Waller,312,"Justice, 14th Court of Appeals District, Place 7",,DEM,V.R. Faulkner,1,0,2,3
Waller,312,"Justice, 14th Court of Appeals District, Place 7",,DEM,Cheri Thomas,3,7,10,20
Waller,312,"Justice, 14th Court of Appeals District, Place 7",,DEM,Dominic J. Merino,0,5,3,8
Waller,312,"Justice, 14th Court of Appeals District, Place 7",,DEM,Lennon C. Wright,2,1,2,5
Waller,312,"Justice, 14th Court of Appeals District, Place 7",,DEM,Ballots Cast,6,17,34,57
Waller,312,"Justice, 14th Court of Appeals District, Place 7",,DEM,Under Votes,2,8,13,23
Waller,312,"Justice, 14th Court of Appeals District, Place 7",,DEM,Over Votes,0,0,0,0
Waller,312,Sheriff,,DEM,Cedric D. Watson,3,16,33,52
Waller,312,Sheriff,,DEM,Ballots Cast,3,16,33,52
Waller,312,Sheriff,,DEM,Under Votes,5,9,14,28
Waller,312,Sheriff,,DEM,Over Votes,0,0,0,0
Waller,312,"County Commissioner, Precinct 3",,DEM,Christian Charleston,2,6,17,25
Waller,312,"County Commissioner, Precinct 3",,DEM,Darryl S. Johnson,2,7,11,20
Waller,312,"County Commissioner, Precinct 3",,DEM,Kendric D. Jones,0,4,8,12
Waller,312,"County Commissioner, Precinct 3",,DEM,Ballots Cast,4,17,36,57
Waller,312,"County Commissioner, Precinct 3",,DEM,Under Votes,4,8,11,23
Waller,312,"County Commissioner, Precinct 3",,DEM,Over Votes,0,0,0,0
Waller,312,"Constable, Precinct 3",,DEM,Herschel Smith,2,6,18,26
Waller,312,"Constable, Precinct 3",,DEM,Scott H. Green,3,13,21,37
Waller,312,"Constable, Precinct 3",,DEM,Ballots Cast,5,19,39,63
Waller,312,"Constable, Precinct 3",,DEM,Under Votes,3,6,8,17
Waller,312,"Constable, Precinct 3",,DEM,Over Votes,0,0,0,0
Waller,312,County Chairman,,DEM,Rosa Patlan Harris,1,17,31,49
Waller,312,County Chairman,,DEM,Ballots Cast,1,17,31,49
Waller,312,County Chairman,,DEM,Under Votes,7,8,16,31
Waller,312,County Chairman,,DEM,Over Votes,0,0,0,0
Waller,312,President,,REP,Donald J. Trump,23,221,154,398
Waller,312,President,,REP,Joe Walsh,0,0,2,2
Waller,312,President,,REP,Bob Ely,0,0,0,0
Waller,312,President,,REP,"Roque ""Rocky"" De La Fuente Guerra",0,1,1,2
Waller,312,President,,REP,Zoltan G. Istvan,0,0,0,0
Waller,312,President,,REP,Matthew John Matern,0,0,0,0
Waller,312,President,,REP,Bill Weld,0,2,1,3
Waller,312,President,,REP,Uncommitted,0,3,1,4
Waller,312,President,,REP,Ballots Cast,23,227,159,409
Waller,312,President,,REP,Under Votes,1,0,0,1
Waller,312,President,,REP,Over Votes,0,0,0,0
Waller,312,U.S. Senate,,REP,Dwayne Stovall,1,38,37,76
Waller,312,U.S. Senate,,REP,Mark Yancey,0,13,8,21
Waller,312,U.S. Senate,,REP,Virgil Bierschwale,0,0,1,1
Waller,312,U.S. Senate,,REP,John Anthony Castro,0,3,2,5
Waller,312,U.S. Senate,,REP,John Cornyn,20,167,97,284
Waller,312,U.S. Senate,,REP,Ballots Cast,21,221,145,387
Waller,312,U.S. Senate,,REP,Under Votes,3,6,14,23
Waller,312,U.S. Senate,,REP,Over Votes,0,0,0,0
Waller,312,U.S. House,10,REP,Michael McCaul,20,209,143,372
Waller,312,U.S. House,10,REP,Ballots Cast,20,209,143,372
Waller,312,U.S. House,10,REP,Under Votes,4,18,16,38
Waller,312,U.S. House,10,REP,Over Votes,0,0,0,0
Waller,312,Railroad Commissioner,,REP,Ryan Sitton,11,126,84,221
Waller,312,Railroad Commissioner,,REP,"James ""Jim"" Wright",6,76,57,139
Waller,312,Railroad Commissioner,,REP,Ballots Cast,17,202,141,360
Waller,312,Railroad Commissioner,,REP,Under Votes,7,25,18,50
Waller,312,Railroad Commissioner,,REP,Over Votes,0,0,0,0
Waller,312,"Chief Justice, Supreme Court",,REP,Nathan Hecht,16,199,141,356
Waller,312,"Chief Justice, Supreme Court",,REP,Ballots Cast,16,199,141,356
Waller,312,"Chief Justice, Supreme Court",,REP,Under Votes,8,28,18,54
Waller,312,"Chief Justice, Supreme Court",,REP,Over Votes,0,0,0,0
Waller,312,"Justice, Supreme Court, Place 6 Unexpired Term",,REP,Jane Bland,14,197,141,352
Waller,312,"Justice, Supreme Court, Place 6 Unexpired Term",,REP,Ballots Cast,14,197,141,352
Waller,312,"Justice, Supreme Court, Place 6 Unexpired Term",,REP,Under Votes,10,30,18,58
Waller,312,"Justice, Supreme Court, Place 6 Unexpired Term",,REP,Over Votes,0,0,0,0
Waller,312,"Justice, Supreme Court, Place 7",,REP,Jeff Boyd,15,199,142,356
Waller,312,"Justice, Supreme Court, Place 7",,REP,Ballots Cast,15,199,142,356
Waller,312,"Justice, Supreme Court, Place 7",,REP,Under Votes,9,28,17,54
Waller,312,"Justice, Supreme Court, Place 7",,REP,Over Votes,0,0,0,0
Waller,312,"Justice, Supreme Court, Place 8",,REP,Brett Busby,15,196,141,352
Waller,312,"Justice, Supreme Court, Place 8",,REP,Ballots Cast,15,196,141,352
Waller,312,"Justice, Supreme Court, Place 8",,REP,Under Votes,9,31,18,58
Waller,312,"Justice, Supreme Court, Place 8",,REP,Over Votes,0,0,0,0
Waller,312,"Judge, Court of Criminal Appeals, Place 3",,REP,Gina Parker,4,80,64,148
Waller,312,"Judge, Court of Criminal Appeals, Place 3",,REP,Bert Richardson,13,112,74,199
Waller,312,"Judge, Court of Criminal Appeals, Place 3",,REP,Ballots Cast,17,192,138,347
Waller,312,"Judge, Court of Criminal Appeals, Place 3",,REP,Under Votes,7,35,21,63
Waller,312,"Judge, Court of Criminal Appeals, Place 3",,REP,Over Votes,0,0,0,0
Waller,312,"Judge, Court of Criminal Appeals, Place 4",,REP,Kevin Patrick Yeary,15,193,139,347
Waller,312,"Judge, Court of Criminal Appeals, Place 4",,REP,Ballots Cast,15,193,139,347
Waller,312,"Judge, Court of Criminal Appeals, Place 4",,REP,Under Votes,9,34,20,63
Waller,312,"Judge, Court of Criminal Appeals, Place 4",,REP,Over Votes,0,0,0,0
Waller,312,"Judge, Court of Criminal Appeals, Place 9",,REP,David Newell,15,194,139,348
Waller,312,"Judge, Court of Criminal Appeals, Place 9",,REP,Ballots Cast,15,194,139,348
Waller,312,"Judge, Court of Criminal Appeals, Place 9",,REP,Under Votes,9,33,20,62
Waller,312,"Judge, Court of Criminal Appeals, Place 9",,REP,Over Votes,0,0,0,0
Waller,312,"Member, State Board of Education, District 10",,REP,Tom Maynard,17,195,139,351
Waller,312,"Member, State Board of Education, District 10",,REP,Ballots Cast,17,195,139,351
Waller,312,"Member, State Board of Education, District 10",,REP,Under Votes,7,32,20,59
Waller,312,"Member, State Board of Education, District 10",,REP,Over Votes,0,0,0,0
Waller,312,State Senate,18,REP,Lois W. Kolkhorst,21,204,142,367
Waller,312,State Senate,18,REP,Ballots Cast,21,204,142,367
Waller,312,State Senate,18,REP,Under Votes,3,23,17,43
Waller,312,State Senate,18,REP,Over Votes,0,0,0,0
Waller,312,State Representative,3,REP,Cecil Bell Jr,18,202,141,361
Waller,312,State Representative,3,REP,Ballots Cast,18,202,141,361
Waller,312,State Representative,3,REP,Under Votes,6,25,18,49
Waller,312,State Representative,3,REP,Over Votes,0,0,0,0
Waller,312,"Chief Justice, 14th Court of Appeals District",,REP,Tracy Elizabeth Christopher,17,197,137,351
Waller,312,"Chief Justice, 14th Court of Appeals District",,REP,Ballots Cast,17,197,137,351
Waller,312,"Chief Justice, 14th Court of Appeals District",,REP,Under Votes,7,30,22,59
Waller,312,"Chief Justice, 14th Court of Appeals District",,REP,Over Votes,0,0,0,0
Waller,312,"Justice, 1st Court of Appeals District, Place 3",,REP,Russell Lloyd,16,195,137,348
Waller,312,"Justice, 1st Court of Appeals District, Place 3",,REP,Ballots Cast,16,195,137,348
Waller,312,"Justice, 1st Court of Appeals District, Place 3",,REP,Under Votes,8,32,22,62
Waller,312,"Justice, 1st Court of Appeals District, Place 3",,REP,Over Votes,0,0,0,0
Waller,312,"Justice, 1st Court of Appeals District, Place 5",,REP,Chad Bridges,3,70,45,118
Waller,312,"Justice, 1st Court of Appeals District, Place 5",,REP,James Lombardino,0,18,9,27
Waller,312,"Justice, 1st Court of Appeals District, Place 5",,REP,Levi J. Benton,4,17,23,44
Waller,312,"Justice, 1st Court of Appeals District, Place 5",,REP,Terry Adams,8,70,43,121
Waller,312,"Justice, 1st Court of Appeals District, Place 5",,REP,Ballots Cast,15,175,120,310
Waller,312,"Justice, 1st Court of Appeals District, Place 5",,REP,Under Votes,9,52,39,100
Waller,312,"Justice, 1st Court of Appeals District, Place 5",,REP,Over Votes,0,0,0,0
Waller,312,"Justice, 14th Court of Appeals District, Place 7",,REP,Ken Wise,16,192,136,344
Waller,312,"Justice, 14th Court of Appeals District, Place 7",,REP,Ballots Cast,16,192,136,344
Waller,312,"Justice, 14th Court of Appeals District, Place 7",,REP,Under Votes,8,35,23,66
Waller,312,"Justice, 14th Court of Appeals District, Place 7",,REP,Over Votes,0,0,0,0
Waller,312,"District Judge, 506th Judicial District",,REP,Gary W. Chaney,17,195,137,349
Waller,312,"District Judge, 506th Judicial District",,REP,Ballots Cast,17,195,137,349
Waller,312,"District Judge, 506th Judicial District",,REP,Under Votes,7,32,22,61
Waller,312,"District Judge, 506th Judicial District",,REP,Over Votes,0,0,0,0
Waller,312,Sheriff,,REP,Dan Porter,0,11,15,26
Waller,312,Sheriff,,REP,R. Glenn Smith,9,101,60,170
Waller,312,Sheriff,,REP,Troy Guidry,11,111,76,198
Waller,312,Sheriff,,REP,Ballots Cast,20,223,151,394
Waller,312,Sheriff,,REP,Under Votes,4,4,8,16
Waller,312,Sheriff,,REP,Over Votes,0,0,0,0
Waller,312,County Tax Assessor-Collector,,REP,Ellen Contreras Shelburne,14,127,80,221
Waller,312,County Tax Assessor-Collector,,REP,Carolyn Miedke,9,90,69,168
Waller,312,County Tax Assessor-Collector,,REP,Ballots Cast,23,217,149,389
Waller,312,County Tax Assessor-Collector,,REP,Under Votes,1,10,10,21
Waller,312,County Tax Assessor-Collector,,REP,Over Votes,0,0,0,0
Waller,312,"County Commissioner, Precinct 3",,REP,Jeron Barnett,14,195,139,348
Waller,312,"County Commissioner, Precinct 3",,REP,Ballots Cast,14,195,139,348
Waller,312,"County Commissioner, Precinct 3",,REP,Under Votes,10,32,20,62
Waller,312,"County Commissioner, Precinct 3",,REP,Over Votes,0,0,0,0
Waller,312,"Constable, Precinct 3",,REP,Marvin Hood,16,193,136,345
Waller,312,"Constable, Precinct 3",,REP,Ballots Cast,16,193,136,345
Waller,312,"Constable, Precinct 3",,REP,Under Votes,8,34,23,65
Waller,312,"Constable, Precinct 3",,REP,Over Votes,0,0,0,0
Waller,312,County Chairman,,REP,David W. Luther,15,189,135,339
Waller,312,County Chairman,,REP,Ballots Cast,15,189,135,339
Waller,312,County Chairman,,REP,Under Votes,9,38,24,71
Waller,312,County Chairman,,REP,Over Votes,0,0,0,0
Waller,312,Proposition #1,,DEM,Yes,6,23,42,71
Waller,312,Proposition #1,,DEM,No,1,1,3,5
Waller,312,Proposition #1,,DEM,Ballots Cast,7,24,45,76
Waller,312,Proposition #1,,DEM,Under Votes,0,1,2,3
Waller,312,Proposition #1,,DEM,Over Votes,0,0,0,0
Waller,312,Proposition #2,,DEM,Yes,4,21,40,65
Waller,312,Proposition #2,,DEM,No,3,3,5,11
Waller,312,Proposition #2,,DEM,Ballots Cast,7,24,45,76
Waller,312,Proposition #2,,DEM,Under Votes,0,1,2,3
Waller,312,Proposition #2,,DEM,Over Votes,0,0,0,0
Waller,312,Proposition #3,,DEM,Yes,7,23,43,73
Waller,312,Proposition #3,,DEM,No,0,1,2,3
Waller,312,Proposition #3,,DEM,Ballots Cast,7,24,45,76
Waller,312,Proposition #3,,DEM,Under Votes,0,1,2,3
Waller,312,Proposition #3,,DEM,Over Votes,0,0,0,0
Waller,312,Proposition #4,,DEM,Yes,4,21,40,65
Waller,312,Proposition #4,,DEM,No,3,3,5,11
Waller,312,Proposition #4,,DEM,Ballots Cast,7,24,45,76
Waller,312,Proposition #4,,DEM,Under Votes,0,1,2,3
Waller,312,Proposition #4,,DEM,Over Votes,0,0,0,0
Waller,312,Proposition #5,,DEM,Yes,7,21,40,68
Waller,312,Proposition #5,,DEM,No,0,3,2,5
Waller,312,Proposition #5,,DEM,Ballots Cast,7,24,42,73
Waller,312,Proposition #5,,DEM,Under Votes,0,1,5,6
Waller,312,Proposition #5,,DEM,Over Votes,0,0,0,0
Waller,312,Proposition #6,,DEM,Yes,6,21,40,67
Waller,312,Proposition #6,,DEM,No,1,2,2,5
Waller,312,Proposition #6,,DEM,Ballots Cast,7,23,42,72
Waller,312,Proposition #6,,DEM,Under Votes,0,2,5,7
Waller,312,Proposition #6,,DEM,Over Votes,0,0,0,0
Waller,312,Proposition #7,,DEM,Yes,5,22,40,67
Waller,312,Proposition #7,,DEM,No,2,2,3,7
Waller,312,Proposition #7,,DEM,Ballots Cast,7,24,43,74
Waller,312,Proposition #7,,DEM,Under Votes,0,1,4,5
Waller,312,Proposition #7,,DEM,Over Votes,0,0,0,0
Waller,312,Proposition #8,,DEM,Yes,7,22,41,70
Waller,312,Proposition #8,,DEM,No,0,2,3,5
Waller,312,Proposition #8,,DEM,Ballots Cast,7,24,44,75
Waller,312,Proposition #8,,DEM,Under Votes,0,1,3,4
Waller,312,Proposition #8,,DEM,Over Votes,0,0,0,0
Waller,312,Proposition #9,,DEM,Yes,6,22,41,69
Waller,312,Proposition #9,,DEM,No,1,2,2,5
Waller,312,Proposition #9,,DEM,Ballots Cast,7,24,43,74
Waller,312,Proposition #9,,DEM,Under Votes,0,1,4,5
Waller,312,Proposition #9,,DEM,Over Votes,0,0,0,0
Waller,312,Proposition #10,,DEM,Yes,7,21,37,65
Waller,312,Proposition #10,,DEM,No,0,2,6,8
Waller,312,Proposition #10,,DEM,Ballots Cast,7,23,43,73
Waller,312,Proposition #10,,DEM,Under Votes,0,2,4,6
Waller,312,Proposition #10,,DEM,Over Votes,0,0,0,0
Waller,312,Proposition #11,,DEM,Yes,5,21,36,62
Waller,312,Proposition #11,,DEM,No,2,3,7,12
Waller,312,Proposition #11,,DEM,Ballots Cast,7,24,43,74
Waller,312,Proposition #11,,DEM,Under Votes,0,1,4,5
Waller,312,Proposition #11,,DEM,Over Votes,0,0,0,0
Waller,312,Proposition 1,,REP,Yes,22,199,136,357
Waller,312,Proposition 1,,REP,No,0,25,20,45
Waller,312,Proposition 1,,REP,Ballots Cast,22,224,156,402
Waller,312,Proposition 1,,REP,Under Votes,2,3,3,8
Waller,312,Proposition 1,,REP,Over Votes,0,0,0,0
Waller,312,Proposition 2,,REP,Yes,20,197,137,354
Waller,312,Proposition 2,,REP,No,2,27,18,47
Waller,312,Proposition 2,,REP,Ballots Cast,22,224,155,401
Waller,312,Proposition 2,,REP,Under Votes,1,3,4,8
Waller,312,Proposition 2,,REP,Over Votes,1,0,0,1
Waller,312,Proposition 3,,REP,Yes,21,210,144,375
Waller,312,Proposition 3,,REP,No,0,12,8,20
Waller,312,Proposition 3,,REP,Ballots Cast,21,222,152,395
Waller,312,Proposition 3,,REP,Under Votes,3,5,7,15
Waller,312,Proposition 3,,REP,Over Votes,0,0,0,0
Waller,312,Proposition 4,,REP,Yes,23,219,144,386
Waller,312,Proposition 4,,REP,No,0,4,5,9
Waller,312,Proposition 4,,REP,Ballots Cast,23,223,149,395
Waller,312,Proposition 4,,REP,Under Votes,1,4,10,15
Waller,312,Proposition 4,,REP,Over Votes,0,0,0,0
Waller,312,Proposition 5,,REP,Yes,18,200,138,356
Waller,312,Proposition 5,,REP,No,4,20,15,39
Waller,312,Proposition 5,,REP,Ballots Cast,22,220,153,395
Waller,312,Proposition 5,,REP,Under Votes,2,7,6,15
Waller,312,Proposition 5,,REP,Over Votes,0,0,0,0
Waller,312,Proposition 6,,REP,Yes,23,208,143,374
Waller,312,Proposition 6,,REP,No,0,7,6,13
Waller,312,Proposition 6,,REP,Ballots Cast,23,215,149,387
Waller,312,Proposition 6,,REP,Under Votes,1,12,10,23
Waller,312,Proposition 6,,REP,Over Votes,0,0,0,0
Waller,312,Proposition 7,,REP,Yes,22,220,151,393
Waller,312,Proposition 7,,REP,No,0,3,0,3
Waller,312,Proposition 7,,REP,Ballots Cast,22,223,151,396
Waller,312,Proposition 7,,REP,Under Votes,1,4,8,13
Waller,312,Proposition 7,,REP,Over Votes,1,0,0,1
Waller,312,Proposition 8,,REP,Yes,23,218,149,390
Waller,312,Proposition 8,,REP,No,0,2,2,4
Waller,312,Proposition 8,,REP,Ballots Cast,23,220,151,394
Waller,312,Proposition 8,,REP,Under Votes,1,7,8,16
Waller,312,Proposition 8,,REP,Over Votes,0,0,0,0
Waller,312,Proposition 9,,REP,Yes,23,210,146,379
Waller,312,Proposition 9,,REP,No,0,11,6,17
Waller,312,Proposition 9,,REP,Ballots Cast,23,221,152,396
Waller,312,Proposition 9,,REP,Under Votes,1,6,7,14
Waller,312,Proposition 9,,REP,Over Votes,0,0,0,0
Waller,312,Proposition 10,,REP,Yes,23,205,144,372
Waller,312,Proposition 10,,REP,No,0,15,9,24
Waller,312,Proposition 10,,REP,Ballots Cast,23,220,153,396
Waller,312,Proposition 10,,REP,Under Votes,1,7,6,14
Waller,312,Proposition 10,,REP,Over Votes,0,0,0,0
Waller,313,President,,DEM,Michael Bennet,0,0,0,0
Waller,313,President,,DEM,Marianne Williamson,0,0,0,0
Waller,313,President,,DEM,Cory Booker,0,0,0,0
Waller,313,President,,DEM,Bernie Sanders,2,0,9,11
Waller,313,President,,DEM,Tulsi Gabbard,0,0,0,0
Waller,313,President,,DEM,Deval Patrick,0,0,0,0
Waller,313,President,,DEM,Amy Klobuchar,0,1,0,1
Waller,313,President,,DEM,Julián Castro,0,0,0,0
Waller,313,President,,DEM,Elizabeth Warren,0,0,4,4
Waller,313,President,,DEM,John K. Delaney,0,0,0,0
Waller,313,President,,DEM,Robby Wells,0,0,0,0
Waller,313,President,,DEM,"Roque ""Rocky"" De La Fuente",0,0,0,0
Waller,313,President,,DEM,Andrew Yang,0,0,0,0
Waller,313,President,,DEM,Joseph R. Biden,0,3,4,7
Waller,313,President,,DEM,Michael R. Bloomberg,2,1,0,3
Waller,313,President,,DEM,Tom Steyer,0,0,0,0
Waller,313,President,,DEM,Pete Buttigieg,0,0,0,0
Waller,313,President,,DEM,Ballots Cast,4,5,17,26
Waller,313,President,,DEM,Under Votes,0,0,0,0
Waller,313,President,,DEM,Over Votes,0,0,0,0
Waller,313,U.S. Senate,,DEM,Royce West,0,0,3,3
Waller,313,U.S. Senate,,DEM,"Annie ""Mamá"" Garcia",1,0,1,2
Waller,313,U.S. Senate,,DEM,D. R. Hunter,0,0,0,0
Waller,313,U.S. Senate,,DEM,Sema Hernandez,1,0,2,3
Waller,313,U.S. Senate,,DEM,Adrian Ocegueda,0,0,0,0
Waller,313,U.S. Senate,,DEM,Chris Bell,2,4,3,9
Waller,313,U.S. Senate,,DEM,Cristina Tzintzun Ramirez,0,0,2,2
Waller,313,U.S. Senate,,DEM,Jack Daniel Foster Jr,0,0,3,3
Waller,313,U.S. Senate,,DEM,Amanda K. Edwards,0,0,0,0
Waller,313,U.S. Senate,,DEM,Victor Hugo Harris,0,0,0,0
Waller,313,U.S. Senate,,DEM,"Mary ""MJ"" Hegar",0,1,1,2
Waller,313,U.S. Senate,,DEM,Michael Cooper,0,0,0,0
Waller,313,U.S. Senate,,DEM,Ballots Cast,4,5,15,24
Waller,313,U.S. Senate,,DEM,Under Votes,0,0,2,2
Waller,313,U.S. Senate,,DEM,Over Votes,0,0,0,0
Waller,313,U.S. House,10,DEM,Mike Siegel,3,0,6,9
Waller,313,U.S. House,10,DEM,Shannon Hutcheson,1,3,8,12
Waller,313,U.S. House,10,DEM,Pritesh Gandhi,0,2,1,3
Waller,313,U.S. House,10,DEM,Ballots Cast,4,5,15,24
Waller,313,U.S. House,10,DEM,Under Votes,0,0,2,2
Waller,313,U.S. House,10,DEM,Over Votes,0,0,0,0
Waller,313,Railroad Commissioner,,DEM,"Roberto R. ""Beto"" Alonzo",1,2,7,10
Waller,313,Railroad Commissioner,,DEM,Chrysta Castañeda,0,0,3,3
Waller,313,Railroad Commissioner,,DEM,Mark Watson,3,0,0,3
Waller,313,Railroad Commissioner,,DEM,Kelly Stone,0,2,4,6
Waller,313,Railroad Commissioner,,DEM,Ballots Cast,4,4,14,22
Waller,313,Railroad Commissioner,,DEM,Under Votes,0,1,3,4
Waller,313,Railroad Commissioner,,DEM,Over Votes,0,0,0,0
Waller,313,"Chief Justice, Supreme Court",,DEM,Jerry Zimmerer,0,0,5,5
Waller,313,"Chief Justice, Supreme Court",,DEM,Amy Clark Meachum,4,4,9,17
Waller,313,"Chief Justice, Supreme Court",,DEM,Ballots Cast,4,4,14,22
Waller,313,"Chief Justice, Supreme Court",,DEM,Under Votes,0,1,3,4
Waller,313,"Chief Justice, Supreme Court",,DEM,Over Votes,0,0,0,0
Waller,313,"Justice, Supreme Court, Place 6 Unexpired Term",,DEM,Kathy Cheng,4,4,11,19
Waller,313,"Justice, Supreme Court, Place 6 Unexpired Term",,DEM,Larry Praeger,0,0,3,3
Waller,313,"Justice, Supreme Court, Place 6 Unexpired Term",,DEM,Ballots Cast,4,4,14,22
Waller,313,"Justice, Supreme Court, Place 6 Unexpired Term",,DEM,Under Votes,0,1,3,4
Waller,313,"Justice, Supreme Court, Place 6 Unexpired Term",,DEM,Over Votes,0,0,0,0
Waller,313,"Justice, Supreme Court, Place 7",,DEM,Staci Williams,2,4,10,16
Waller,313,"Justice, Supreme Court, Place 7",,DEM,Brandy Voss,2,0,4,6
Waller,313,"Justice, Supreme Court, Place 7",,DEM,Ballots Cast,4,4,14,22
Waller,313,"Justice, Supreme Court, Place 7",,DEM,Under Votes,0,1,3,4
Waller,313,"Justice, Supreme Court, Place 7",,DEM,Over Votes,0,0,0,0
Waller,313,"Justice, Supreme Court, Place 8",,DEM,Gisela D. Triana,2,3,8,13
Waller,313,"Justice, Supreme Court, Place 8",,DEM,Peter Kelly,2,1,6,9
Waller,313,"Justice, Supreme Court, Place 8",,DEM,Ballots Cast,4,4,14,22
Waller,313,"Justice, Supreme Court, Place 8",,DEM,Under Votes,0,1,3,4
Waller,313,"Justice, Supreme Court, Place 8",,DEM,Over Votes,0,0,0,0
Waller,313,"Judge, Court of Criminal Appeals, Place 3",,DEM,Elizabeth Davis Frizell,3,3,9,15
Waller,313,"Judge, Court of Criminal Appeals, Place 3",,DEM,William Pieratt Demond,0,0,1,1
Waller,313,"Judge, Court of Criminal Appeals, Place 3",,DEM,Dan Wood,1,1,4,6
Waller,313,"Judge, Court of Criminal Appeals, Place 3",,DEM,Ballots Cast,4,4,14,22
Waller,313,"Judge, Court of Criminal Appeals, Place 3",,DEM,Under Votes,0,1,3,4
Waller,313,"Judge, Court of Criminal Appeals, Place 3",,DEM,Over Votes,0,0,0,0
Waller,313,"Judge, Court of Criminal Appeals, Place 4",,DEM,Steven Miears,1,1,6,8
Waller,313,"Judge, Court of Criminal Appeals, Place 4",,DEM,Tina Clinton,3,3,8,14
Waller,313,"Judge, Court of Criminal Appeals, Place 4",,DEM,Ballots Cast,4,4,14,22
Waller,313,"Judge, Court of Criminal Appeals, Place 4",,DEM,Under Votes,0,1,3,4
Waller,313,"Judge, Court of Criminal Appeals, Place 4",,DEM,Over Votes,0,0,0,0
Waller,313,"Judge, Court of Criminal Appeals, Place 9",,DEM,Brandon Birmingham,3,4,13,20
Waller,313,"Judge, Court of Criminal Appeals, Place 9",,DEM,Ballots Cast,3,4,13,20
Waller,313,"Judge, Court of Criminal Appeals, Place 9",,DEM,Under Votes,1,1,4,6
Waller,313,"Judge, Court of Criminal Appeals, Place 9",,DEM,Over Votes,0,0,0,0
Waller,313,"Member, State Board of Education, District 10",,DEM,Stephen Wyman,0,1,3,4
Waller,313,"Member, State Board of Education, District 10",,DEM,Marsha Burnett-Webster,3,3,11,17
Waller,313,"Member, State Board of Education, District 10",,DEM,Ballots Cast,3,4,14,21
Waller,313,"Member, State Board of Education, District 10",,DEM,Under Votes,1,1,3,5
Waller,313,"Member, State Board of Education, District 10",,DEM,Over Votes,0,0,0,0
Waller,313,State Senate,18,DEM,Michael Antalan,2,4,13,19
Waller,313,State Senate,18,DEM,Ballots Cast,2,4,13,19
Waller,313,State Senate,18,DEM,Under Votes,2,1,4,7
Waller,313,State Senate,18,DEM,Over Votes,0,0,0,0
Waller,313,State Representative,3,DEM,Martin Shupp,2,4,14,20
Waller,313,State Representative,3,DEM,Ballots Cast,2,4,14,20
Waller,313,State Representative,3,DEM,Under Votes,2,1,3,6
Waller,313,State Representative,3,DEM,Over Votes,0,0,0,0
Waller,313,"Chief Justice, 14th Court of Appeals District",,DEM,Jane Robinson,4,4,8,16
Waller,313,"Chief Justice, 14th Court of Appeals District",,DEM,Jim Evans,0,0,6,6
Waller,313,"Chief Justice, 14th Court of Appeals District",,DEM,Ballots Cast,4,4,14,22
Waller,313,"Chief Justice, 14th Court of Appeals District",,DEM,Under Votes,0,1,3,4
Waller,313,"Chief Justice, 14th Court of Appeals District",,DEM,Over Votes,0,0,0,0
Waller,313,"Justice, 1st Court of Appeals District, Place 3",,DEM,Jim Sharp,2,0,2,4
Waller,313,"Justice, 1st Court of Appeals District, Place 3",,DEM,Dinesh Singhal,0,2,5,7
Waller,313,"Justice, 1st Court of Appeals District, Place 3",,DEM,Veronica Rivas-Molloy,2,2,7,11
Waller,313,"Justice, 1st Court of Appeals District, Place 3",,DEM,Ballots Cast,4,4,14,22
Waller,313,"Justice, 1st Court of Appeals District, Place 3",,DEM,Under Votes,0,1,3,4
Waller,313,"Justice, 1st Court of Appeals District, Place 3",,DEM,Over Votes,0,0,0,0
Waller,313,"Justice, 1st Court of Appeals District, Place 5",,DEM,Tim Hootman,3,0,4,7
Waller,313,"Justice, 1st Court of Appeals District, Place 5",,DEM,Amparo Monique Guerra,1,4,10,15
Waller,313,"Justice, 1st Court of Appeals District, Place 5",,DEM,Ballots Cast,4,4,14,22
Waller,313,"Justice, 1st Court of Appeals District, Place 5",,DEM,Under Votes,0,1,3,4
Waller,313,"Justice, 1st Court of Appeals District, Place 5",,DEM,Over Votes,0,0,0,0
Waller,313,"Justice, 14th Court of Appeals District, Place 7",,DEM,"Tamika ""Tami"" Craft",1,2,2,5
Waller,313,"Justice, 14th Court of Appeals District, Place 7",,DEM,Wally Kronzer,0,0,0,0
Waller,313,"Justice, 14th Court of Appeals District, Place 7",,DEM,V.R. Faulkner,0,0,1,1
Waller,313,"Justice, 14th Court of Appeals District, Place 7",,DEM,Cheri Thomas,0,2,8,10
Waller,313,"Justice, 14th Court of Appeals District, Place 7",,DEM,Dominic J. Merino,2,0,2,4
Waller,313,"Justice, 14th Court of Appeals District, Place 7",,DEM,Lennon C. Wright,1,0,1,2
Waller,313,"Justice, 14th Court of Appeals District, Place 7",,DEM,Ballots Cast,4,4,14,22
Waller,313,"Justice, 14th Court of Appeals District, Place 7",,DEM,Under Votes,0,1,3,4
Waller,313,"Justice, 14th Court of Appeals District, Place 7",,DEM,Over Votes,0,0,0,0
Waller,313,Sheriff,,DEM,Cedric D. Watson,2,4,14,20
Waller,313,Sheriff,,DEM,Ballots Cast,2,4,14,20
Waller,313,Sheriff,,DEM,Under Votes,2,1,3,6
Waller,313,Sheriff,,DEM,Over Votes,0,0,0,0
Waller,313,"County Commissioner, Precinct 3",,DEM,Christian Charleston,1,0,6,7
Waller,313,"County Commissioner, Precinct 3",,DEM,Darryl S. Johnson,2,3,2,7
Waller,313,"County Commissioner, Precinct 3",,DEM,Kendric D. Jones,0,1,5,6
Waller,313,"County Commissioner, Precinct 3",,DEM,Ballots Cast,3,4,13,20
Waller,313,"County Commissioner, Precinct 3",,DEM,Under Votes,1,1,4,6
Waller,313,"County Commissioner, Precinct 3",,DEM,Over Votes,0,0,0,0
Waller,313,"Constable, Precinct 3",,DEM,Herschel Smith,1,5,7,13
Waller,313,"Constable, Precinct 3",,DEM,Scott H. Green,2,0,7,9
Waller,313,"Constable, Precinct 3",,DEM,Ballots Cast,3,5,14,22
Waller,313,"Constable, Precinct 3",,DEM,Under Votes,1,0,3,4
Waller,313,"Constable, Precinct 3",,DEM,Over Votes,0,0,0,0
Waller,313,County Chairman,,DEM,Rosa Patlan Harris,2,4,14,20
Waller,313,County Chairman,,DEM,Ballots Cast,2,4,14,20
Waller,313,County Chairman,,DEM,Under Votes,2,1,3,6
Waller,313,County Chairman,,DEM,Over Votes,0,0,0,0
Waller,313,President,,REP,Donald J. Trump,2,28,48,78
Waller,313,President,,REP,Joe Walsh,0,0,0,0
Waller,313,President,,REP,Bob Ely,0,0,0,0
Waller,313,President,,REP,"Roque ""Rocky"" De La Fuente Guerra",0,0,0,0
Waller,313,President,,REP,Zoltan G. Istvan,0,0,0,0
Waller,313,President,,REP,Matthew John Matern,0,0,0,0
Waller,313,President,,REP,Bill Weld,0,0,0,0
Waller,313,President,,REP,Uncommitted,0,1,0,1
Waller,313,President,,REP,Ballots Cast,2,29,48,79
Waller,313,President,,REP,Under Votes,0,0,0,0
Waller,313,President,,REP,Over Votes,0,0,0,0
Waller,313,U.S. Senate,,REP,Dwayne Stovall,1,5,13,19
Waller,313,U.S. Senate,,REP,Mark Yancey,0,0,4,4
Waller,313,U.S. Senate,,REP,Virgil Bierschwale,0,0,0,0
Waller,313,U.S. Senate,,REP,John Anthony Castro,0,1,1,2
Waller,313,U.S. Senate,,REP,John Cornyn,1,20,27,48
Waller,313,U.S. Senate,,REP,Ballots Cast,2,26,45,73
Waller,313,U.S. Senate,,REP,Under Votes,0,3,3,6
Waller,313,U.S. Senate,,REP,Over Votes,0,0,0,0
Waller,313,U.S. House,10,REP,Michael McCaul,2,26,42,70
Waller,313,U.S. House,10,REP,Ballots Cast,2,26,42,70
Waller,313,U.S. House,10,REP,Under Votes,0,3,6,9
Waller,313,U.S. House,10,REP,Over Votes,0,0,0,0
Waller,313,Railroad Commissioner,,REP,Ryan Sitton,2,13,23,38
Waller,313,Railroad Commissioner,,REP,"James ""Jim"" Wright",0,13,17,30
Waller,313,Railroad Commissioner,,REP,Ballots Cast,2,26,40,68
Waller,313,Railroad Commissioner,,REP,Under Votes,0,3,8,11
Waller,313,Railroad Commissioner,,REP,Over Votes,0,0,0,0
Waller,313,"Chief Justice, Supreme Court",,REP,Nathan Hecht,2,26,39,67
Waller,313,"Chief Justice, Supreme Court",,REP,Ballots Cast,2,26,39,67
Waller,313,"Chief Justice, Supreme Court",,REP,Under Votes,0,3,9,12
Waller,313,"Chief Justice, Supreme Court",,REP,Over Votes,0,0,0,0
Waller,313,"Justice, Supreme Court, Place 6 Unexpired Term",,REP,Jane Bland,2,25,39,66
Waller,313,"Justice, Supreme Court, Place 6 Unexpired Term",,REP,Ballots Cast,2,25,39,66
Waller,313,"Justice, Supreme Court, Place 6 Unexpired Term",,REP,Under Votes,0,4,9,13
Waller,313,"Justice, Supreme Court, Place 6 Unexpired Term",,REP,Over Votes,0,0,0,0
Waller,313,"Justice, Supreme Court, Place 7",,REP,Jeff Boyd,2,24,39,65
Waller,313,"Justice, Supreme Court, Place 7",,REP,Ballots Cast,2,24,39,65
Waller,313,"Justice, Supreme Court, Place 7",,REP,Under Votes,0,5,9,14
Waller,313,"Justice, Supreme Court, Place 7",,REP,Over Votes,0,0,0,0
Waller,313,"Justice, Supreme Court, Place 8",,REP,Brett Busby,2,24,39,65
Waller,313,"Justice, Supreme Court, Place 8",,REP,Ballots Cast,2,24,39,65
Waller,313,"Justice, Supreme Court, Place 8",,REP,Under Votes,0,5,9,14
Waller,313,"Justice, Supreme Court, Place 8",,REP,Over Votes,0,0,0,0
Waller,313,"Judge, Court of Criminal Appeals, Place 3",,REP,Gina Parker,0,13,17,30
Waller,313,"Judge, Court of Criminal Appeals, Place 3",,REP,Bert Richardson,2,12,21,35
Waller,313,"Judge, Court of Criminal Appeals, Place 3",,REP,Ballots Cast,2,25,38,65
Waller,313,"Judge, Court of Criminal Appeals, Place 3",,REP,Under Votes,0,4,10,14
Waller,313,"Judge, Court of Criminal Appeals, Place 3",,REP,Over Votes,0,0,0,0
Waller,313,"Judge, Court of Criminal Appeals, Place 4",,REP,Kevin Patrick Yeary,2,23,39,64
Waller,313,"Judge, Court of Criminal Appeals, Place 4",,REP,Ballots Cast,2,23,39,64
Waller,313,"Judge, Court of Criminal Appeals, Place 4",,REP,Under Votes,0,6,9,15
Waller,313,"Judge, Court of Criminal Appeals, Place 4",,REP,Over Votes,0,0,0,0
Waller,313,"Judge, Court of Criminal Appeals, Place 9",,REP,David Newell,2,23,39,64
Waller,313,"Judge, Court of Criminal Appeals, Place 9",,REP,Ballots Cast,2,23,39,64
Waller,313,"Judge, Court of Criminal Appeals, Place 9",,REP,Under Votes,0,6,9,15
Waller,313,"Judge, Court of Criminal Appeals, Place 9",,REP,Over Votes,0,0,0,0
Waller,313,"Member, State Board of Education, District 10",,REP,Tom Maynard,2,23,39,64
Waller,313,"Member, State Board of Education, District 10",,REP,Ballots Cast,2,23,39,64
Waller,313,"Member, State Board of Education, District 10",,REP,Under Votes,0,6,9,15
Waller,313,"Member, State Board of Education, District 10",,REP,Over Votes,0,0,0,0
Waller,313,State Senate,18,REP,Lois W. Kolkhorst,2,25,40,67
Waller,313,State Senate,18,REP,Ballots Cast,2,25,40,67
Waller,313,State Senate,18,REP,Under Votes,0,4,8,12
Waller,313,State Senate,18,REP,Over Votes,0,0,0,0
Waller,313,State Representative,3,REP,Cecil Bell Jr,2,25,41,68
Waller,313,State Representative,3,REP,Ballots Cast,2,25,41,68
Waller,313,State Representative,3,REP,Under Votes,0,4,7,11
Waller,313,State Representative,3,REP,Over Votes,0,0,0,0
Waller,313,"Chief Justice, 14th Court of Appeals District",,REP,Tracy Elizabeth Christopher,2,25,39,66
Waller,313,"Chief Justice, 14th Court of Appeals District",,REP,Ballots Cast,2,25,39,66
Waller,313,"Chief Justice, 14th Court of Appeals District",,REP,Under Votes,0,4,9,13
Waller,313,"Chief Justice, 14th Court of Appeals District",,REP,Over Votes,0,0,0,0
Waller,313,"Justice, 1st Court of Appeals District, Place 3",,REP,Russell Lloyd,2,24,39,65
Waller,313,"Justice, 1st Court of Appeals District, Place 3",,REP,Ballots Cast,2,24,39,65
Waller,313,"Justice, 1st Court of Appeals District, Place 3",,REP,Under Votes,0,5,9,14
Waller,313,"Justice, 1st Court of Appeals District, Place 3",,REP,Over Votes,0,0,0,0
Waller,313,"Justice, 1st Court of Appeals District, Place 5",,REP,Chad Bridges,2,11,8,21
Waller,313,"Justice, 1st Court of Appeals District, Place 5",,REP,James Lombardino,0,2,1,3
Waller,313,"Justice, 1st Court of Appeals District, Place 5",,REP,Levi J. Benton,0,3,5,8
Waller,313,"Justice, 1st Court of Appeals District, Place 5",,REP,Terry Adams,0,6,18,24
Waller,313,"Justice, 1st Court of Appeals District, Place 5",,REP,Ballots Cast,2,22,32,56
Waller,313,"Justice, 1st Court of Appeals District, Place 5",,REP,Under Votes,0,7,16,23
Waller,313,"Justice, 1st Court of Appeals District, Place 5",,REP,Over Votes,0,0,0,0
Waller,313,"Justice, 14th Court of Appeals District, Place 7",,REP,Ken Wise,2,23,36,61
Waller,313,"Justice, 14th Court of Appeals District, Place 7",,REP,Ballots Cast,2,23,36,61
Waller,313,"Justice, 14th Court of Appeals District, Place 7",,REP,Under Votes,0,6,12,18
Waller,313,"Justice, 14th Court of Appeals District, Place 7",,REP,Over Votes,0,0,0,0
Waller,313,"District Judge, 506th Judicial District",,REP,Gary W. Chaney,2,23,38,63
Waller,313,"District Judge, 506th Judicial District",,REP,Ballots Cast,2,23,38,63
Waller,313,"District Judge, 506th Judicial District",,REP,Under Votes,0,6,10,16
Waller,313,"District Judge, 506th Judicial District",,REP,Over Votes,0,0,0,0
Waller,313,Sheriff,,REP,Dan Porter,1,7,16,24
Waller,313,Sheriff,,REP,R. Glenn Smith,0,12,18,30
Waller,313,Sheriff,,REP,Troy Guidry,1,9,10,20
Waller,313,Sheriff,,REP,Ballots Cast,2,28,44,74
Waller,313,Sheriff,,REP,Under Votes,0,1,4,5
Waller,313,Sheriff,,REP,Over Votes,0,0,0,0
Waller,313,County Tax Assessor-Collector,,REP,Ellen Contreras Shelburne,2,19,18,39
Waller,313,County Tax Assessor-Collector,,REP,Carolyn Miedke,0,7,23,30
Waller,313,County Tax Assessor-Collector,,REP,Ballots Cast,2,26,41,69
Waller,313,County Tax Assessor-Collector,,REP,Under Votes,0,3,7,10
Waller,313,County Tax Assessor-Collector,,REP,Over Votes,0,0,0,0
Waller,313,"County Commissioner, Precinct 3",,REP,Jeron Barnett,1,26,38,65
Waller,313,"County Commissioner, Precinct 3",,REP,Ballots Cast,1,26,38,65
Waller,313,"County Commissioner, Precinct 3",,REP,Under Votes,1,3,10,14
Waller,313,"County Commissioner, Precinct 3",,REP,Over Votes,0,0,0,0
Waller,313,"Constable, Precinct 3",,REP,Marvin Hood,2,27,36,65
Waller,313,"Constable, Precinct 3",,REP,Ballots Cast,2,27,36,65
Waller,313,"Constable, Precinct 3",,REP,Under Votes,0,2,12,14
Waller,313,"Constable, Precinct 3",,REP,Over Votes,0,0,0,0
Waller,313,County Chairman,,REP,David W. Luther,2,24,37,63
Waller,313,County Chairman,,REP,Ballots Cast,2,24,37,63
Waller,313,County Chairman,,REP,Under Votes,0,5,11,16
Waller,313,County Chairman,,REP,Over Votes,0,0,0,0
Waller,313,Proposition #1,,DEM,Yes,2,5,16,23
Waller,313,Proposition #1,,DEM,No,2,0,0,2
Waller,313,Proposition #1,,DEM,Ballots Cast,4,5,16,25
Waller,313,Proposition #1,,DEM,Under Votes,0,0,1,1
Waller,313,Proposition #1,,DEM,Over Votes,0,0,0,0
Waller,313,Proposition #2,,DEM,Yes,4,5,15,24
Waller,313,Proposition #2,,DEM,No,0,0,0,0
Waller,313,Proposition #2,,DEM,Ballots Cast,4,5,15,24
Waller,313,Proposition #2,,DEM,Under Votes,0,0,2,2
Waller,313,Proposition #2,,DEM,Over Votes,0,0,0,0
Waller,313,Proposition #3,,DEM,Yes,4,5,15,24
Waller,313,Proposition #3,,DEM,No,0,0,0,0
Waller,313,Proposition #3,,DEM,Ballots Cast,4,5,15,24
Waller,313,Proposition #3,,DEM,Under Votes,0,0,2,2
Waller,313,Proposition #3,,DEM,Over Votes,0,0,0,0
Waller,313,Proposition #4,,DEM,Yes,4,5,15,24
Waller,313,Proposition #4,,DEM,No,0,0,0,0
Waller,313,Proposition #4,,DEM,Ballots Cast,4,5,15,24
Waller,313,Proposition #4,,DEM,Under Votes,0,0,2,2
Waller,313,Proposition #4,,DEM,Over Votes,0,0,0,0
Waller,313,Proposition #5,,DEM,Yes,4,5,16,25
Waller,313,Proposition #5,,DEM,No,0,0,0,0
Waller,313,Proposition #5,,DEM,Ballots Cast,4,5,16,25
Waller,313,Proposition #5,,DEM,Under Votes,0,0,1,1
Waller,313,Proposition #5,,DEM,Over Votes,0,0,0,0
Waller,313,Proposition #6,,DEM,Yes,4,5,15,24
Waller,313,Proposition #6,,DEM,No,0,0,0,0
Waller,313,Proposition #6,,DEM,Ballots Cast,4,5,15,24
Waller,313,Proposition #6,,DEM,Under Votes,0,0,2,2
Waller,313,Proposition #6,,DEM,Over Votes,0,0,0,0
Waller,313,Proposition #7,,DEM,Yes,4,5,15,24
Waller,313,Proposition #7,,DEM,No,0,0,0,0
Waller,313,Proposition #7,,DEM,Ballots Cast,4,5,15,24
Waller,313,Proposition #7,,DEM,Under Votes,0,0,2,2
Waller,313,Proposition #7,,DEM,Over Votes,0,0,0,0
Waller,313,Proposition #8,,DEM,Yes,4,5,16,25
Waller,313,Proposition #8,,DEM,No,0,0,0,0
Waller,313,Proposition #8,,DEM,Ballots Cast,4,5,16,25
Waller,313,Proposition #8,,DEM,Under Votes,0,0,1,1
Waller,313,Proposition #8,,DEM,Over Votes,0,0,0,0
Waller,313,Proposition #9,,DEM,Yes,4,5,15,24
Waller,313,Proposition #9,,DEM,No,0,0,0,0
Waller,313,Proposition #9,,DEM,Ballots Cast,4,5,15,24
Waller,313,Proposition #9,,DEM,Under Votes,0,0,2,2
Waller,313,Proposition #9,,DEM,Over Votes,0,0,0,0
Waller,313,Proposition #10,,DEM,Yes,4,5,14,23
Waller,313,Proposition #10,,DEM,No,0,0,1,1
Waller,313,Proposition #10,,DEM,Ballots Cast,4,5,15,24
Waller,313,Proposition #10,,DEM,Under Votes,0,0,2,2
Waller,313,Proposition #10,,DEM,Over Votes,0,0,0,0
Waller,313,Proposition #11,,DEM,Yes,4,4,14,22
Waller,313,Proposition #11,,DEM,No,0,1,1,2
Waller,313,Proposition #11,,DEM,Ballots Cast,4,5,15,24
Waller,313,Proposition #11,,DEM,Under Votes,0,0,2,2
Waller,313,Proposition #11,,DEM,Over Votes,0,0,0,0
Waller,313,Proposition 1,,REP,Yes,1,27,47,75
Waller,313,Proposition 1,,REP,No,1,2,0,3
Waller,313,Proposition 1,,REP,Ballots Cast,2,29,47,78
Waller,313,Proposition 1,,REP,Under Votes,0,0,1,1
Waller,313,Proposition 1,,REP,Over Votes,0,0,0,0
Waller,313,Proposition 2,,REP,Yes,2,27,43,72
Waller,313,Proposition 2,,REP,No,0,2,4,6
Waller,313,Proposition 2,,REP,Ballots Cast,2,29,47,78
Waller,313,Proposition 2,,REP,Under Votes,0,0,1,1
Waller,313,Proposition 2,,REP,Over Votes,0,0,0,0
Waller,313,Proposition 3,,REP,Yes,2,29,46,77
Waller,313,Proposition 3,,REP,No,0,0,1,1
Waller,313,Proposition 3,,REP,Ballots Cast,2,29,47,78
Waller,313,Proposition 3,,REP,Under Votes,0,0,1,1
Waller,313,Proposition 3,,REP,Over Votes,0,0,0,0
Waller,313,Proposition 4,,REP,Yes,2,27,45,74
Waller,313,Proposition 4,,REP,No,0,2,0,2
Waller,313,Proposition 4,,REP,Ballots Cast,2,29,45,76
Waller,313,Proposition 4,,REP,Under Votes,0,0,3,3
Waller,313,Proposition 4,,REP,Over Votes,0,0,0,0
Waller,313,Proposition 5,,REP,Yes,2,25,43,70
Waller,313,Proposition 5,,REP,No,0,3,5,8
Waller,313,Proposition 5,,REP,Ballots Cast,2,28,48,78
Waller,313,Proposition 5,,REP,Under Votes,0,1,0,1
Waller,313,Proposition 5,,REP,Over Votes,0,0,0,0
Waller,313,Proposition 6,,REP,Yes,2,26,47,75
Waller,313,Proposition 6,,REP,No,0,3,0,3
Waller,313,Proposition 6,,REP,Ballots Cast,2,29,47,78
Waller,313,Proposition 6,,REP,Under Votes,0,0,1,1
Waller,313,Proposition 6,,REP,Over Votes,0,0,0,0
Waller,313,Proposition 7,,REP,Yes,2,29,47,78
Waller,313,Proposition 7,,REP,No,0,0,0,0
Waller,313,Proposition 7,,REP,Ballots Cast,2,29,47,78
Waller,313,Proposition 7,,REP,Under Votes,0,0,1,1
Waller,313,Proposition 7,,REP,Over Votes,0,0,0,0
Waller,313,Proposition 8,,REP,Yes,2,29,47,78
Waller,313,Proposition 8,,REP,No,0,0,0,0
Waller,313,Proposition 8,,REP,Ballots Cast,2,29,47,78
Waller,313,Proposition 8,,REP,Under Votes,0,0,1,1
Waller,313,Proposition 8,,REP,Over Votes,0,0,0,0
Waller,313,Proposition 9,,REP,Yes,2,26,47,75
Waller,313,Proposition 9,,REP,No,0,1,1,2
Waller,313,Proposition 9,,REP,Ballots Cast,2,27,48,77
Waller,313,Proposition 9,,REP,Under Votes,0,2,0,2
Waller,313,Proposition 9,,REP,Over Votes,0,0,0,0
Waller,313,Proposition 10,,REP,Yes,2,27,43,72
Waller,313,Proposition 10,,REP,No,0,1,3,4
Waller,313,Proposition 10,,REP,Ballots Cast,2,28,46,76
Waller,313,Proposition 10,,REP,Under Votes,0,1,2,3
Waller,313,Proposition 10,,REP,Over Votes,0,0,0,0
Waller,414,President,,DEM,Michael Bennet,0,0,2,2
Waller,414,President,,DEM,Marianne Williamson,0,0,0,0
Waller,414,President,,DEM,Cory Booker,0,0,0,0
Waller,414,President,,DEM,Bernie Sanders,0,5,7,12
Waller,414,President,,DEM,Tulsi Gabbard,0,0,0,0
Waller,414,President,,DEM,Deval Patrick,0,0,0,0
Waller,414,President,,DEM,Amy Klobuchar,0,0,1,1
Waller,414,President,,DEM,Julián Castro,0,0,0,0
Waller,414,President,,DEM,Elizabeth Warren,0,0,0,0
Waller,414,President,,DEM,John K. Delaney,0,0,0,0
Waller,414,President,,DEM,Robby Wells,0,0,0,0
Waller,414,President,,DEM,"Roque ""Rocky"" De La Fuente",0,0,0,0
Waller,414,President,,DEM,Andrew Yang,0,0,0,0
Waller,414,President,,DEM,Joseph R. Biden,2,4,28,34
Waller,414,President,,DEM,Michael R. Bloomberg,0,1,6,7
Waller,414,President,,DEM,Tom Steyer,0,1,0,1
Waller,414,President,,DEM,Pete Buttigieg,0,2,0,2
Waller,414,President,,DEM,Ballots Cast,2,13,44,59
Waller,414,President,,DEM,Under Votes,0,1,0,1
Waller,414,President,,DEM,Over Votes,0,0,0,0
Waller,414,U.S. Senate,,DEM,Royce West,0,1,6,7
Waller,414,U.S. Senate,,DEM,"Annie ""Mamá"" Garcia",0,2,6,8
Waller,414,U.S. Senate,,DEM,D. R. Hunter,0,0,0,0
Waller,414,U.S. Senate,,DEM,Sema Hernandez,0,1,0,1
Waller,414,U.S. Senate,,DEM,Adrian Ocegueda,0,0,2,2
Waller,414,U.S. Senate,,DEM,Chris Bell,0,3,15,18
Waller,414,U.S. Senate,,DEM,Cristina Tzintzun Ramirez,0,1,1,2
Waller,414,U.S. Senate,,DEM,Jack Daniel Foster Jr,0,0,4,4
Waller,414,U.S. Senate,,DEM,Amanda K. Edwards,0,1,1,2
Waller,414,U.S. Senate,,DEM,Victor Hugo Harris,0,0,1,1
Waller,414,U.S. Senate,,DEM,"Mary ""MJ"" Hegar",2,0,2,4
Waller,414,U.S. Senate,,DEM,Michael Cooper,0,1,1,2
Waller,414,U.S. Senate,,DEM,Ballots Cast,2,10,39,51
Waller,414,U.S. Senate,,DEM,Under Votes,0,4,5,9
Waller,414,U.S. Senate,,DEM,Over Votes,0,0,0,0
Waller,414,U.S. House,10,DEM,Mike Siegel,2,3,24,29
Waller,414,U.S. House,10,DEM,Shannon Hutcheson,0,6,10,16
Waller,414,U.S. House,10,DEM,Pritesh Gandhi,0,2,5,7
Waller,414,U.S. House,10,DEM,Ballots Cast,2,11,39,52
Waller,414,U.S. House,10,DEM,Under Votes,0,3,5,8
Waller,414,U.S. House,10,DEM,Over Votes,0,0,0,0
Waller,414,Railroad Commissioner,,DEM,"Roberto R. ""Beto"" Alonzo",0,3,14,17
Waller,414,Railroad Commissioner,,DEM,Chrysta Castañeda,1,4,3,8
Waller,414,Railroad Commissioner,,DEM,Mark Watson,0,1,18,19
Waller,414,Railroad Commissioner,,DEM,Kelly Stone,1,3,4,8
Waller,414,Railroad Commissioner,,DEM,Ballots Cast,2,11,39,52
Waller,414,Railroad Commissioner,,DEM,Under Votes,0,3,5,8
Waller,414,Railroad Commissioner,,DEM,Over Votes,0,0,0,0
Waller,414,"Chief Justice, Supreme Court",,DEM,Jerry Zimmerer,1,4,13,18
Waller,414,"Chief Justice, Supreme Court",,DEM,Amy Clark Meachum,1,7,24,32
Waller,414,"Chief Justice, Supreme Court",,DEM,Ballots Cast,2,11,37,50
Waller,414,"Chief Justice, Supreme Court",,DEM,Under Votes,0,3,7,10
Waller,414,"Chief Justice, Supreme Court",,DEM,Over Votes,0,0,0,0
Waller,414,"Justice, Supreme Court, Place 6 Unexpired Term",,DEM,Kathy Cheng,0,10,27,37
Waller,414,"Justice, Supreme Court, Place 6 Unexpired Term",,DEM,Larry Praeger,2,1,10,13
Waller,414,"Justice, Supreme Court, Place 6 Unexpired Term",,DEM,Ballots Cast,2,11,37,50
Waller,414,"Justice, Supreme Court, Place 6 Unexpired Term",,DEM,Under Votes,0,3,7,10
Waller,414,"Justice, Supreme Court, Place 6 Unexpired Term",,DEM,Over Votes,0,0,0,0
Waller,414,"Justice, Supreme Court, Place 7",,DEM,Staci Williams,2,6,30,38
Waller,414,"Justice, Supreme Court, Place 7",,DEM,Brandy Voss,0,5,6,11
Waller,414,"Justice, Supreme Court, Place 7",,DEM,Ballots Cast,2,11,36,49
Waller,414,"Justice, Supreme Court, Place 7",,DEM,Under Votes,0,3,8,11
Waller,414,"Justice, Supreme Court, Place 7",,DEM,Over Votes,0,0,0,0
Waller,414,"Justice, Supreme Court, Place 8",,DEM,Gisela D. Triana,1,7,21,29
Waller,414,"Justice, Supreme Court, Place 8",,DEM,Peter Kelly,1,4,15,20
Waller,414,"Justice, Supreme Court, Place 8",,DEM,Ballots Cast,2,11,36,49
Waller,414,"Justice, Supreme Court, Place 8",,DEM,Under Votes,0,3,8,11
Waller,414,"Justice, Supreme Court, Place 8",,DEM,Over Votes,0,0,0,0
Waller,414,"Judge, Court of Criminal Appeals, Place 3",,DEM,Elizabeth Davis Frizell,1,6,22,29
Waller,414,"Judge, Court of Criminal Appeals, Place 3",,DEM,William Pieratt Demond,0,2,5,7
Waller,414,"Judge, Court of Criminal Appeals, Place 3",,DEM,Dan Wood,1,3,8,12
Waller,414,"Judge, Court of Criminal Appeals, Place 3",,DEM,Ballots Cast,2,11,35,48
Waller,414,"Judge, Court of Criminal Appeals, Place 3",,DEM,Under Votes,0,3,9,12
Waller,414,"Judge, Court of Criminal Appeals, Place 3",,DEM,Over Votes,0,0,0,0
Waller,414,"Judge, Court of Criminal Appeals, Place 4",,DEM,Steven Miears,1,1,10,12
Waller,414,"Judge, Court of Criminal Appeals, Place 4",,DEM,Tina Clinton,1,10,27,38
Waller,414,"Judge, Court of Criminal Appeals, Place 4",,DEM,Ballots Cast,2,11,37,50
Waller,414,"Judge, Court of Criminal Appeals, Place 4",,DEM,Under Votes,0,3,7,10
Waller,414,"Judge, Court of Criminal Appeals, Place 4",,DEM,Over Votes,0,0,0,0
Waller,414,"Judge, Court of Criminal Appeals, Place 9",,DEM,Brandon Birmingham,2,11,34,47
Waller,414,"Judge, Court of Criminal Appeals, Place 9",,DEM,Ballots Cast,2,11,34,47
Waller,414,"Judge, Court of Criminal Appeals, Place 9",,DEM,Under Votes,0,3,10,13
Waller,414,"Judge, Court of Criminal Appeals, Place 9",,DEM,Over Votes,0,0,0,0
Waller,414,"Member, State Board of Education, District 10",,DEM,Stephen Wyman,1,1,6,8
Waller,414,"Member, State Board of Education, District 10",,DEM,Marsha Burnett-Webster,1,10,30,41
Waller,414,"Member, State Board of Education, District 10",,DEM,Ballots Cast,2,11,36,49
Waller,414,"Member, State Board of Education, District 10",,DEM,Under Votes,0,3,8,11
Waller,414,"Member, State Board of Education, District 10",,DEM,Over Votes,0,0,0,0
Waller,414,State Senate,18,DEM,Michael Antalan,2,11,34,47
Waller,414,State Senate,18,DEM,Ballots Cast,2,11,34,47
Waller,414,State Senate,18,DEM,Under Votes,0,3,10,13
Waller,414,State Senate,18,DEM,Over Votes,0,0,0,0
Waller,414,State Representative,3,DEM,Martin Shupp,2,11,33,46
Waller,414,State Representative,3,DEM,Ballots Cast,2,11,33,46
Waller,414,State Representative,3,DEM,Under Votes,0,3,11,14
Waller,414,State Representative,3,DEM,Over Votes,0,0,0,0
Waller,414,"Chief Justice, 14th Court of Appeals District",,DEM,Jane Robinson,2,11,31,44
Waller,414,"Chief Justice, 14th Court of Appeals District",,DEM,Jim Evans,0,1,7,8
Waller,414,"Chief Justice, 14th Court of Appeals District",,DEM,Ballots Cast,2,12,38,52
Waller,414,"Chief Justice, 14th Court of Appeals District",,DEM,Under Votes,0,2,6,8
Waller,414,"Chief Justice, 14th Court of Appeals District",,DEM,Over Votes,0,0,0,0
Waller,414,"Justice, 1st Court of Appeals District, Place 3",,DEM,Jim Sharp,1,4,11,16
Waller,414,"Justice, 1st Court of Appeals District, Place 3",,DEM,Dinesh Singhal,0,3,10,13
Waller,414,"Justice, 1st Court of Appeals District, Place 3",,DEM,Veronica Rivas-Molloy,1,4,16,21
Waller,414,"Justice, 1st Court of Appeals District, Place 3",,DEM,Ballots Cast,2,11,37,50
Waller,414,"Justice, 1st Court of Appeals District, Place 3",,DEM,Under Votes,0,3,7,10
Waller,414,"Justice, 1st Court of Appeals District, Place 3",,DEM,Over Votes,0,0,0,0
Waller,414,"Justice, 1st Court of Appeals District, Place 5",,DEM,Tim Hootman,0,1,20,21
Waller,414,"Justice, 1st Court of Appeals District, Place 5",,DEM,Amparo Monique Guerra,1,10,14,25
Waller,414,"Justice, 1st Court of Appeals District, Place 5",,DEM,Ballots Cast,1,11,34,46
Waller,414,"Justice, 1st Court of Appeals District, Place 5",,DEM,Under Votes,1,3,10,14
Waller,414,"Justice, 1st Court of Appeals District, Place 5",,DEM,Over Votes,0,0,0,0
Waller,414,"Justice, 14th Court of Appeals District, Place 7",,DEM,"Tamika ""Tami"" Craft",1,5,17,23
Waller,414,"Justice, 14th Court of Appeals District, Place 7",,DEM,Wally Kronzer,1,2,2,5
Waller,414,"Justice, 14th Court of Appeals District, Place 7",,DEM,V.R. Faulkner,0,0,2,2
Waller,414,"Justice, 14th Court of Appeals District, Place 7",,DEM,Cheri Thomas,0,4,8,12
Waller,414,"Justice, 14th Court of Appeals District, Place 7",,DEM,Dominic J. Merino,0,0,1,1
Waller,414,"Justice, 14th Court of Appeals District, Place 7",,DEM,Lennon C. Wright,0,1,5,6
Waller,414,"Justice, 14th Court of Appeals District, Place 7",,DEM,Ballots Cast,2,12,35,49
Waller,414,"Justice, 14th Court of Appeals District, Place 7",,DEM,Under Votes,0,2,9,11
Waller,414,"Justice, 14th Court of Appeals District, Place 7",,DEM,Over Votes,0,0,0,0
Waller,414,Sheriff,,DEM,Cedric D. Watson,2,11,37,50
Waller,414,Sheriff,,DEM,Ballots Cast,2,11,37,50
Waller,414,Sheriff,,DEM,Under Votes,0,3,7,10
Waller,414,Sheriff,,DEM,Over Votes,0,0,0,0
Waller,414,County Chairman,,DEM,Rosa Patlan Harris,2,11,37,50
Waller,414,County Chairman,,DEM,Ballots Cast,2,11,37,50
Waller,414,County Chairman,,DEM,Under Votes,0,3,7,10
Waller,414,County Chairman,,DEM,Over Votes,0,0,0,0
Waller,414,President,,REP,Donald J. Trump,3,20,20,43
Waller,414,President,,REP,Joe Walsh,0,1,0,1
Waller,414,President,,REP,Bob Ely,0,0,0,0
Waller,414,President,,REP,"Roque ""Rocky"" De La Fuente Guerra",0,0,0,0
Waller,414,President,,REP,Zoltan G. Istvan,0,0,0,0
Waller,414,President,,REP,Matthew John Matern,0,0,0,0
Waller,414,President,,REP,Bill Weld,0,0,0,0
Waller,414,President,,REP,Uncommitted,0,0,1,1
Waller,414,President,,REP,Ballots Cast,3,21,21,45
Waller,414,President,,REP,Under Votes,0,1,0,1
Waller,414,President,,REP,Over Votes,0,0,0,0
Waller,414,U.S. Senate,,REP,Dwayne Stovall,0,4,8,12
Waller,414,U.S. Senate,,REP,Mark Yancey,0,0,2,2
Waller,414,U.S. Senate,,REP,Virgil Bierschwale,0,0,0,0
Waller,414,U.S. Senate,,REP,John Anthony Castro,0,0,0,0
Waller,414,U.S. Senate,,REP,John Cornyn,3,17,9,29
Waller,414,U.S. Senate,,REP,Ballots Cast,3,21,19,43
Waller,414,U.S. Senate,,REP,Under Votes,0,1,2,3
Waller,414,U.S. Senate,,REP,Over Votes,0,0,0,0
Waller,414,U.S. House,10,REP,Michael McCaul,3,19,20,42
Waller,414,U.S. House,10,REP,Ballots Cast,3,19,20,42
Waller,414,U.S. House,10,REP,Under Votes,0,3,1,4
Waller,414,U.S. House,10,REP,Over Votes,0,0,0,0
Waller,414,Railroad Commissioner,,REP,Ryan Sitton,1,13,12,26
Waller,414,Railroad Commissioner,,REP,"James ""Jim"" Wright",2,8,8,18
Waller,414,Railroad Commissioner,,REP,Ballots Cast,3,21,20,44
Waller,414,Railroad Commissioner,,REP,Under Votes,0,1,1,2
Waller,414,Railroad Commissioner,,REP,Over Votes,0,0,0,0
Waller,414,"Chief Justice, Supreme Court",,REP,Nathan Hecht,3,19,19,41
Waller,414,"Chief Justice, Supreme Court",,REP,Ballots Cast,3,19,19,41
Waller,414,"Chief Justice, Supreme Court",,REP,Under Votes,0,3,2,5
Waller,414,"Chief Justice, Supreme Court",,REP,Over Votes,0,0,0,0
Waller,414,"Justice, Supreme Court, Place 6 Unexpired Term",,REP,Jane Bland,3,19,20,42
Waller,414,"Justice, Supreme Court, Place 6 Unexpired Term",,REP,Ballots Cast,3,19,20,42
Waller,414,"Justice, Supreme Court, Place 6 Unexpired Term",,REP,Under Votes,0,3,1,4
Waller,414,"Justice, Supreme Court, Place 6 Unexpired Term",,REP,Over Votes,0,0,0,0
Waller,414,"Justice, Supreme Court, Place 7",,REP,Jeff Boyd,3,19,20,42
Waller,414,"Justice, Supreme Court, Place 7",,REP,Ballots Cast,3,19,20,42
Waller,414,"Justice, Supreme Court, Place 7",,REP,Under Votes,0,3,1,4
Waller,414,"Justice, Supreme Court, Place 7",,REP,Over Votes,0,0,0,0
Waller,414,"Justice, Supreme Court, Place 8",,REP,Brett Busby,3,19,20,42
Waller,414,"Justice, Supreme Court, Place 8",,REP,Ballots Cast,3,19,20,42
Waller,414,"Justice, Supreme Court, Place 8",,REP,Under Votes,0,3,1,4
Waller,414,"Justice, Supreme Court, Place 8",,REP,Over Votes,0,0,0,0
Waller,414,"Judge, Court of Criminal Appeals, Place 3",,REP,Gina Parker,0,10,7,17
Waller,414,"Judge, Court of Criminal Appeals, Place 3",,REP,Bert Richardson,3,9,11,23
Waller,414,"Judge, Court of Criminal Appeals, Place 3",,REP,Ballots Cast,3,19,18,40
Waller,414,"Judge, Court of Criminal Appeals, Place 3",,REP,Under Votes,0,3,3,6
Waller,414,"Judge, Court of Criminal Appeals, Place 3",,REP,Over Votes,0,0,0,0
Waller,414,"Judge, Court of Criminal Appeals, Place 4",,REP,Kevin Patrick Yeary,3,19,19,41
Waller,414,"Judge, Court of Criminal Appeals, Place 4",,REP,Ballots Cast,3,19,19,41
Waller,414,"Judge, Court of Criminal Appeals, Place 4",,REP,Under Votes,0,3,2,5
Waller,414,"Judge, Court of Criminal Appeals, Place 4",,REP,Over Votes,0,0,0,0
Waller,414,"Judge, Court of Criminal Appeals, Place 9",,REP,David Newell,3,19,20,42
Waller,414,"Judge, Court of Criminal Appeals, Place 9",,REP,Ballots Cast,3,19,20,42
Waller,414,"Judge, Court of Criminal Appeals, Place 9",,REP,Under Votes,0,3,1,4
Waller,414,"Judge, Court of Criminal Appeals, Place 9",,REP,Over Votes,0,0,0,0
Waller,414,"Member, State Board of Education, District 10",,REP,Tom Maynard,3,19,20,42
Waller,414,"Member, State Board of Education, District 10",,REP,Ballots Cast,3,19,20,42
Waller,414,"Member, State Board of Education, District 10",,REP,Under Votes,0,3,1,4
Waller,414,"Member, State Board of Education, District 10",,REP,Over Votes,0,0,0,0
Waller,414,State Senate,18,REP,Lois W. Kolkhorst,3,18,20,41
Waller,414,State Senate,18,REP,Ballots Cast,3,18,20,41
Waller,414,State Senate,18,REP,Under Votes,0,4,1,5
Waller,414,State Senate,18,REP,Over Votes,0,0,0,0
Waller,414,State Representative,3,REP,Cecil Bell Jr,3,19,20,42
Waller,414,State Representative,3,REP,Ballots Cast,3,19,20,42
Waller,414,State Representative,3,REP,Under Votes,0,3,1,4
Waller,414,State Representative,3,REP,Over Votes,0,0,0,0
Waller,414,"Chief Justice, 14th Court of Appeals District",,REP,Tracy Elizabeth Christopher,3,19,19,41
Waller,414,"Chief Justice, 14th Court of Appeals District",,REP,Ballots Cast,3,19,19,41
Waller,414,"Chief Justice, 14th Court of Appeals District",,REP,Under Votes,0,3,2,5
Waller,414,"Chief Justice, 14th Court of Appeals District",,REP,Over Votes,0,0,0,0
Waller,414,"Justice, 1st Court of Appeals District, Place 3",,REP,Russell Lloyd,3,19,20,42
Waller,414,"Justice, 1st Court of Appeals District, Place 3",,REP,Ballots Cast,3,19,20,42
Waller,414,"Justice, 1st Court of Appeals District, Place 3",,REP,Under Votes,0,3,1,4
Waller,414,"Justice, 1st Court of Appeals District, Place 3",,REP,Over Votes,0,0,0,0
Waller,414,"Justice, 1st Court of Appeals District, Place 5",,REP,Chad Bridges,0,10,8,18
Waller,414,"Justice, 1st Court of Appeals District, Place 5",,REP,James Lombardino,0,1,2,3
Waller,414,"Justice, 1st Court of Appeals District, Place 5",,REP,Levi J. Benton,0,1,2,3
Waller,414,"Justice, 1st Court of Appeals District, Place 5",,REP,Terry Adams,3,6,4,13
Waller,414,"Justice, 1st Court of Appeals District, Place 5",,REP,Ballots Cast,3,18,16,37
Waller,414,"Justice, 1st Court of Appeals District, Place 5",,REP,Under Votes,0,4,5,9
Waller,414,"Justice, 1st Court of Appeals District, Place 5",,REP,Over Votes,0,0,0,0
Waller,414,"Justice, 14th Court of Appeals District, Place 7",,REP,Ken Wise,3,19,20,42
Waller,414,"Justice, 14th Court of Appeals District, Place 7",,REP,Ballots Cast,3,19,20,42
Waller,414,"Justice, 14th Court of Appeals District, Place 7",,REP,Under Votes,0,3,1,4
Waller,414,"Justice, 14th Court of Appeals District, Place 7",,REP,Over Votes,0,0,0,0
Waller,414,"District Judge, 506th Judicial District",,REP,Gary W. Chaney,3,19,20,42
Waller,414,"District Judge, 506th Judicial District",,REP,Ballots Cast,3,19,20,42
Waller,414,"District Judge, 506th Judicial District",,REP,Under Votes,0,3,1,4
Waller,414,"District Judge, 506th Judicial District",,REP,Over Votes,0,0,0,0
Waller,414,Sheriff,,REP,Dan Porter,0,1,2,3
Waller,414,Sheriff,,REP,R. Glenn Smith,1,14,8,23
Waller,414,Sheriff,,REP,Troy Guidry,2,7,10,19
Waller,414,Sheriff,,REP,Ballots Cast,3,22,20,45
Waller,414,Sheriff,,REP,Under Votes,0,0,1,1
Waller,414,Sheriff,,REP,Over Votes,0,0,0,0
Waller,414,County Tax Assessor-Collector,,REP,Ellen Contreras Shelburne,1,18,15,34
Waller,414,County Tax Assessor-Collector,,REP,Carolyn Miedke,2,4,4,10
Waller,414,County Tax Assessor-Collector,,REP,Ballots Cast,3,22,19,44
Waller,414,County Tax Assessor-Collector,,REP,Under Votes,0,0,2,2
Waller,414,County Tax Assessor-Collector,,REP,Over Votes,0,0,0,0
Waller,414,"Constable, Precinct 4",,REP,Joe Trimm Jr,3,20,17,40
Waller,414,"Constable, Precinct 4",,REP,Ballots Cast,3,20,17,40
Waller,414,"Constable, Precinct 4",,REP,Under Votes,0,2,4,6
Waller,414,"Constable, Precinct 4",,REP,Over Votes,0,0,0,0
Waller,414,County Chairman,,REP,David W. Luther,3,19,19,41
Waller,414,County Chairman,,REP,Ballots Cast,3,19,19,41
Waller,414,County Chairman,,REP,Under Votes,0,3,2,5
Waller,414,County Chairman,,REP,Over Votes,0,0,0,0
Waller,414,Proposition #1,,DEM,Yes,2,13,40,55
Waller,414,Proposition #1,,DEM,No,0,1,1,2
Waller,414,Proposition #1,,DEM,Ballots Cast,2,14,41,57
Waller,414,Proposition #1,,DEM,Under Votes,0,0,3,3
Waller,414,Proposition #1,,DEM,Over Votes,0,0,0,0
Waller,414,Proposition #2,,DEM,Yes,2,13,43,58
Waller,414,Proposition #2,,DEM,No,0,1,0,1
Waller,414,Proposition #2,,DEM,Ballots Cast,2,14,43,59
Waller,414,Proposition #2,,DEM,Under Votes,0,0,1,1
Waller,414,Proposition #2,,DEM,Over Votes,0,0,0,0
Waller,414,Proposition #3,,DEM,Yes,2,13,42,57
Waller,414,Proposition #3,,DEM,No,0,1,0,1
Waller,414,Proposition #3,,DEM,Ballots Cast,2,14,42,58
Waller,414,Proposition #3,,DEM,Under Votes,0,0,2,2
Waller,414,Proposition #3,,DEM,Over Votes,0,0,0,0
Waller,414,Proposition #4,,DEM,Yes,2,13,41,56
Waller,414,Proposition #4,,DEM,No,0,1,0,1
Waller,414,Proposition #4,,DEM,Ballots Cast,2,14,41,57
Waller,414,Proposition #4,,DEM,Under Votes,0,0,3,3
Waller,414,Proposition #4,,DEM,Over Votes,0,0,0,0
Waller,414,Proposition #5,,DEM,Yes,2,13,40,55
Waller,414,Proposition #5,,DEM,No,0,1,1,2
Waller,414,Proposition #5,,DEM,Ballots Cast,2,14,41,57
Waller,414,Proposition #5,,DEM,Under Votes,0,0,3,3
Waller,414,Proposition #5,,DEM,Over Votes,0,0,0,0
Waller,414,Proposition #6,,DEM,Yes,2,13,43,58
Waller,414,Proposition #6,,DEM,No,0,1,0,1
Waller,414,Proposition #6,,DEM,Ballots Cast,2,14,43,59
Waller,414,Proposition #6,,DEM,Under Votes,0,0,1,1
Waller,414,Proposition #6,,DEM,Over Votes,0,0,0,0
Waller,414,Proposition #7,,DEM,Yes,2,13,42,57
Waller,414,Proposition #7,,DEM,No,0,1,1,2
Waller,414,Proposition #7,,DEM,Ballots Cast,2,14,43,59
Waller,414,Proposition #7,,DEM,Under Votes,0,0,1,1
Waller,414,Proposition #7,,DEM,Over Votes,0,0,0,0
Waller,414,Proposition #8,,DEM,Yes,2,13,42,57
Waller,414,Proposition #8,,DEM,No,0,1,0,1
Waller,414,Proposition #8,,DEM,Ballots Cast,2,14,42,58
Waller,414,Proposition #8,,DEM,Under Votes,0,0,2,2
Waller,414,Proposition #8,,DEM,Over Votes,0,0,0,0
Waller,414,Proposition #9,,DEM,Yes,2,12,41,55
Waller,414,Proposition #9,,DEM,No,0,1,1,2
Waller,414,Proposition #9,,DEM,Ballots Cast,2,13,42,57
Waller,414,Proposition #9,,DEM,Under Votes,0,1,2,3
Waller,414,Proposition #9,,DEM,Over Votes,0,0,0,0
Waller,414,Proposition #10,,DEM,Yes,2,13,39,54
Waller,414,Proposition #10,,DEM,No,0,1,1,2
Waller,414,Proposition #10,,DEM,Ballots Cast,2,14,40,56
Waller,414,Proposition #10,,DEM,Under Votes,0,0,4,4
Waller,414,Proposition #10,,DEM,Over Votes,0,0,0,0
Waller,414,Proposition #11,,DEM,Yes,2,13,42,57
Waller,414,Proposition #11,,DEM,No,0,1,0,1
Waller,414,Proposition #11,,DEM,Ballots Cast,2,14,42,58
Waller,414,Proposition #11,,DEM,Under Votes,0,0,2,2
Waller,414,Proposition #11,,DEM,Over Votes,0,0,0,0
Waller,414,Proposition 1,,REP,Yes,1,17,13,31
Waller,414,Proposition 1,,REP,No,2,3,6,11
Waller,414,Proposition 1,,REP,Ballots Cast,3,20,19,42
Waller,414,Proposition 1,,REP,Under Votes,0,2,2,4
Waller,414,Proposition 1,,REP,Over Votes,0,0,0,0
Waller,414,Proposition 2,,REP,Yes,3,18,11,32
Waller,414,Proposition 2,,REP,No,0,2,7,9
Waller,414,Proposition 2,,REP,Ballots Cast,3,20,18,41
Waller,414,Proposition 2,,REP,Under Votes,0,2,3,5
Waller,414,Proposition 2,,REP,Over Votes,0,0,0,0
Waller,414,Proposition 3,,REP,Yes,3,18,17,38
Waller,414,Proposition 3,,REP,No,0,2,3,5
Waller,414,Proposition 3,,REP,Ballots Cast,3,20,20,43
Waller,414,Proposition 3,,REP,Under Votes,0,2,1,3
Waller,414,Proposition 3,,REP,Over Votes,0,0,0,0
Waller,414,Proposition 4,,REP,Yes,3,18,18,39
Waller,414,Proposition 4,,REP,No,0,2,1,3
Waller,414,Proposition 4,,REP,Ballots Cast,3,20,19,42
Waller,414,Proposition 4,,REP,Under Votes,0,2,2,4
Waller,414,Proposition 4,,REP,Over Votes,0,0,0,0
Waller,414,Proposition 5,,REP,Yes,3,20,18,41
Waller,414,Proposition 5,,REP,No,0,0,1,1
Waller,414,Proposition 5,,REP,Ballots Cast,3,20,19,42
Waller,414,Proposition 5,,REP,Under Votes,0,2,2,4
Waller,414,Proposition 5,,REP,Over Votes,0,0,0,0
Waller,414,Proposition 6,,REP,Yes,3,20,19,42
Waller,414,Proposition 6,,REP,No,0,0,0,0
Waller,414,Proposition 6,,REP,Ballots Cast,3,20,19,42
Waller,414,Proposition 6,,REP,Under Votes,0,2,2,4
Waller,414,Proposition 6,,REP,Over Votes,0,0,0,0
Waller,414,Proposition 7,,REP,Yes,3,20,20,43
Waller,414,Proposition 7,,REP,No,0,0,0,0
Waller,414,Proposition 7,,REP,Ballots Cast,3,20,20,43
Waller,414,Proposition 7,,REP,Under Votes,0,2,1,3
Waller,414,Proposition 7,,REP,Over Votes,0,0,0,0
Waller,414,Proposition 8,,REP,Yes,3,20,20,43
Waller,414,Proposition 8,,REP,No,0,0,0,0
Waller,414,Proposition 8,,REP,Ballots Cast,3,20,20,43
Waller,414,Proposition 8,,REP,Under Votes,0,2,1,3
Waller,414,Proposition 8,,REP,Over Votes,0,0,0,0
Waller,414,Proposition 9,,REP,Yes,3,20,19,42
Waller,414,Proposition 9,,REP,No,0,0,1,1
Waller,414,Proposition 9,,REP,Ballots Cast,3,20,20,43
Waller,414,Proposition 9,,REP,Under Votes,0,2,1,3
Waller,414,Proposition 9,,REP,Over Votes,0,0,0,0
Waller,414,Proposition 10,,REP,Yes,2,17,18,37
Waller,414,Proposition 10,,REP,No,1,3,2,6
Waller,414,Proposition 10,,REP,Ballots Cast,3,20,20,43
Waller,414,Proposition 10,,REP,Under Votes,0,2,1,3
Waller,414,Proposition 10,,REP,Over Votes,0,0,0,0
Waller,415,President,,DEM,Michael Bennet,0,0,3,3
Waller,415,President,,DEM,Marianne Williamson,0,0,0,0
Waller,415,President,,DEM,Cory Booker,1,0,0,1
Waller,415,President,,DEM,Bernie Sanders,2,5,22,29
Waller,415,President,,DEM,Tulsi Gabbard,0,0,0,0
Waller,415,President,,DEM,Deval Patrick,0,0,0,0
Waller,415,President,,DEM,Amy Klobuchar,0,1,0,1
Waller,415,President,,DEM,Julián Castro,0,0,0,0
Waller,415,President,,DEM,Elizabeth Warren,0,4,2,6
Waller,415,President,,DEM,John K. Delaney,0,0,0,0
Waller,415,President,,DEM,Robby Wells,0,0,0,0
Waller,415,President,,DEM,"Roque ""Rocky"" De La Fuente",0,0,0,0
Waller,415,President,,DEM,Andrew Yang,0,0,0,0
Waller,415,President,,DEM,Joseph R. Biden,10,6,19,35
Waller,415,President,,DEM,Michael R. Bloomberg,4,2,8,14
Waller,415,President,,DEM,Tom Steyer,0,2,0,2
Waller,415,President,,DEM,Pete Buttigieg,1,2,0,3
Waller,415,President,,DEM,Ballots Cast,18,22,54,94
Waller,415,President,,DEM,Under Votes,0,0,0,0
Waller,415,President,,DEM,Over Votes,0,0,0,0
Waller,415,U.S. Senate,,DEM,Royce West,5,3,4,12
Waller,415,U.S. Senate,,DEM,"Annie ""Mamá"" Garcia",1,0,7,8
Waller,415,U.S. Senate,,DEM,D. R. Hunter,0,0,0,0
Waller,415,U.S. Senate,,DEM,Sema Hernandez,1,1,9,11
Waller,415,U.S. Senate,,DEM,Adrian Ocegueda,0,0,1,1
Waller,415,U.S. Senate,,DEM,Chris Bell,4,3,12,19
Waller,415,U.S. Senate,,DEM,Cristina Tzintzun Ramirez,0,6,2,8
Waller,415,U.S. Senate,,DEM,Jack Daniel Foster Jr,0,0,0,0
Waller,415,U.S. Senate,,DEM,Amanda K. Edwards,2,1,2,5
Waller,415,U.S. Senate,,DEM,Victor Hugo Harris,0,0,1,1
Waller,415,U.S. Senate,,DEM,"Mary ""MJ"" Hegar",5,4,6,15
Waller,415,U.S. Senate,,DEM,Michael Cooper,0,1,4,5
Waller,415,U.S. Senate,,DEM,Ballots Cast,18,19,48,85
Waller,415,U.S. Senate,,DEM,Under Votes,0,3,6,9
Waller,415,U.S. Senate,,DEM,Over Votes,0,0,0,0
Waller,415,U.S. House,10,DEM,Mike Siegel,10,9,28,47
Waller,415,U.S. House,10,DEM,Shannon Hutcheson,6,3,9,18
Waller,415,U.S. House,10,DEM,Pritesh Gandhi,1,6,12,19
Waller,415,U.S. House,10,DEM,Ballots Cast,17,18,49,84
Waller,415,U.S. House,10,DEM,Under Votes,1,4,5,10
Waller,415,U.S. House,10,DEM,Over Votes,0,0,0,0
Waller,415,Railroad Commissioner,,DEM,"Roberto R. ""Beto"" Alonzo",5,8,19,32
Waller,415,Railroad Commissioner,,DEM,Chrysta Castañeda,2,7,14,23
Waller,415,Railroad Commissioner,,DEM,Mark Watson,2,1,5,8
Waller,415,Railroad Commissioner,,DEM,Kelly Stone,7,1,9,17
Waller,415,Railroad Commissioner,,DEM,Ballots Cast,16,17,47,80
Waller,415,Railroad Commissioner,,DEM,Under Votes,2,5,7,14
Waller,415,Railroad Commissioner,,DEM,Over Votes,0,0,0,0
Waller,415,"Chief Justice, Supreme Court",,DEM,Jerry Zimmerer,8,0,11,19
Waller,415,"Chief Justice, Supreme Court",,DEM,Amy Clark Meachum,8,16,37,61
Waller,415,"Chief Justice, Supreme Court",,DEM,Ballots Cast,16,16,48,80
Waller,415,"Chief Justice, Supreme Court",,DEM,Under Votes,2,6,6,14
Waller,415,"Chief Justice, Supreme Court",,DEM,Over Votes,0,0,0,0
Waller,415,"Justice, Supreme Court, Place 6 Unexpired Term",,DEM,Kathy Cheng,11,14,37,62
Waller,415,"Justice, Supreme Court, Place 6 Unexpired Term",,DEM,Larry Praeger,5,4,12,21
Waller,415,"Justice, Supreme Court, Place 6 Unexpired Term",,DEM,Ballots Cast,16,18,49,83
Waller,415,"Justice, Supreme Court, Place 6 Unexpired Term",,DEM,Under Votes,2,4,5,11
Waller,415,"Justice, Supreme Court, Place 6 Unexpired Term",,DEM,Over Votes,0,0,0,0
Waller,415,"Justice, Supreme Court, Place 7",,DEM,Staci Williams,14,16,35,65
Waller,415,"Justice, Supreme Court, Place 7",,DEM,Brandy Voss,2,1,12,15
Waller,415,"Justice, Supreme Court, Place 7",,DEM,Ballots Cast,16,17,47,80
Waller,415,"Justice, Supreme Court, Place 7",,DEM,Under Votes,2,5,7,14
Waller,415,"Justice, Supreme Court, Place 7",,DEM,Over Votes,0,0,0,0
Waller,415,"Justice, Supreme Court, Place 8",,DEM,Gisela D. Triana,10,14,41,65
Waller,415,"Justice, Supreme Court, Place 8",,DEM,Peter Kelly,6,3,6,15
Waller,415,"Justice, Supreme Court, Place 8",,DEM,Ballots Cast,16,17,47,80
Waller,415,"Justice, Supreme Court, Place 8",,DEM,Under Votes,2,5,7,14
Waller,415,"Justice, Supreme Court, Place 8",,DEM,Over Votes,0,0,0,0
Waller,415,"Judge, Court of Criminal Appeals, Place 3",,DEM,Elizabeth Davis Frizell,11,16,33,60
Waller,415,"Judge, Court of Criminal Appeals, Place 3",,DEM,William Pieratt Demond,3,0,6,9
Waller,415,"Judge, Court of Criminal Appeals, Place 3",,DEM,Dan Wood,2,0,10,12
Waller,415,"Judge, Court of Criminal Appeals, Place 3",,DEM,Ballots Cast,16,16,49,81
Waller,415,"Judge, Court of Criminal Appeals, Place 3",,DEM,Under Votes,2,6,5,13
Waller,415,"Judge, Court of Criminal Appeals, Place 3",,DEM,Over Votes,0,0,0,0
Waller,415,"Judge, Court of Criminal Appeals, Place 4",,DEM,Steven Miears,6,2,17,25
Waller,415,"Judge, Court of Criminal Appeals, Place 4",,DEM,Tina Clinton,10,14,32,56
Waller,415,"Judge, Court of Criminal Appeals, Place 4",,DEM,Ballots Cast,16,16,49,81
Waller,415,"Judge, Court of Criminal Appeals, Place 4",,DEM,Under Votes,2,6,5,13
Waller,415,"Judge, Court of Criminal Appeals, Place 4",,DEM,Over Votes,0,0,0,0
Waller,415,"Judge, Court of Criminal Appeals, Place 9",,DEM,Brandon Birmingham,11,14,43,68
Waller,415,"Judge, Court of Criminal Appeals, Place 9",,DEM,Ballots Cast,11,14,43,68
Waller,415,"Judge, Court of Criminal Appeals, Place 9",,DEM,Under Votes,7,8,11,26
Waller,415,"Judge, Court of Criminal Appeals, Place 9",,DEM,Over Votes,0,0,0,0
Waller,415,"Member, State Board of Education, District 10",,DEM,Stephen Wyman,1,3,11,15
Waller,415,"Member, State Board of Education, District 10",,DEM,Marsha Burnett-Webster,15,16,35,66
Waller,415,"Member, State Board of Education, District 10",,DEM,Ballots Cast,16,19,46,81
Waller,415,"Member, State Board of Education, District 10",,DEM,Under Votes,2,3,8,13
Waller,415,"Member, State Board of Education, District 10",,DEM,Over Votes,0,0,0,0
Waller,415,State Senate,18,DEM,Michael Antalan,13,15,42,70
Waller,415,State Senate,18,DEM,Ballots Cast,13,15,42,70
Waller,415,State Senate,18,DEM,Under Votes,5,7,12,24
Waller,415,State Senate,18,DEM,Over Votes,0,0,0,0
Waller,415,State Representative,3,DEM,Martin Shupp,13,15,41,69
Waller,415,State Representative,3,DEM,Ballots Cast,13,15,41,69
Waller,415,State Representative,3,DEM,Under Votes,5,7,13,25
Waller,415,State Representative,3,DEM,Over Votes,0,0,0,0
Waller,415,"Chief Justice, 14th Court of Appeals District",,DEM,Jane Robinson,14,14,41,69
Waller,415,"Chief Justice, 14th Court of Appeals District",,DEM,Jim Evans,3,1,5,9
Waller,415,"Chief Justice, 14th Court of Appeals District",,DEM,Ballots Cast,17,15,46,78
Waller,415,"Chief Justice, 14th Court of Appeals District",,DEM,Under Votes,1,7,8,16
Waller,415,"Chief Justice, 14th Court of Appeals District",,DEM,Over Votes,0,0,0,0
Waller,415,"Justice, 1st Court of Appeals District, Place 3",,DEM,Jim Sharp,4,1,6,11
Waller,415,"Justice, 1st Court of Appeals District, Place 3",,DEM,Dinesh Singhal,3,4,11,18
Waller,415,"Justice, 1st Court of Appeals District, Place 3",,DEM,Veronica Rivas-Molloy,10,12,32,54
Waller,415,"Justice, 1st Court of Appeals District, Place 3",,DEM,Ballots Cast,17,17,49,83
Waller,415,"Justice, 1st Court of Appeals District, Place 3",,DEM,Under Votes,1,5,5,11
Waller,415,"Justice, 1st Court of Appeals District, Place 3",,DEM,Over Votes,0,0,0,0
Waller,415,"Justice, 1st Court of Appeals District, Place 5",,DEM,Tim Hootman,2,3,15,20
Waller,415,"Justice, 1st Court of Appeals District, Place 5",,DEM,Amparo Monique Guerra,14,13,31,58
Waller,415,"Justice, 1st Court of Appeals District, Place 5",,DEM,Ballots Cast,16,16,46,78
Waller,415,"Justice, 1st Court of Appeals District, Place 5",,DEM,Under Votes,2,6,8,16
Waller,415,"Justice, 1st Court of Appeals District, Place 5",,DEM,Over Votes,0,0,0,0
Waller,415,"Justice, 14th Court of Appeals District, Place 7",,DEM,"Tamika ""Tami"" Craft",4,6,15,25
Waller,415,"Justice, 14th Court of Appeals District, Place 7",,DEM,Wally Kronzer,1,1,4,6
Waller,415,"Justice, 14th Court of Appeals District, Place 7",,DEM,V.R. Faulkner,6,1,0,7
Waller,415,"Justice, 14th Court of Appeals District, Place 7",,DEM,Cheri Thomas,3,5,12,20
Waller,415,"Justice, 14th Court of Appeals District, Place 7",,DEM,Dominic J. Merino,1,2,10,13
Waller,415,"Justice, 14th Court of Appeals District, Place 7",,DEM,Lennon C. Wright,1,0,5,6
Waller,415,"Justice, 14th Court of Appeals District, Place 7",,DEM,Ballots Cast,16,15,46,77
Waller,415,"Justice, 14th Court of Appeals District, Place 7",,DEM,Under Votes,2,7,8,17
Waller,415,"Justice, 14th Court of Appeals District, Place 7",,DEM,Over Votes,0,0,0,0
Waller,415,Sheriff,,DEM,Cedric D. Watson,17,17,42,76
Waller,415,Sheriff,,DEM,Ballots Cast,17,17,42,76
Waller,415,Sheriff,,DEM,Under Votes,1,5,12,18
Waller,415,Sheriff,,DEM,Over Votes,0,0,0,0
Waller,415,County Chairman,,DEM,Rosa Patlan Harris,16,17,43,76
Waller,415,County Chairman,,DEM,Ballots Cast,16,17,43,76
Waller,415,County Chairman,,DEM,Under Votes,2,5,11,18
Waller,415,County Chairman,,DEM,Over Votes,0,0,0,0
Waller,415,President,,REP,Donald J. Trump,21,116,186,323
Waller,415,President,,REP,Joe Walsh,0,1,1,2
Waller,415,President,,REP,Bob Ely,0,0,0,0
Waller,415,President,,REP,"Roque ""Rocky"" De La Fuente Guerra",0,0,1,1
Waller,415,President,,REP,Zoltan G. Istvan,0,0,0,0
Waller,415,President,,REP,Matthew John Matern,0,0,0,0
Waller,415,President,,REP,Bill Weld,0,1,1,2
Waller,415,President,,REP,Uncommitted,1,3,4,8
Waller,415,President,,REP,Ballots Cast,22,121,193,336
Waller,415,President,,REP,Under Votes,0,0,3,3
Waller,415,President,,REP,Over Votes,0,0,0,0
Waller,415,U.S. Senate,,REP,Dwayne Stovall,1,26,40,67
Waller,415,U.S. Senate,,REP,Mark Yancey,0,11,12,23
Waller,415,U.S. Senate,,REP,Virgil Bierschwale,2,0,3,5
Waller,415,U.S. Senate,,REP,John Anthony Castro,0,2,5,7
Waller,415,U.S. Senate,,REP,John Cornyn,18,76,122,216
Waller,415,U.S. Senate,,REP,Ballots Cast,21,115,182,318
Waller,415,U.S. Senate,,REP,Under Votes,1,6,14,21
Waller,415,U.S. Senate,,REP,Over Votes,0,0,0,0
Waller,415,U.S. House,10,REP,Michael McCaul,20,105,182,307
Waller,415,U.S. House,10,REP,Ballots Cast,20,105,182,307
Waller,415,U.S. House,10,REP,Under Votes,2,16,14,32
Waller,415,U.S. House,10,REP,Over Votes,0,0,0,0
Waller,415,Railroad Commissioner,,REP,Ryan Sitton,7,56,84,147
Waller,415,Railroad Commissioner,,REP,"James ""Jim"" Wright",9,45,72,126
Waller,415,Railroad Commissioner,,REP,Ballots Cast,16,101,156,273
Waller,415,Railroad Commissioner,,REP,Under Votes,6,20,40,66
Waller,415,Railroad Commissioner,,REP,Over Votes,0,0,0,0
Waller,415,"Chief Justice, Supreme Court",,REP,Nathan Hecht,17,99,165,281
Waller,415,"Chief Justice, Supreme Court",,REP,Ballots Cast,17,99,165,281
Waller,415,"Chief Justice, Supreme Court",,REP,Under Votes,5,22,31,58
Waller,415,"Chief Justice, Supreme Court",,REP,Over Votes,0,0,0,0
Waller,415,"Justice, Supreme Court, Place 6 Unexpired Term",,REP,Jane Bland,16,96,162,274
Waller,415,"Justice, Supreme Court, Place 6 Unexpired Term",,REP,Ballots Cast,16,96,162,274
Waller,415,"Justice, Supreme Court, Place 6 Unexpired Term",,REP,Under Votes,6,25,34,65
Waller,415,"Justice, Supreme Court, Place 6 Unexpired Term",,REP,Over Votes,0,0,0,0
Waller,415,"Justice, Supreme Court, Place 7",,REP,Jeff Boyd,16,94,162,272
Waller,415,"Justice, Supreme Court, Place 7",,REP,Ballots Cast,16,94,162,272
Waller,415,"Justice, Supreme Court, Place 7",,REP,Under Votes,6,27,34,67
Waller,415,"Justice, Supreme Court, Place 7",,REP,Over Votes,0,0,0,0
Waller,415,"Justice, Supreme Court, Place 8",,REP,Brett Busby,16,94,161,271
Waller,415,"Justice, Supreme Court, Place 8",,REP,Ballots Cast,16,94,161,271
Waller,415,"Justice, Supreme Court, Place 8",,REP,Under Votes,6,27,35,68
Waller,415,"Justice, Supreme Court, Place 8",,REP,Over Votes,0,0,0,0
Waller,415,"Judge, Court of Criminal Appeals, Place 3",,REP,Gina Parker,5,46,68,119
Waller,415,"Judge, Court of Criminal Appeals, Place 3",,REP,Bert Richardson,13,50,90,153
Waller,415,"Judge, Court of Criminal Appeals, Place 3",,REP,Ballots Cast,18,96,158,272
Waller,415,"Judge, Court of Criminal Appeals, Place 3",,REP,Under Votes,4,25,38,67
Waller,415,"Judge, Court of Criminal Appeals, Place 3",,REP,Over Votes,0,0,0,0
Waller,415,"Judge, Court of Criminal Appeals, Place 4",,REP,Kevin Patrick Yeary,16,91,161,268
Waller,415,"Judge, Court of Criminal Appeals, Place 4",,REP,Ballots Cast,16,91,161,268
Waller,415,"Judge, Court of Criminal Appeals, Place 4",,REP,Under Votes,6,30,35,71
Waller,415,"Judge, Court of Criminal Appeals, Place 4",,REP,Over Votes,0,0,0,0
Waller,415,"Judge, Court of Criminal Appeals, Place 9",,REP,David Newell,16,89,160,265
Waller,415,"Judge, Court of Criminal Appeals, Place 9",,REP,Ballots Cast,16,89,160,265
Waller,415,"Judge, Court of Criminal Appeals, Place 9",,REP,Under Votes,6,32,36,74
Waller,415,"Judge, Court of Criminal Appeals, Place 9",,REP,Over Votes,0,0,0,0
Waller,415,"Member, State Board of Education, District 10",,REP,Tom Maynard,16,88,161,265
Waller,415,"Member, State Board of Education, District 10",,REP,Ballots Cast,16,88,161,265
Waller,415,"Member, State Board of Education, District 10",,REP,Under Votes,6,33,35,74
Waller,415,"Member, State Board of Education, District 10",,REP,Over Votes,0,0,0,0
Waller,415,State Senate,18,REP,Lois W. Kolkhorst,20,95,169,284
Waller,415,State Senate,18,REP,Ballots Cast,20,95,169,284
Waller,415,State Senate,18,REP,Under Votes,2,26,27,55
Waller,415,State Senate,18,REP,Over Votes,0,0,0,0
Waller,415,State Representative,3,REP,Cecil Bell Jr,20,99,169,288
Waller,415,State Representative,3,REP,Ballots Cast,20,99,169,288
Waller,415,State Representative,3,REP,Under Votes,2,22,27,51
Waller,415,State Representative,3,REP,Over Votes,0,0,0,0
Waller,415,"Chief Justice, 14th Court of Appeals District",,REP,Tracy Elizabeth Christopher,16,91,159,266
Waller,415,"Chief Justice, 14th Court of Appeals District",,REP,Ballots Cast,16,91,159,266
Waller,415,"Chief Justice, 14th Court of Appeals District",,REP,Under Votes,6,30,37,73
Waller,415,"Chief Justice, 14th Court of Appeals District",,REP,Over Votes,0,0,0,0
Waller,415,"Justice, 1st Court of Appeals District, Place 3",,REP,Russell Lloyd,16,91,162,269
Waller,415,"Justice, 1st Court of Appeals District, Place 3",,REP,Ballots Cast,16,91,162,269
Waller,415,"Justice, 1st Court of Appeals District, Place 3",,REP,Under Votes,6,30,34,70
Waller,415,"Justice, 1st Court of Appeals District, Place 3",,REP,Over Votes,0,0,0,0
Waller,415,"Justice, 1st Court of Appeals District, Place 5",,REP,Chad Bridges,4,37,53,94
Waller,415,"Justice, 1st Court of Appeals District, Place 5",,REP,James Lombardino,1,7,10,18
Waller,415,"Justice, 1st Court of Appeals District, Place 5",,REP,Levi J. Benton,3,12,26,41
Waller,415,"Justice, 1st Court of Appeals District, Place 5",,REP,Terry Adams,7,32,60,99
Waller,415,"Justice, 1st Court of Appeals District, Place 5",,REP,Ballots Cast,15,88,149,252
Waller,415,"Justice, 1st Court of Appeals District, Place 5",,REP,Under Votes,7,33,47,87
Waller,415,"Justice, 1st Court of Appeals District, Place 5",,REP,Over Votes,0,0,0,0
Waller,415,"Justice, 14th Court of Appeals District, Place 7",,REP,Ken Wise,16,88,158,262
Waller,415,"Justice, 14th Court of Appeals District, Place 7",,REP,Ballots Cast,16,88,158,262
Waller,415,"Justice, 14th Court of Appeals District, Place 7",,REP,Under Votes,6,33,38,77
Waller,415,"Justice, 14th Court of Appeals District, Place 7",,REP,Over Votes,0,0,0,0
Waller,415,"District Judge, 506th Judicial District",,REP,Gary W. Chaney,18,94,163,275
Waller,415,"District Judge, 506th Judicial District",,REP,Ballots Cast,18,94,163,275
Waller,415,"District Judge, 506th Judicial District",,REP,Under Votes,4,27,33,64
Waller,415,"District Judge, 506th Judicial District",,REP,Over Votes,0,0,0,0
Waller,415,Sheriff,,REP,Dan Porter,1,14,34,49
Waller,415,Sheriff,,REP,R. Glenn Smith,10,58,87,155
Waller,415,Sheriff,,REP,Troy Guidry,11,48,70,129
Waller,415,Sheriff,,REP,Ballots Cast,22,120,191,333
Waller,415,Sheriff,,REP,Under Votes,0,1,5,6
Waller,415,Sheriff,,REP,Over Votes,0,0,0,0
Waller,415,County Tax Assessor-Collector,,REP,Ellen Contreras Shelburne,14,71,115,200
Waller,415,County Tax Assessor-Collector,,REP,Carolyn Miedke,8,43,70,121
Waller,415,County Tax Assessor-Collector,,REP,Ballots Cast,22,114,185,321
Waller,415,County Tax Assessor-Collector,,REP,Under Votes,0,7,11,18
Waller,415,County Tax Assessor-Collector,,REP,Over Votes,0,0,0,0
Waller,415,"Constable, Precinct 4",,REP,Joe Trimm Jr,22,106,172,300
Waller,415,"Constable, Precinct 4",,REP,Ballots Cast,22,106,172,300
Waller,415,"Constable, Precinct 4",,REP,Under Votes,0,15,24,39
Waller,415,"Constable, Precinct 4",,REP,Over Votes,0,0,0,0
Waller,415,County Chairman,,REP,David W. Luther,16,93,158,267
Waller,415,County Chairman,,REP,Ballots Cast,16,93,158,267
Waller,415,County Chairman,,REP,Under Votes,6,28,38,72
Waller,415,County Chairman,,REP,Over Votes,0,0,0,0
Waller,415,Proposition #1,,DEM,Yes,16,22,52,90
Waller,415,Proposition #1,,DEM,No,1,0,2,3
Waller,415,Proposition #1,,DEM,Ballots Cast,17,22,54,93
Waller,415,Proposition #1,,DEM,Under Votes,1,0,0,1
Waller,415,Proposition #1,,DEM,Over Votes,0,0,0,0
Waller,415,Proposition #2,,DEM,Yes,15,22,53,90
Waller,415,Proposition #2,,DEM,No,2,0,1,3
Waller,415,Proposition #2,,DEM,Ballots Cast,17,22,54,93
Waller,415,Proposition #2,,DEM,Under Votes,1,0,0,1
Waller,415,Proposition #2,,DEM,Over Votes,0,0,0,0
Waller,415,Proposition #3,,DEM,Yes,17,21,54,92
Waller,415,Proposition #3,,DEM,No,1,0,0,1
Waller,415,Proposition #3,,DEM,Ballots Cast,18,21,54,93
Waller,415,Proposition #3,,DEM,Under Votes,0,1,0,1
Waller,415,Proposition #3,,DEM,Over Votes,0,0,0,0
Waller,415,Proposition #4,,DEM,Yes,18,21,49,88
Waller,415,Proposition #4,,DEM,No,0,0,3,3
Waller,415,Proposition #4,,DEM,Ballots Cast,18,21,52,91
Waller,415,Proposition #4,,DEM,Under Votes,0,1,2,3
Waller,415,Proposition #4,,DEM,Over Votes,0,0,0,0
Waller,415,Proposition #5,,DEM,Yes,16,21,53,90
Waller,415,Proposition #5,,DEM,No,2,0,1,3
Waller,415,Proposition #5,,DEM,Ballots Cast,18,21,54,93
Waller,415,Proposition #5,,DEM,Under Votes,0,1,0,1
Waller,415,Proposition #5,,DEM,Over Votes,0,0,0,0
Waller,415,Proposition #6,,DEM,Yes,18,22,51,91
Waller,415,Proposition #6,,DEM,No,0,0,3,3
Waller,415,Proposition #6,,DEM,Ballots Cast,18,22,54,94
Waller,415,Proposition #6,,DEM,Under Votes,0,0,0,0
Waller,415,Proposition #6,,DEM,Over Votes,0,0,0,0
Waller,415,Proposition #7,,DEM,Yes,17,22,52,91
Waller,415,Proposition #7,,DEM,No,1,0,2,3
Waller,415,Proposition #7,,DEM,Ballots Cast,18,22,54,94
Waller,415,Proposition #7,,DEM,Under Votes,0,0,0,0
Waller,415,Proposition #7,,DEM,Over Votes,0,0,0,0
Waller,415,Proposition #8,,DEM,Yes,17,22,49,88
Waller,415,Proposition #8,,DEM,No,1,0,3,4
Waller,415,Proposition #8,,DEM,Ballots Cast,18,22,52,92
Waller,415,Proposition #8,,DEM,Under Votes,0,0,2,2
Waller,415,Proposition #8,,DEM,Over Votes,0,0,0,0
Waller,415,Proposition #9,,DEM,Yes,17,21,53,91
Waller,415,Proposition #9,,DEM,No,1,0,0,1
Waller,415,Proposition #9,,DEM,Ballots Cast,18,21,53,92
Waller,415,Proposition #9,,DEM,Under Votes,0,1,1,2
Waller,415,Proposition #9,,DEM,Over Votes,0,0,0,0
Waller,415,Proposition #10,,DEM,Yes,17,20,52,89
Waller,415,Proposition #10,,DEM,No,1,1,2,4
Waller,415,Proposition #10,,DEM,Ballots Cast,18,21,54,93
Waller,415,Proposition #10,,DEM,Under Votes,0,1,0,1
Waller,415,Proposition #10,,DEM,Over Votes,0,0,0,0
Waller,415,Proposition #11,,DEM,Yes,17,21,51,89
Waller,415,Proposition #11,,DEM,No,1,0,3,4
Waller,415,Proposition #11,,DEM,Ballots Cast,18,21,54,93
Waller,415,Proposition #11,,DEM,Under Votes,0,1,0,1
Waller,415,Proposition #11,,DEM,Over Votes,0,0,0,0
Waller,415,Proposition 1,,REP,Yes,20,111,177,308
Waller,415,Proposition 1,,REP,No,1,9,14,24
Waller,415,Proposition 1,,REP,Ballots Cast,21,120,191,332
Waller,415,Proposition 1,,REP,Under Votes,1,1,5,7
Waller,415,Proposition 1,,REP,Over Votes,0,0,0,0
Waller,415,Proposition 2,,REP,Yes,19,111,173,303
Waller,415,Proposition 2,,REP,No,1,8,18,27
Waller,415,Proposition 2,,REP,Ballots Cast,20,119,191,330
Waller,415,Proposition 2,,REP,Under Votes,0,2,5,7
Waller,415,Proposition 2,,REP,Over Votes,2,0,0,2
Waller,415,Proposition 3,,REP,Yes,21,115,179,315
Waller,415,Proposition 3,,REP,No,1,4,9,14
Waller,415,Proposition 3,,REP,Ballots Cast,22,119,188,329
Waller,415,Proposition 3,,REP,Under Votes,0,2,8,10
Waller,415,Proposition 3,,REP,Over Votes,0,0,0,0
Waller,415,Proposition 4,,REP,Yes,19,111,183,313
Waller,415,Proposition 4,,REP,No,2,8,7,17
Waller,415,Proposition 4,,REP,Ballots Cast,21,119,190,330
Waller,415,Proposition 4,,REP,Under Votes,1,2,6,9
Waller,415,Proposition 4,,REP,Over Votes,0,0,0,0
Waller,415,Proposition 5,,REP,Yes,19,106,176,301
Waller,415,Proposition 5,,REP,No,2,12,13,27
Waller,415,Proposition 5,,REP,Ballots Cast,21,118,189,328
Waller,415,Proposition 5,,REP,Under Votes,1,3,7,11
Waller,415,Proposition 5,,REP,Over Votes,0,0,0,0
Waller,415,Proposition 6,,REP,Yes,21,113,178,312
Waller,415,Proposition 6,,REP,No,1,6,10,17
Waller,415,Proposition 6,,REP,Ballots Cast,22,119,188,329
Waller,415,Proposition 6,,REP,Under Votes,0,2,8,10
Waller,415,Proposition 6,,REP,Over Votes,0,0,0,0
Waller,415,Proposition 7,,REP,Yes,21,117,189,327
Waller,415,Proposition 7,,REP,No,0,3,3,6
Waller,415,Proposition 7,,REP,Ballots Cast,21,120,192,333
Waller,415,Proposition 7,,REP,Under Votes,1,1,4,6
Waller,415,Proposition 7,,REP,Over Votes,0,0,0,0
Waller,415,Proposition 8,,REP,Yes,20,116,193,329
Waller,415,Proposition 8,,REP,No,1,3,0,4
Waller,415,Proposition 8,,REP,Ballots Cast,21,119,193,333
Waller,415,Proposition 8,,REP,Under Votes,1,2,3,6
Waller,415,Proposition 8,,REP,Over Votes,0,0,0,0
Waller,415,Proposition 9,,REP,Yes,20,117,184,321
Waller,415,Proposition 9,,REP,No,1,2,7,10
Waller,415,Proposition 9,,REP,Ballots Cast,21,119,191,331
Waller,415,Proposition 9,,REP,Under Votes,1,2,5,8
Waller,415,Proposition 9,,REP,Over Votes,0,0,0,0
Waller,415,Proposition 10,,REP,Yes,21,111,174,306
Waller,415,Proposition 10,,REP,No,1,8,15,24
Waller,415,Proposition 10,,REP,Ballots Cast,22,119,189,330
Waller,415,Proposition 10,,REP,Under Votes,0,2,7,9
Waller,415,Proposition 10,,REP,Over Votes,0,0,0,0
Waller,416,President,,DEM,Michael Bennet,0,1,1,2
Waller,416,President,,DEM,Marianne Williamson,0,2,0,2
Waller,416,President,,DEM,Cory Booker,0,1,0,1
Waller,416,President,,DEM,Bernie Sanders,3,13,23,39
Waller,416,President,,DEM,Tulsi Gabbard,0,0,0,0
Waller,416,President,,DEM,Deval Patrick,0,0,0,0
Waller,416,President,,DEM,Amy Klobuchar,0,0,0,0
Waller,416,President,,DEM,Julián Castro,0,0,0,0
Waller,416,President,,DEM,Elizabeth Warren,0,1,1,2
Waller,416,President,,DEM,John K. Delaney,0,0,0,0
Waller,416,President,,DEM,Robby Wells,0,0,0,0
Waller,416,President,,DEM,"Roque ""Rocky"" De La Fuente",0,0,0,0
Waller,416,President,,DEM,Andrew Yang,0,0,1,1
Waller,416,President,,DEM,Joseph R. Biden,4,6,37,47
Waller,416,President,,DEM,Michael R. Bloomberg,7,12,8,27
Waller,416,President,,DEM,Tom Steyer,0,0,0,0
Waller,416,President,,DEM,Pete Buttigieg,0,3,0,3
Waller,416,President,,DEM,Ballots Cast,14,39,71,124
Waller,416,President,,DEM,Under Votes,0,0,0,0
Waller,416,President,,DEM,Over Votes,0,0,0,0
Waller,416,U.S. Senate,,DEM,Royce West,4,6,7,17
Waller,416,U.S. Senate,,DEM,"Annie ""Mamá"" Garcia",3,5,10,18
Waller,416,U.S. Senate,,DEM,D. R. Hunter,0,0,0,0
Waller,416,U.S. Senate,,DEM,Sema Hernandez,0,3,7,10
Waller,416,U.S. Senate,,DEM,Adrian Ocegueda,0,0,4,4
Waller,416,U.S. Senate,,DEM,Chris Bell,2,12,18,32
Waller,416,U.S. Senate,,DEM,Cristina Tzintzun Ramirez,0,4,3,7
Waller,416,U.S. Senate,,DEM,Jack Daniel Foster Jr,1,0,1,2
Waller,416,U.S. Senate,,DEM,Amanda K. Edwards,0,1,4,5
Waller,416,U.S. Senate,,DEM,Victor Hugo Harris,0,1,1,2
Waller,416,U.S. Senate,,DEM,"Mary ""MJ"" Hegar",3,2,4,9
Waller,416,U.S. Senate,,DEM,Michael Cooper,0,1,3,4
Waller,416,U.S. Senate,,DEM,Ballots Cast,13,35,62,110
Waller,416,U.S. Senate,,DEM,Under Votes,0,4,9,13
Waller,416,U.S. Senate,,DEM,Over Votes,1,0,0,1
Waller,416,U.S. House,10,DEM,Mike Siegel,7,14,32,53
Waller,416,U.S. House,10,DEM,Shannon Hutcheson,3,9,21,33
Waller,416,U.S. House,10,DEM,Pritesh Gandhi,4,13,11,28
Waller,416,U.S. House,10,DEM,Ballots Cast,14,36,64,114
Waller,416,U.S. House,10,DEM,Under Votes,0,3,7,10
Waller,416,U.S. House,10,DEM,Over Votes,0,0,0,0
Waller,416,Railroad Commissioner,,DEM,"Roberto R. ""Beto"" Alonzo",7,10,23,40
Waller,416,Railroad Commissioner,,DEM,Chrysta Castañeda,3,6,14,23
Waller,416,Railroad Commissioner,,DEM,Mark Watson,1,10,12,23
Waller,416,Railroad Commissioner,,DEM,Kelly Stone,1,8,13,22
Waller,416,Railroad Commissioner,,DEM,Ballots Cast,12,34,62,108
Waller,416,Railroad Commissioner,,DEM,Under Votes,2,5,9,16
Waller,416,Railroad Commissioner,,DEM,Over Votes,0,0,0,0
Waller,416,"Chief Justice, Supreme Court",,DEM,Jerry Zimmerer,2,4,15,21
Waller,416,"Chief Justice, Supreme Court",,DEM,Amy Clark Meachum,10,29,46,85
Waller,416,"Chief Justice, Supreme Court",,DEM,Ballots Cast,12,33,61,106
Waller,416,"Chief Justice, Supreme Court",,DEM,Under Votes,2,6,10,18
Waller,416,"Chief Justice, Supreme Court",,DEM,Over Votes,0,0,0,0
Waller,416,"Justice, Supreme Court, Place 6 Unexpired Term",,DEM,Kathy Cheng,7,28,49,84
Waller,416,"Justice, Supreme Court, Place 6 Unexpired Term",,DEM,Larry Praeger,5,6,12,23
Waller,416,"Justice, Supreme Court, Place 6 Unexpired Term",,DEM,Ballots Cast,12,34,61,107
Waller,416,"Justice, Supreme Court, Place 6 Unexpired Term",,DEM,Under Votes,2,5,10,17
Waller,416,"Justice, Supreme Court, Place 6 Unexpired Term",,DEM,Over Votes,0,0,0,0
Waller,416,"Justice, Supreme Court, Place 7",,DEM,Staci Williams,10,19,39,68
Waller,416,"Justice, Supreme Court, Place 7",,DEM,Brandy Voss,2,15,22,39
Waller,416,"Justice, Supreme Court, Place 7",,DEM,Ballots Cast,12,34,61,107
Waller,416,"Justice, Supreme Court, Place 7",,DEM,Under Votes,2,5,10,17
Waller,416,"Justice, Supreme Court, Place 7",,DEM,Over Votes,0,0,0,0
Waller,416,"Justice, Supreme Court, Place 8",,DEM,Gisela D. Triana,5,24,45,74
Waller,416,"Justice, Supreme Court, Place 8",,DEM,Peter Kelly,7,8,16,31
Waller,416,"Justice, Supreme Court, Place 8",,DEM,Ballots Cast,12,32,61,105
Waller,416,"Justice, Supreme Court, Place 8",,DEM,Under Votes,2,7,10,19
Waller,416,"Justice, Supreme Court, Place 8",,DEM,Over Votes,0,0,0,0
Waller,416,"Judge, Court of Criminal Appeals, Place 3",,DEM,Elizabeth Davis Frizell,8,22,40,70
Waller,416,"Judge, Court of Criminal Appeals, Place 3",,DEM,William Pieratt Demond,0,6,10,16
Waller,416,"Judge, Court of Criminal Appeals, Place 3",,DEM,Dan Wood,4,5,12,21
Waller,416,"Judge, Court of Criminal Appeals, Place 3",,DEM,Ballots Cast,12,33,62,107
Waller,416,"Judge, Court of Criminal Appeals, Place 3",,DEM,Under Votes,2,6,9,17
Waller,416,"Judge, Court of Criminal Appeals, Place 3",,DEM,Over Votes,0,0,0,0
Waller,416,"Judge, Court of Criminal Appeals, Place 4",,DEM,Steven Miears,1,5,10,16
Waller,416,"Judge, Court of Criminal Appeals, Place 4",,DEM,Tina Clinton,11,28,49,88
Waller,416,"Judge, Court of Criminal Appeals, Place 4",,DEM,Ballots Cast,12,33,59,104
Waller,416,"Judge, Court of Criminal Appeals, Place 4",,DEM,Under Votes,2,6,12,20
Waller,416,"Judge, Court of Criminal Appeals, Place 4",,DEM,Over Votes,0,0,0,0
Waller,416,"Judge, Court of Criminal Appeals, Place 9",,DEM,Brandon Birmingham,10,30,56,96
Waller,416,"Judge, Court of Criminal Appeals, Place 9",,DEM,Ballots Cast,10,30,56,96
Waller,416,"Judge, Court of Criminal Appeals, Place 9",,DEM,Under Votes,4,9,15,28
Waller,416,"Judge, Court of Criminal Appeals, Place 9",,DEM,Over Votes,0,0,0,0
Waller,416,"Member, State Board of Education, District 10",,DEM,Stephen Wyman,1,7,20,28
Waller,416,"Member, State Board of Education, District 10",,DEM,Marsha Burnett-Webster,11,24,40,75
Waller,416,"Member, State Board of Education, District 10",,DEM,Ballots Cast,12,31,60,103
Waller,416,"Member, State Board of Education, District 10",,DEM,Under Votes,2,8,11,21
Waller,416,"Member, State Board of Education, District 10",,DEM,Over Votes,0,0,0,0
Waller,416,State Senate,18,DEM,Michael Antalan,9,32,55,96
Waller,416,State Senate,18,DEM,Ballots Cast,9,32,55,96
Waller,416,State Senate,18,DEM,Under Votes,5,7,16,28
Waller,416,State Senate,18,DEM,Over Votes,0,0,0,0
Waller,416,State Representative,3,DEM,Martin Shupp,10,29,52,91
Waller,416,State Representative,3,DEM,Ballots Cast,10,29,52,91
Waller,416,State Representative,3,DEM,Under Votes,4,10,19,33
Waller,416,State Representative,3,DEM,Over Votes,0,0,0,0
Waller,416,"Chief Justice, 14th Court of Appeals District",,DEM,Jane Robinson,11,26,47,84
Waller,416,"Chief Justice, 14th Court of Appeals District",,DEM,Jim Evans,0,6,10,16
Waller,416,"Chief Justice, 14th Court of Appeals District",,DEM,Ballots Cast,11,32,57,100
Waller,416,"Chief Justice, 14th Court of Appeals District",,DEM,Under Votes,3,7,14,24
Waller,416,"Chief Justice, 14th Court of Appeals District",,DEM,Over Votes,0,0,0,0
Waller,416,"Justice, 1st Court of Appeals District, Place 3",,DEM,Jim Sharp,2,8,11,21
Waller,416,"Justice, 1st Court of Appeals District, Place 3",,DEM,Dinesh Singhal,2,9,9,20
Waller,416,"Justice, 1st Court of Appeals District, Place 3",,DEM,Veronica Rivas-Molloy,8,16,39,63
Waller,416,"Justice, 1st Court of Appeals District, Place 3",,DEM,Ballots Cast,12,33,59,104
Waller,416,"Justice, 1st Court of Appeals District, Place 3",,DEM,Under Votes,2,6,12,20
Waller,416,"Justice, 1st Court of Appeals District, Place 3",,DEM,Over Votes,0,0,0,0
Waller,416,"Justice, 1st Court of Appeals District, Place 5",,DEM,Tim Hootman,3,11,15,29
Waller,416,"Justice, 1st Court of Appeals District, Place 5",,DEM,Amparo Monique Guerra,9,22,44,75
Waller,416,"Justice, 1st Court of Appeals District, Place 5",,DEM,Ballots Cast,12,33,59,104
Waller,416,"Justice, 1st Court of Appeals District, Place 5",,DEM,Under Votes,2,6,12,20
Waller,416,"Justice, 1st Court of Appeals District, Place 5",,DEM,Over Votes,0,0,0,0
Waller,416,"Justice, 14th Court of Appeals District, Place 7",,DEM,"Tamika ""Tami"" Craft",10,16,34,60
Waller,416,"Justice, 14th Court of Appeals District, Place 7",,DEM,Wally Kronzer,0,3,2,5
Waller,416,"Justice, 14th Court of Appeals District, Place 7",,DEM,V.R. Faulkner,0,0,4,4
Waller,416,"Justice, 14th Court of Appeals District, Place 7",,DEM,Cheri Thomas,1,9,8,18
Waller,416,"Justice, 14th Court of Appeals District, Place 7",,DEM,Dominic J. Merino,0,2,7,9
Waller,416,"Justice, 14th Court of Appeals District, Place 7",,DEM,Lennon C. Wright,0,2,4,6
Waller,416,"Justice, 14th Court of Appeals District, Place 7",,DEM,Ballots Cast,11,32,59,102
Waller,416,"Justice, 14th Court of Appeals District, Place 7",,DEM,Under Votes,2,7,12,21
Waller,416,"Justice, 14th Court of Appeals District, Place 7",,DEM,Over Votes,1,0,0,1
Waller,416,Sheriff,,DEM,Cedric D. Watson,11,31,58,100
Waller,416,Sheriff,,DEM,Ballots Cast,11,31,58,100
Waller,416,Sheriff,,DEM,Under Votes,3,8,13,24
Waller,416,Sheriff,,DEM,Over Votes,0,0,0,0
Waller,416,County Chairman,,DEM,Rosa Patlan Harris,11,32,59,102
Waller,416,County Chairman,,DEM,Ballots Cast,11,32,59,102
Waller,416,County Chairman,,DEM,Under Votes,3,7,12,22
Waller,416,County Chairman,,DEM,Over Votes,0,0,0,0
Waller,416,President,,REP,Donald J. Trump,5,51,78,134
Waller,416,President,,REP,Joe Walsh,0,1,1,2
Waller,416,President,,REP,Bob Ely,0,0,0,0
Waller,416,President,,REP,"Roque ""Rocky"" De La Fuente Guerra",0,0,0,0
Waller,416,President,,REP,Zoltan G. Istvan,0,0,0,0
Waller,416,President,,REP,Matthew John Matern,0,0,0,0
Waller,416,President,,REP,Bill Weld,0,0,0,0
Waller,416,President,,REP,Uncommitted,0,1,2,3
Waller,416,President,,REP,Ballots Cast,5,53,81,139
Waller,416,President,,REP,Under Votes,0,0,0,0
Waller,416,President,,REP,Over Votes,0,0,0,0
Waller,416,U.S. Senate,,REP,Dwayne Stovall,1,10,20,31
Waller,416,U.S. Senate,,REP,Mark Yancey,0,2,4,6
Waller,416,U.S. Senate,,REP,Virgil Bierschwale,0,2,1,3
Waller,416,U.S. Senate,,REP,John Anthony Castro,0,1,4,5
Waller,416,U.S. Senate,,REP,John Cornyn,4,36,51,91
Waller,416,U.S. Senate,,REP,Ballots Cast,5,51,80,136
Waller,416,U.S. Senate,,REP,Under Votes,0,2,1,3
Waller,416,U.S. Senate,,REP,Over Votes,0,0,0,0
Waller,416,U.S. House,10,REP,Michael McCaul,4,49,76,129
Waller,416,U.S. House,10,REP,Ballots Cast,4,49,76,129
Waller,416,U.S. House,10,REP,Under Votes,1,4,5,10
Waller,416,U.S. House,10,REP,Over Votes,0,0,0,0
Waller,416,Railroad Commissioner,,REP,Ryan Sitton,2,24,36,62
Waller,416,Railroad Commissioner,,REP,"James ""Jim"" Wright",2,23,42,67
Waller,416,Railroad Commissioner,,REP,Ballots Cast,4,47,78,129
Waller,416,Railroad Commissioner,,REP,Under Votes,1,6,3,10
Waller,416,Railroad Commissioner,,REP,Over Votes,0,0,0,0
Waller,416,"Chief Justice, Supreme Court",,REP,Nathan Hecht,4,47,73,124
Waller,416,"Chief Justice, Supreme Court",,REP,Ballots Cast,4,47,73,124
Waller,416,"Chief Justice, Supreme Court",,REP,Under Votes,1,6,8,15
Waller,416,"Chief Justice, Supreme Court",,REP,Over Votes,0,0,0,0
Waller,416,"Justice, Supreme Court, Place 6 Unexpired Term",,REP,Jane Bland,4,47,73,124
Waller,416,"Justice, Supreme Court, Place 6 Unexpired Term",,REP,Ballots Cast,4,47,73,124
Waller,416,"Justice, Supreme Court, Place 6 Unexpired Term",,REP,Under Votes,1,6,8,15
Waller,416,"Justice, Supreme Court, Place 6 Unexpired Term",,REP,Over Votes,0,0,0,0
Waller,416,"Justice, Supreme Court, Place 7",,REP,Jeff Boyd,4,47,75,126
Waller,416,"Justice, Supreme Court, Place 7",,REP,Ballots Cast,4,47,75,126
Waller,416,"Justice, Supreme Court, Place 7",,REP,Under Votes,1,6,6,13
Waller,416,"Justice, Supreme Court, Place 7",,REP,Over Votes,0,0,0,0
Waller,416,"Justice, Supreme Court, Place 8",,REP,Brett Busby,4,47,73,124
Waller,416,"Justice, Supreme Court, Place 8",,REP,Ballots Cast,4,47,73,124
Waller,416,"Justice, Supreme Court, Place 8",,REP,Under Votes,1,6,8,15
Waller,416,"Justice, Supreme Court, Place 8",,REP,Over Votes,0,0,0,0
Waller,416,"Judge, Court of Criminal Appeals, Place 3",,REP,Gina Parker,2,27,40,69
Waller,416,"Judge, Court of Criminal Appeals, Place 3",,REP,Bert Richardson,2,23,37,62
Waller,416,"Judge, Court of Criminal Appeals, Place 3",,REP,Ballots Cast,4,50,77,131
Waller,416,"Judge, Court of Criminal Appeals, Place 3",,REP,Under Votes,1,3,4,8
Waller,416,"Judge, Court of Criminal Appeals, Place 3",,REP,Over Votes,0,0,0,0
Waller,416,"Judge, Court of Criminal Appeals, Place 4",,REP,Kevin Patrick Yeary,4,45,72,121
Waller,416,"Judge, Court of Criminal Appeals, Place 4",,REP,Ballots Cast,4,45,72,121
Waller,416,"Judge, Court of Criminal Appeals, Place 4",,REP,Under Votes,1,8,9,18
Waller,416,"Judge, Court of Criminal Appeals, Place 4",,REP,Over Votes,0,0,0,0
Waller,416,"Judge, Court of Criminal Appeals, Place 9",,REP,David Newell,3,46,73,122
Waller,416,"Judge, Court of Criminal Appeals, Place 9",,REP,Ballots Cast,3,46,73,122
Waller,416,"Judge, Court of Criminal Appeals, Place 9",,REP,Under Votes,2,7,8,17
Waller,416,"Judge, Court of Criminal Appeals, Place 9",,REP,Over Votes,0,0,0,0
Waller,416,"Member, State Board of Education, District 10",,REP,Tom Maynard,3,46,71,120
Waller,416,"Member, State Board of Education, District 10",,REP,Ballots Cast,3,46,71,120
Waller,416,"Member, State Board of Education, District 10",,REP,Under Votes,2,7,10,19
Waller,416,"Member, State Board of Education, District 10",,REP,Over Votes,0,0,0,0
Waller,416,State Senate,18,REP,Lois W. Kolkhorst,3,48,72,123
Waller,416,State Senate,18,REP,Ballots Cast,3,48,72,123
Waller,416,State Senate,18,REP,Under Votes,2,5,9,16
Waller,416,State Senate,18,REP,Over Votes,0,0,0,0
Waller,416,State Representative,3,REP,Cecil Bell Jr,3,50,74,127
Waller,416,State Representative,3,REP,Ballots Cast,3,50,74,127
Waller,416,State Representative,3,REP,Under Votes,2,3,7,12
Waller,416,State Representative,3,REP,Over Votes,0,0,0,0
Waller,416,"Chief Justice, 14th Court of Appeals District",,REP,Tracy Elizabeth Christopher,4,46,74,124
Waller,416,"Chief Justice, 14th Court of Appeals District",,REP,Ballots Cast,4,46,74,124
Waller,416,"Chief Justice, 14th Court of Appeals District",,REP,Under Votes,1,7,7,15
Waller,416,"Chief Justice, 14th Court of Appeals District",,REP,Over Votes,0,0,0,0
Waller,416,"Justice, 1st Court of Appeals District, Place 3",,REP,Russell Lloyd,3,46,72,121
Waller,416,"Justice, 1st Court of Appeals District, Place 3",,REP,Ballots Cast,3,46,72,121
Waller,416,"Justice, 1st Court of Appeals District, Place 3",,REP,Under Votes,2,7,9,18
Waller,416,"Justice, 1st Court of Appeals District, Place 3",,REP,Over Votes,0,0,0,0
Waller,416,"Justice, 1st Court of Appeals District, Place 5",,REP,Chad Bridges,0,15,23,38
Waller,416,"Justice, 1st Court of Appeals District, Place 5",,REP,James Lombardino,0,4,10,14
Waller,416,"Justice, 1st Court of Appeals District, Place 5",,REP,Levi J. Benton,0,5,9,14
Waller,416,"Justice, 1st Court of Appeals District, Place 5",,REP,Terry Adams,3,17,23,43
Waller,416,"Justice, 1st Court of Appeals District, Place 5",,REP,Ballots Cast,3,41,65,109
Waller,416,"Justice, 1st Court of Appeals District, Place 5",,REP,Under Votes,2,12,16,30
Waller,416,"Justice, 1st Court of Appeals District, Place 5",,REP,Over Votes,0,0,0,0
Waller,416,"Justice, 14th Court of Appeals District, Place 7",,REP,Ken Wise,3,45,71,119
Waller,416,"Justice, 14th Court of Appeals District, Place 7",,REP,Ballots Cast,3,45,71,119
Waller,416,"Justice, 14th Court of Appeals District, Place 7",,REP,Under Votes,2,8,10,20
Waller,416,"Justice, 14th Court of Appeals District, Place 7",,REP,Over Votes,0,0,0,0
Waller,416,"District Judge, 506th Judicial District",,REP,Gary W. Chaney,3,47,71,121
Waller,416,"District Judge, 506th Judicial District",,REP,Ballots Cast,3,47,71,121
Waller,416,"District Judge, 506th Judicial District",,REP,Under Votes,2,6,10,18
Waller,416,"District Judge, 506th Judicial District",,REP,Over Votes,0,0,0,0
Waller,416,Sheriff,,REP,Dan Porter,0,9,24,33
Waller,416,Sheriff,,REP,R. Glenn Smith,2,23,34,59
Waller,416,Sheriff,,REP,Troy Guidry,2,21,21,44
Waller,416,Sheriff,,REP,Ballots Cast,4,53,79,136
Waller,416,Sheriff,,REP,Under Votes,1,0,2,3
Waller,416,Sheriff,,REP,Over Votes,0,0,0,0
Waller,416,County Tax Assessor-Collector,,REP,Ellen Contreras Shelburne,2,30,56,88
Waller,416,County Tax Assessor-Collector,,REP,Carolyn Miedke,2,19,22,43
Waller,416,County Tax Assessor-Collector,,REP,Ballots Cast,4,49,78,131
Waller,416,County Tax Assessor-Collector,,REP,Under Votes,1,4,3,8
Waller,416,County Tax Assessor-Collector,,REP,Over Votes,0,0,0,0
Waller,416,"Constable, Precinct 4",,REP,Joe Trimm Jr,3,49,74,126
Waller,416,"Constable, Precinct 4",,REP,Ballots Cast,3,49,74,126
Waller,416,"Constable, Precinct 4",,REP,Under Votes,2,4,7,13
Waller,416,"Constable, Precinct 4",,REP,Over Votes,0,0,0,0
Waller,416,County Chairman,,REP,David W. Luther,3,46,72,121
Waller,416,County Chairman,,REP,Ballots Cast,3,46,72,121
Waller,416,County Chairman,,REP,Under Votes,2,7,9,18
Waller,416,County Chairman,,REP,Over Votes,0,0,0,0
Waller,416,Proposition #1,,DEM,Yes,13,34,65,112
Waller,416,Proposition #1,,DEM,No,0,2,4,6
Waller,416,Proposition #1,,DEM,Ballots Cast,13,36,69,118
Waller,416,Proposition #1,,DEM,Under Votes,1,3,2,6
Waller,416,Proposition #1,,DEM,Over Votes,0,0,0,0
Waller,416,Proposition #2,,DEM,Yes,13,35,67,115
Waller,416,Proposition #2,,DEM,No,0,3,3,6
Waller,416,Proposition #2,,DEM,Ballots Cast,13,38,70,121
Waller,416,Proposition #2,,DEM,Under Votes,1,1,1,3
Waller,416,Proposition #2,,DEM,Over Votes,0,0,0,0
Waller,416,Proposition #3,,DEM,Yes,14,36,67,117
Waller,416,Proposition #3,,DEM,No,0,1,3,4
Waller,416,Proposition #3,,DEM,Ballots Cast,14,37,70,121
Waller,416,Proposition #3,,DEM,Under Votes,0,2,1,3
Waller,416,Proposition #3,,DEM,Over Votes,0,0,0,0
Waller,416,Proposition #4,,DEM,Yes,12,34,67,113
Waller,416,Proposition #4,,DEM,No,2,2,3,7
Waller,416,Proposition #4,,DEM,Ballots Cast,14,36,70,120
Waller,416,Proposition #4,,DEM,Under Votes,0,3,1,4
Waller,416,Proposition #4,,DEM,Over Votes,0,0,0,0
Waller,416,Proposition #5,,DEM,Yes,14,36,66,116
Waller,416,Proposition #5,,DEM,No,0,1,3,4
Waller,416,Proposition #5,,DEM,Ballots Cast,14,37,69,120
Waller,416,Proposition #5,,DEM,Under Votes,0,2,2,4
Waller,416,Proposition #5,,DEM,Over Votes,0,0,0,0
Waller,416,Proposition #6,,DEM,Yes,14,36,68,118
Waller,416,Proposition #6,,DEM,No,0,1,2,3
Waller,416,Proposition #6,,DEM,Ballots Cast,14,37,70,121
Waller,416,Proposition #6,,DEM,Under Votes,0,2,1,3
Waller,416,Proposition #6,,DEM,Over Votes,0,0,0,0
Waller,416,Proposition #7,,DEM,Yes,14,37,65,116
Waller,416,Proposition #7,,DEM,No,0,1,5,6
Waller,416,Proposition #7,,DEM,Ballots Cast,14,38,70,122
Waller,416,Proposition #7,,DEM,Under Votes,0,1,1,2
Waller,416,Proposition #7,,DEM,Over Votes,0,0,0,0
Waller,416,Proposition #8,,DEM,Yes,14,35,66,115
Waller,416,Proposition #8,,DEM,No,0,2,3,5
Waller,416,Proposition #8,,DEM,Ballots Cast,14,37,69,120
Waller,416,Proposition #8,,DEM,Under Votes,0,2,2,4
Waller,416,Proposition #8,,DEM,Over Votes,0,0,0,0
Waller,416,Proposition #9,,DEM,Yes,14,35,68,117
Waller,416,Proposition #9,,DEM,No,0,1,2,3
Waller,416,Proposition #9,,DEM,Ballots Cast,14,36,70,120
Waller,416,Proposition #9,,DEM,Under Votes,0,3,1,4
Waller,416,Proposition #9,,DEM,Over Votes,0,0,0,0
Waller,416,Proposition #10,,DEM,Yes,14,33,65,112
Waller,416,Proposition #10,,DEM,No,0,3,5,8
Waller,416,Proposition #10,,DEM,Ballots Cast,14,36,70,120
Waller,416,Proposition #10,,DEM,Under Votes,0,3,1,4
Waller,416,Proposition #10,,DEM,Over Votes,0,0,0,0
Waller,416,Proposition #11,,DEM,Yes,14,33,60,107
Waller,416,Proposition #11,,DEM,No,0,3,8,11
Waller,416,Proposition #11,,DEM,Ballots Cast,14,36,68,118
Waller,416,Proposition #11,,DEM,Under Votes,0,3,3,6
Waller,416,Proposition #11,,DEM,Over Votes,0,0,0,0
Waller,416,Proposition 1,,REP,Yes,4,45,68,117
Waller,416,Proposition 1,,REP,No,0,8,12,20
Waller,416,Proposition 1,,REP,Ballots Cast,4,53,80,137
Waller,416,Proposition 1,,REP,Under Votes,1,0,1,2
Waller,416,Proposition 1,,REP,Over Votes,0,0,0,0
Waller,416,Proposition 2,,REP,Yes,2,47,71,120
Waller,416,Proposition 2,,REP,No,1,3,10,14
Waller,416,Proposition 2,,REP,Ballots Cast,3,50,81,134
Waller,416,Proposition 2,,REP,Under Votes,1,3,0,4
Waller,416,Proposition 2,,REP,Over Votes,1,0,0,1
Waller,416,Proposition 3,,REP,Yes,4,49,79,132
Waller,416,Proposition 3,,REP,No,0,4,2,6
Waller,416,Proposition 3,,REP,Ballots Cast,4,53,81,138
Waller,416,Proposition 3,,REP,Under Votes,1,0,0,1
Waller,416,Proposition 3,,REP,Over Votes,0,0,0,0
Waller,416,Proposition 4,,REP,Yes,3,48,79,130
Waller,416,Proposition 4,,REP,No,1,4,1,6
Waller,416,Proposition 4,,REP,Ballots Cast,4,52,80,136
Waller,416,Proposition 4,,REP,Under Votes,1,1,1,3
Waller,416,Proposition 4,,REP,Over Votes,0,0,0,0
Waller,416,Proposition 5,,REP,Yes,3,48,77,128
Waller,416,Proposition 5,,REP,No,1,5,3,9
Waller,416,Proposition 5,,REP,Ballots Cast,4,53,80,137
Waller,416,Proposition 5,,REP,Under Votes,1,0,1,2
Waller,416,Proposition 5,,REP,Over Votes,0,0,0,0
Waller,416,Proposition 6,,REP,Yes,5,51,72,128
Waller,416,Proposition 6,,REP,No,0,1,9,10
Waller,416,Proposition 6,,REP,Ballots Cast,5,52,81,138
Waller,416,Proposition 6,,REP,Under Votes,0,1,0,1
Waller,416,Proposition 6,,REP,Over Votes,0,0,0,0
Waller,416,Proposition 7,,REP,Yes,5,52,81,138
Waller,416,Proposition 7,,REP,No,0,1,0,1
Waller,416,Proposition 7,,REP,Ballots Cast,5,53,81,139
Waller,416,Proposition 7,,REP,Under Votes,0,0,0,0
Waller,416,Proposition 7,,REP,Over Votes,0,0,0,0
Waller,416,Proposition 8,,REP,Yes,5,50,80,135
Waller,416,Proposition 8,,REP,No,0,2,1,3
Waller,416,Proposition 8,,REP,Ballots Cast,5,52,81,138
Waller,416,Proposition 8,,REP,Under Votes,0,1,0,1
Waller,416,Proposition 8,,REP,Over Votes,0,0,0,0
Waller,416,Proposition 9,,REP,Yes,5,50,78,133
Waller,416,Proposition 9,,REP,No,0,2,3,5
Waller,416,Proposition 9,,REP,Ballots Cast,5,52,81,138
Waller,416,Proposition 9,,REP,Under Votes,0,1,0,1
Waller,416,Proposition 9,,REP,Over Votes,0,0,0,0
Waller,416,Proposition 10,,REP,Yes,5,46,70,121
Waller,416,Proposition 10,,REP,No,0,7,9,16
Waller,416,Proposition 10,,REP,Ballots Cast,5,53,79,137
Waller,416,Proposition 10,,REP,Under Votes,0,0,2,2
Waller,416,Proposition 10,,REP,Over Votes,0,0,0,0
Waller,417,President,,DEM,Michael Bennet,1,0,1,2
Waller,417,President,,DEM,Marianne Williamson,0,0,0,0
Waller,417,President,,DEM,Cory Booker,0,1,0,1
Waller,417,President,,DEM,Bernie Sanders,2,7,15,24
Waller,417,President,,DEM,Tulsi Gabbard,0,0,0,0
Waller,417,President,,DEM,Deval Patrick,0,0,0,0
Waller,417,President,,DEM,Amy Klobuchar,1,1,0,2
Waller,417,President,,DEM,Julián Castro,0,0,1,1
Waller,417,President,,DEM,Elizabeth Warren,0,1,1,2
Waller,417,President,,DEM,John K. Delaney,0,0,0,0
Waller,417,President,,DEM,Robby Wells,0,0,0,0
Waller,417,President,,DEM,"Roque ""Rocky"" De La Fuente",0,0,0,0
Waller,417,President,,DEM,Andrew Yang,0,0,0,0
Waller,417,President,,DEM,Joseph R. Biden,5,9,46,60
Waller,417,President,,DEM,Michael R. Bloomberg,6,8,13,27
Waller,417,President,,DEM,Tom Steyer,0,0,0,0
Waller,417,President,,DEM,Pete Buttigieg,0,2,0,2
Waller,417,President,,DEM,Ballots Cast,15,29,77,121
Waller,417,President,,DEM,Under Votes,0,1,0,1
Waller,417,President,,DEM,Over Votes,0,0,0,0
Waller,417,U.S. Senate,,DEM,Royce West,1,5,17,23
Waller,417,U.S. Senate,,DEM,"Annie ""Mamá"" Garcia",1,3,4,8
Waller,417,U.S. Senate,,DEM,D. R. Hunter,0,2,0,2
Waller,417,U.S. Senate,,DEM,Sema Hernandez,0,1,5,6
Waller,417,U.S. Senate,,DEM,Adrian Ocegueda,0,0,2,2
Waller,417,U.S. Senate,,DEM,Chris Bell,6,8,14,28
Waller,417,U.S. Senate,,DEM,Cristina Tzintzun Ramirez,0,3,4,7
Waller,417,U.S. Senate,,DEM,Jack Daniel Foster Jr,0,1,6,7
Waller,417,U.S. Senate,,DEM,Amanda K. Edwards,5,2,7,14
Waller,417,U.S. Senate,,DEM,Victor Hugo Harris,0,0,1,1
Waller,417,U.S. Senate,,DEM,"Mary ""MJ"" Hegar",1,3,1,5
Waller,417,U.S. Senate,,DEM,Michael Cooper,0,1,5,6
Waller,417,U.S. Senate,,DEM,Ballots Cast,14,29,66,109
Waller,417,U.S. Senate,,DEM,Under Votes,1,1,11,13
Waller,417,U.S. Senate,,DEM,Over Votes,0,0,0,0
Waller,417,U.S. House,10,DEM,Mike Siegel,8,12,32,52
Waller,417,U.S. House,10,DEM,Shannon Hutcheson,6,11,19,36
Waller,417,U.S. House,10,DEM,Pritesh Gandhi,0,5,14,19
Waller,417,U.S. House,10,DEM,Ballots Cast,14,28,65,107
Waller,417,U.S. House,10,DEM,Under Votes,1,2,12,15
Waller,417,U.S. House,10,DEM,Over Votes,0,0,0,0
Waller,417,Railroad Commissioner,,DEM,"Roberto R. ""Beto"" Alonzo",5,3,22,30
Waller,417,Railroad Commissioner,,DEM,Chrysta Castañeda,3,7,9,19
Waller,417,Railroad Commissioner,,DEM,Mark Watson,3,7,13,23
Waller,417,Railroad Commissioner,,DEM,Kelly Stone,3,8,19,30
Waller,417,Railroad Commissioner,,DEM,Ballots Cast,14,25,63,102
Waller,417,Railroad Commissioner,,DEM,Under Votes,1,5,14,20
Waller,417,Railroad Commissioner,,DEM,Over Votes,0,0,0,0
Waller,417,"Chief Justice, Supreme Court",,DEM,Jerry Zimmerer,0,7,19,26
Waller,417,"Chief Justice, Supreme Court",,DEM,Amy Clark Meachum,13,17,49,79
Waller,417,"Chief Justice, Supreme Court",,DEM,Ballots Cast,13,24,68,105
Waller,417,"Chief Justice, Supreme Court",,DEM,Under Votes,2,6,9,17
Waller,417,"Chief Justice, Supreme Court",,DEM,Over Votes,0,0,0,0
Waller,417,"Justice, Supreme Court, Place 6 Unexpired Term",,DEM,Kathy Cheng,10,16,44,70
Waller,417,"Justice, Supreme Court, Place 6 Unexpired Term",,DEM,Larry Praeger,4,9,20,33
Waller,417,"Justice, Supreme Court, Place 6 Unexpired Term",,DEM,Ballots Cast,14,25,64,103
Waller,417,"Justice, Supreme Court, Place 6 Unexpired Term",,DEM,Under Votes,1,5,13,19
Waller,417,"Justice, Supreme Court, Place 6 Unexpired Term",,DEM,Over Votes,0,0,0,0
Waller,417,"Justice, Supreme Court, Place 7",,DEM,Staci Williams,11,18,48,77
Waller,417,"Justice, Supreme Court, Place 7",,DEM,Brandy Voss,3,7,16,26
Waller,417,"Justice, Supreme Court, Place 7",,DEM,Ballots Cast,14,25,64,103
Waller,417,"Justice, Supreme Court, Place 7",,DEM,Under Votes,1,5,13,19
Waller,417,"Justice, Supreme Court, Place 7",,DEM,Over Votes,0,0,0,0
Waller,417,"Justice, Supreme Court, Place 8",,DEM,Gisela D. Triana,8,14,33,55
Waller,417,"Justice, Supreme Court, Place 8",,DEM,Peter Kelly,6,11,29,46
Waller,417,"Justice, Supreme Court, Place 8",,DEM,Ballots Cast,14,25,62,101
Waller,417,"Justice, Supreme Court, Place 8",,DEM,Under Votes,1,5,15,21
Waller,417,"Justice, Supreme Court, Place 8",,DEM,Over Votes,0,0,0,0
Waller,417,"Judge, Court of Criminal Appeals, Place 3",,DEM,Elizabeth Davis Frizell,8,16,37,61
Waller,417,"Judge, Court of Criminal Appeals, Place 3",,DEM,William Pieratt Demond,3,4,11,18
Waller,417,"Judge, Court of Criminal Appeals, Place 3",,DEM,Dan Wood,3,5,16,24
Waller,417,"Judge, Court of Criminal Appeals, Place 3",,DEM,Ballots Cast,14,25,64,103
Waller,417,"Judge, Court of Criminal Appeals, Place 3",,DEM,Under Votes,1,5,13,19
Waller,417,"Judge, Court of Criminal Appeals, Place 3",,DEM,Over Votes,0,0,0,0
Waller,417,"Judge, Court of Criminal Appeals, Place 4",,DEM,Steven Miears,2,7,13,22
Waller,417,"Judge, Court of Criminal Appeals, Place 4",,DEM,Tina Clinton,12,17,50,79
Waller,417,"Judge, Court of Criminal Appeals, Place 4",,DEM,Ballots Cast,14,24,63,101
Waller,417,"Judge, Court of Criminal Appeals, Place 4",,DEM,Under Votes,1,6,14,21
Waller,417,"Judge, Court of Criminal Appeals, Place 4",,DEM,Over Votes,0,0,0,0
Waller,417,"Judge, Court of Criminal Appeals, Place 9",,DEM,Brandon Birmingham,12,21,52,85
Waller,417,"Judge, Court of Criminal Appeals, Place 9",,DEM,Ballots Cast,12,21,52,85
Waller,417,"Judge, Court of Criminal Appeals, Place 9",,DEM,Under Votes,3,9,25,37
Waller,417,"Judge, Court of Criminal Appeals, Place 9",,DEM,Over Votes,0,0,0,0
Waller,417,"Member, State Board of Education, District 10",,DEM,Stephen Wyman,2,7,17,26
Waller,417,"Member, State Board of Education, District 10",,DEM,Marsha Burnett-Webster,13,16,43,72
Waller,417,"Member, State Board of Education, District 10",,DEM,Ballots Cast,15,23,60,98
Waller,417,"Member, State Board of Education, District 10",,DEM,Under Votes,0,7,17,24
Waller,417,"Member, State Board of Education, District 10",,DEM,Over Votes,0,0,0,0
Waller,417,State Senate,18,DEM,Michael Antalan,13,24,52,89
Waller,417,State Senate,18,DEM,Ballots Cast,13,24,52,89
Waller,417,State Senate,18,DEM,Under Votes,2,6,25,33
Waller,417,State Senate,18,DEM,Over Votes,0,0,0,0
Waller,417,State Representative,3,DEM,Martin Shupp,13,23,50,86
Waller,417,State Representative,3,DEM,Ballots Cast,13,23,50,86
Waller,417,State Representative,3,DEM,Under Votes,2,7,27,36
Waller,417,State Representative,3,DEM,Over Votes,0,0,0,0
Waller,417,"Chief Justice, 14th Court of Appeals District",,DEM,Jane Robinson,14,21,50,85
Waller,417,"Chief Justice, 14th Court of Appeals District",,DEM,Jim Evans,1,3,13,17
Waller,417,"Chief Justice, 14th Court of Appeals District",,DEM,Ballots Cast,15,24,63,102
Waller,417,"Chief Justice, 14th Court of Appeals District",,DEM,Under Votes,0,6,14,20
Waller,417,"Chief Justice, 14th Court of Appeals District",,DEM,Over Votes,0,0,0,0
Waller,417,"Justice, 1st Court of Appeals District, Place 3",,DEM,Jim Sharp,5,6,17,28
Waller,417,"Justice, 1st Court of Appeals District, Place 3",,DEM,Dinesh Singhal,2,10,20,32
Waller,417,"Justice, 1st Court of Appeals District, Place 3",,DEM,Veronica Rivas-Molloy,8,8,25,41
Waller,417,"Justice, 1st Court of Appeals District, Place 3",,DEM,Ballots Cast,15,24,62,101
Waller,417,"Justice, 1st Court of Appeals District, Place 3",,DEM,Under Votes,0,6,15,21
Waller,417,"Justice, 1st Court of Appeals District, Place 3",,DEM,Over Votes,0,0,0,0
Waller,417,"Justice, 1st Court of Appeals District, Place 5",,DEM,Tim Hootman,5,9,29,43
Waller,417,"Justice, 1st Court of Appeals District, Place 5",,DEM,Amparo Monique Guerra,10,13,31,54
Waller,417,"Justice, 1st Court of Appeals District, Place 5",,DEM,Ballots Cast,15,22,60,97
Waller,417,"Justice, 1st Court of Appeals District, Place 5",,DEM,Under Votes,0,8,17,25
Waller,417,"Justice, 1st Court of Appeals District, Place 5",,DEM,Over Votes,0,0,0,0
Waller,417,"Justice, 14th Court of Appeals District, Place 7",,DEM,"Tamika ""Tami"" Craft",9,6,30,45
Waller,417,"Justice, 14th Court of Appeals District, Place 7",,DEM,Wally Kronzer,1,5,4,10
Waller,417,"Justice, 14th Court of Appeals District, Place 7",,DEM,V.R. Faulkner,0,2,7,9
Waller,417,"Justice, 14th Court of Appeals District, Place 7",,DEM,Cheri Thomas,4,6,9,19
Waller,417,"Justice, 14th Court of Appeals District, Place 7",,DEM,Dominic J. Merino,0,0,2,2
Waller,417,"Justice, 14th Court of Appeals District, Place 7",,DEM,Lennon C. Wright,1,2,10,13
Waller,417,"Justice, 14th Court of Appeals District, Place 7",,DEM,Ballots Cast,15,21,62,98
Waller,417,"Justice, 14th Court of Appeals District, Place 7",,DEM,Under Votes,0,9,15,24
Waller,417,"Justice, 14th Court of Appeals District, Place 7",,DEM,Over Votes,0,0,0,0
Waller,417,Sheriff,,DEM,Cedric D. Watson,13,22,61,96
Waller,417,Sheriff,,DEM,Ballots Cast,13,22,61,96
Waller,417,Sheriff,,DEM,Under Votes,2,8,16,26
Waller,417,Sheriff,,DEM,Over Votes,0,0,0,0
Waller,417,County Chairman,,DEM,Rosa Patlan Harris,13,22,59,94
Waller,417,County Chairman,,DEM,Ballots Cast,13,22,59,94
Waller,417,County Chairman,,DEM,Under Votes,2,8,18,28
Waller,417,County Chairman,,DEM,Over Votes,0,0,0,0
Waller,417,President,,REP,Donald J. Trump,2,41,42,85
Waller,417,President,,REP,Joe Walsh,0,0,0,0
Waller,417,President,,REP,Bob Ely,0,0,0,0
Waller,417,President,,REP,"Roque ""Rocky"" De La Fuente Guerra",0,0,1,1
Waller,417,President,,REP,Zoltan G. Istvan,0,0,0,0
Waller,417,President,,REP,Matthew John Matern,0,0,0,0
Waller,417,President,,REP,Bill Weld,0,0,0,0
Waller,417,President,,REP,Uncommitted,2,5,5,12
Waller,417,President,,REP,Ballots Cast,4,46,48,98
Waller,417,President,,REP,Under Votes,0,0,0,0
Waller,417,President,,REP,Over Votes,0,0,0,0
Waller,417,U.S. Senate,,REP,Dwayne Stovall,0,13,10,23
Waller,417,U.S. Senate,,REP,Mark Yancey,0,1,2,3
Waller,417,U.S. Senate,,REP,Virgil Bierschwale,0,0,1,1
Waller,417,U.S. Senate,,REP,John Anthony Castro,0,1,5,6
Waller,417,U.S. Senate,,REP,John Cornyn,4,27,26,57
Waller,417,U.S. Senate,,REP,Ballots Cast,4,42,44,90
Waller,417,U.S. Senate,,REP,Under Votes,0,4,4,8
Waller,417,U.S. Senate,,REP,Over Votes,0,0,0,0
Waller,417,U.S. House,10,REP,Michael McCaul,4,43,43,90
Waller,417,U.S. House,10,REP,Ballots Cast,4,43,43,90
Waller,417,U.S. House,10,REP,Under Votes,0,3,5,8
Waller,417,U.S. House,10,REP,Over Votes,0,0,0,0
Waller,417,Railroad Commissioner,,REP,Ryan Sitton,2,27,20,49
Waller,417,Railroad Commissioner,,REP,"James ""Jim"" Wright",2,14,19,35
Waller,417,Railroad Commissioner,,REP,Ballots Cast,4,41,39,84
Waller,417,Railroad Commissioner,,REP,Under Votes,0,5,9,14
Waller,417,Railroad Commissioner,,REP,Over Votes,0,0,0,0
Waller,417,"Chief Justice, Supreme Court",,REP,Nathan Hecht,4,40,36,80
Waller,417,"Chief Justice, Supreme Court",,REP,Ballots Cast,4,40,36,80
Waller,417,"Chief Justice, Supreme Court",,REP,Under Votes,0,6,12,18
Waller,417,"Chief Justice, Supreme Court",,REP,Over Votes,0,0,0,0
Waller,417,"Justice, Supreme Court, Place 6 Unexpired Term",,REP,Jane Bland,4,37,36,77
Waller,417,"Justice, Supreme Court, Place 6 Unexpired Term",,REP,Ballots Cast,4,37,36,77
Waller,417,"Justice, Supreme Court, Place 6 Unexpired Term",,REP,Under Votes,0,9,12,21
Waller,417,"Justice, Supreme Court, Place 6 Unexpired Term",,REP,Over Votes,0,0,0,0
Waller,417,"Justice, Supreme Court, Place 7",,REP,Jeff Boyd,4,38,35,77
Waller,417,"Justice, Supreme Court, Place 7",,REP,Ballots Cast,4,38,35,77
Waller,417,"Justice, Supreme Court, Place 7",,REP,Under Votes,0,8,13,21
Waller,417,"Justice, Supreme Court, Place 7",,REP,Over Votes,0,0,0,0
Waller,417,"Justice, Supreme Court, Place 8",,REP,Brett Busby,4,38,34,76
Waller,417,"Justice, Supreme Court, Place 8",,REP,Ballots Cast,4,38,34,76
Waller,417,"Justice, Supreme Court, Place 8",,REP,Under Votes,0,8,14,22
Waller,417,"Justice, Supreme Court, Place 8",,REP,Over Votes,0,0,0,0
Waller,417,"Judge, Court of Criminal Appeals, Place 3",,REP,Gina Parker,2,18,20,40
Waller,417,"Judge, Court of Criminal Appeals, Place 3",,REP,Bert Richardson,2,18,16,36
Waller,417,"Judge, Court of Criminal Appeals, Place 3",,REP,Ballots Cast,4,36,36,76
Waller,417,"Judge, Court of Criminal Appeals, Place 3",,REP,Under Votes,0,10,12,22
Waller,417,"Judge, Court of Criminal Appeals, Place 3",,REP,Over Votes,0,0,0,0
Waller,417,"Judge, Court of Criminal Appeals, Place 4",,REP,Kevin Patrick Yeary,4,35,33,72
Waller,417,"Judge, Court of Criminal Appeals, Place 4",,REP,Ballots Cast,4,35,33,72
Waller,417,"Judge, Court of Criminal Appeals, Place 4",,REP,Under Votes,0,11,15,26
Waller,417,"Judge, Court of Criminal Appeals, Place 4",,REP,Over Votes,0,0,0,0
Waller,417,"Judge, Court of Criminal Appeals, Place 9",,REP,David Newell,4,36,33,73
Waller,417,"Judge, Court of Criminal Appeals, Place 9",,REP,Ballots Cast,4,36,33,73
Waller,417,"Judge, Court of Criminal Appeals, Place 9",,REP,Under Votes,0,10,15,25
Waller,417,"Judge, Court of Criminal Appeals, Place 9",,REP,Over Votes,0,0,0,0
Waller,417,"Member, State Board of Education, District 10",,REP,Tom Maynard,4,36,34,74
Waller,417,"Member, State Board of Education, District 10",,REP,Ballots Cast,4,36,34,74
Waller,417,"Member, State Board of Education, District 10",,REP,Under Votes,0,10,14,24
Waller,417,"Member, State Board of Education, District 10",,REP,Over Votes,0,0,0,0
Waller,417,State Senate,18,REP,Lois W. Kolkhorst,4,38,36,78
Waller,417,State Senate,18,REP,Ballots Cast,4,38,36,78
Waller,417,State Senate,18,REP,Under Votes,0,8,12,20
Waller,417,State Senate,18,REP,Over Votes,0,0,0,0
Waller,417,State Representative,3,REP,Cecil Bell Jr,4,38,38,80
Waller,417,State Representative,3,REP,Ballots Cast,4,38,38,80
Waller,417,State Representative,3,REP,Under Votes,0,8,10,18
Waller,417,State Representative,3,REP,Over Votes,0,0,0,0
Waller,417,"Chief Justice, 14th Court of Appeals District",,REP,Tracy Elizabeth Christopher,4,36,34,74
Waller,417,"Chief Justice, 14th Court of Appeals District",,REP,Ballots Cast,4,36,34,74
Waller,417,"Chief Justice, 14th Court of Appeals District",,REP,Under Votes,0,10,14,24
Waller,417,"Chief Justice, 14th Court of Appeals District",,REP,Over Votes,0,0,0,0
Waller,417,"Justice, 1st Court of Appeals District, Place 3",,REP,Russell Lloyd,4,35,34,73
Waller,417,"Justice, 1st Court of Appeals District, Place 3",,REP,Ballots Cast,4,35,34,73
Waller,417,"Justice, 1st Court of Appeals District, Place 3",,REP,Under Votes,0,11,14,25
Waller,417,"Justice, 1st Court of Appeals District, Place 3",,REP,Over Votes,0,0,0,0
Waller,417,"Justice, 1st Court of Appeals District, Place 5",,REP,Chad Bridges,2,11,14,27
Waller,417,"Justice, 1st Court of Appeals District, Place 5",,REP,James Lombardino,0,4,8,12
Waller,417,"Justice, 1st Court of Appeals District, Place 5",,REP,Levi J. Benton,0,5,5,10
Waller,417,"Justice, 1st Court of Appeals District, Place 5",,REP,Terry Adams,2,10,12,24
Waller,417,"Justice, 1st Court of Appeals District, Place 5",,REP,Ballots Cast,4,30,39,73
Waller,417,"Justice, 1st Court of Appeals District, Place 5",,REP,Under Votes,0,16,9,25
Waller,417,"Justice, 1st Court of Appeals District, Place 5",,REP,Over Votes,0,0,0,0
Waller,417,"Justice, 14th Court of Appeals District, Place 7",,REP,Ken Wise,4,36,33,73
Waller,417,"Justice, 14th Court of Appeals District, Place 7",,REP,Ballots Cast,4,36,33,73
Waller,417,"Justice, 14th Court of Appeals District, Place 7",,REP,Under Votes,0,10,15,25
Waller,417,"Justice, 14th Court of Appeals District, Place 7",,REP,Over Votes,0,0,0,0
Waller,417,"District Judge, 506th Judicial District",,REP,Gary W. Chaney,4,38,35,77
Waller,417,"District Judge, 506th Judicial District",,REP,Ballots Cast,4,38,35,77
Waller,417,"District Judge, 506th Judicial District",,REP,Under Votes,0,8,13,21
Waller,417,"District Judge, 506th Judicial District",,REP,Over Votes,0,0,0,0
Waller,417,Sheriff,,REP,Dan Porter,0,13,8,21
Waller,417,Sheriff,,REP,R. Glenn Smith,1,20,22,43
Waller,417,Sheriff,,REP,Troy Guidry,3,12,13,28
Waller,417,Sheriff,,REP,Ballots Cast,4,45,43,92
Waller,417,Sheriff,,REP,Under Votes,0,1,5,6
Waller,417,Sheriff,,REP,Over Votes,0,0,0,0
Waller,417,County Tax Assessor-Collector,,REP,Ellen Contreras Shelburne,2,26,25,53
Waller,417,County Tax Assessor-Collector,,REP,Carolyn Miedke,2,12,18,32
Waller,417,County Tax Assessor-Collector,,REP,Ballots Cast,4,38,43,85
Waller,417,County Tax Assessor-Collector,,REP,Under Votes,0,8,5,13
Waller,417,County Tax Assessor-Collector,,REP,Over Votes,0,0,0,0
Waller,417,"Constable, Precinct 4",,REP,Joe Trimm Jr,4,39,40,83
Waller,417,"Constable, Precinct 4",,REP,Ballots Cast,4,39,40,83
Waller,417,"Constable, Precinct 4",,REP,Under Votes,0,7,8,15
Waller,417,"Constable, Precinct 4",,REP,Over Votes,0,0,0,0
Waller,417,County Chairman,,REP,David W. Luther,4,36,34,74
Waller,417,County Chairman,,REP,Ballots Cast,4,36,34,74
Waller,417,County Chairman,,REP,Under Votes,0,10,14,24
Waller,417,County Chairman,,REP,Over Votes,0,0,0,0
Waller,417,Proposition #1,,DEM,Yes,15,26,73,114
Waller,417,Proposition #1,,DEM,No,0,0,1,1
Waller,417,Proposition #1,,DEM,Ballots Cast,15,26,74,115
Waller,417,Proposition #1,,DEM,Under Votes,0,4,3,7
Waller,417,Proposition #1,,DEM,Over Votes,0,0,0,0
Waller,417,Proposition #2,,DEM,Yes,15,23,72,110
Waller,417,Proposition #2,,DEM,No,0,2,0,2
Waller,417,Proposition #2,,DEM,Ballots Cast,15,25,72,112
Waller,417,Proposition #2,,DEM,Under Votes,0,5,5,10
Waller,417,Proposition #2,,DEM,Over Votes,0,0,0,0
Waller,417,Proposition #3,,DEM,Yes,14,26,73,113
Waller,417,Proposition #3,,DEM,No,0,0,0,0
Waller,417,Proposition #3,,DEM,Ballots Cast,14,26,73,113
Waller,417,Proposition #3,,DEM,Under Votes,1,4,4,9
Waller,417,Proposition #3,,DEM,Over Votes,0,0,0,0
Waller,417,Proposition #4,,DEM,Yes,15,24,72,111
Waller,417,Proposition #4,,DEM,No,0,1,0,1
Waller,417,Proposition #4,,DEM,Ballots Cast,15,25,72,112
Waller,417,Proposition #4,,DEM,Under Votes,0,5,5,10
Waller,417,Proposition #4,,DEM,Over Votes,0,0,0,0
Waller,417,Proposition #5,,DEM,Yes,15,25,72,112
Waller,417,Proposition #5,,DEM,No,0,0,2,2
Waller,417,Proposition #5,,DEM,Ballots Cast,15,25,74,114
Waller,417,Proposition #5,,DEM,Under Votes,0,5,3,8
Waller,417,Proposition #5,,DEM,Over Votes,0,0,0,0
Waller,417,Proposition #6,,DEM,Yes,15,24,71,110
Waller,417,Proposition #6,,DEM,No,0,0,0,0
Waller,417,Proposition #6,,DEM,Ballots Cast,15,24,71,110
Waller,417,Proposition #6,,DEM,Under Votes,0,6,6,12
Waller,417,Proposition #6,,DEM,Over Votes,0,0,0,0
Waller,417,Proposition #7,,DEM,Yes,15,23,71,109
Waller,417,Proposition #7,,DEM,No,0,2,1,3
Waller,417,Proposition #7,,DEM,Ballots Cast,15,25,72,112
Waller,417,Proposition #7,,DEM,Under Votes,0,5,5,10
Waller,417,Proposition #7,,DEM,Over Votes,0,0,0,0
Waller,417,Proposition #8,,DEM,Yes,15,24,71,110
Waller,417,Proposition #8,,DEM,No,0,1,1,2
Waller,417,Proposition #8,,DEM,Ballots Cast,15,25,72,112
Waller,417,Proposition #8,,DEM,Under Votes,0,5,5,10
Waller,417,Proposition #8,,DEM,Over Votes,0,0,0,0
Waller,417,Proposition #9,,DEM,Yes,15,24,72,111
Waller,417,Proposition #9,,DEM,No,0,1,1,2
Waller,417,Proposition #9,,DEM,Ballots Cast,15,25,73,113
Waller,417,Proposition #9,,DEM,Under Votes,0,5,4,9
Waller,417,Proposition #9,,DEM,Over Votes,0,0,0,0
Waller,417,Proposition #10,,DEM,Yes,14,21,71,106
Waller,417,Proposition #10,,DEM,No,0,4,1,5
Waller,417,Proposition #10,,DEM,Ballots Cast,14,25,72,111
Waller,417,Proposition #10,,DEM,Under Votes,1,5,5,11
Waller,417,Proposition #10,,DEM,Over Votes,0,0,0,0
Waller,417,Proposition #11,,DEM,Yes,13,21,63,97
Waller,417,Proposition #11,,DEM,No,2,4,9,15
Waller,417,Proposition #11,,DEM,Ballots Cast,15,25,72,112
Waller,417,Proposition #11,,DEM,Under Votes,0,5,5,10
Waller,417,Proposition #11,,DEM,Over Votes,0,0,0,0
Waller,417,Proposition 1,,REP,Yes,2,43,40,85
Waller,417,Proposition 1,,REP,No,2,3,7,12
Waller,417,Proposition 1,,REP,Ballots Cast,4,46,47,97
Waller,417,Proposition 1,,REP,Under Votes,0,0,1,1
Waller,417,Proposition 1,,REP,Over Votes,0,0,0,0
Waller,417,Proposition 2,,REP,Yes,2,40,36,78
Waller,417,Proposition 2,,REP,No,2,5,9,16
Waller,417,Proposition 2,,REP,Ballots Cast,4,45,45,94
Waller,417,Proposition 2,,REP,Under Votes,0,1,3,4
Waller,417,Proposition 2,,REP,Over Votes,0,0,0,0
Waller,417,Proposition 3,,REP,Yes,4,40,45,89
Waller,417,Proposition 3,,REP,No,0,4,1,5
Waller,417,Proposition 3,,REP,Ballots Cast,4,44,46,94
Waller,417,Proposition 3,,REP,Under Votes,0,2,2,4
Waller,417,Proposition 3,,REP,Over Votes,0,0,0,0
Waller,417,Proposition 4,,REP,Yes,4,41,40,85
Waller,417,Proposition 4,,REP,No,0,3,7,10
Waller,417,Proposition 4,,REP,Ballots Cast,4,44,47,95
Waller,417,Proposition 4,,REP,Under Votes,0,2,1,3
Waller,417,Proposition 4,,REP,Over Votes,0,0,0,0
Waller,417,Proposition 5,,REP,Yes,4,41,42,87
Waller,417,Proposition 5,,REP,No,0,2,4,6
Waller,417,Proposition 5,,REP,Ballots Cast,4,43,46,93
Waller,417,Proposition 5,,REP,Under Votes,0,3,2,5
Waller,417,Proposition 5,,REP,Over Votes,0,0,0,0
Waller,417,Proposition 6,,REP,Yes,4,43,40,87
Waller,417,Proposition 6,,REP,No,0,1,6,7
Waller,417,Proposition 6,,REP,Ballots Cast,4,44,46,94
Waller,417,Proposition 6,,REP,Under Votes,0,2,2,4
Waller,417,Proposition 6,,REP,Over Votes,0,0,0,0
Waller,417,Proposition 7,,REP,Yes,4,44,45,93
Waller,417,Proposition 7,,REP,No,0,0,2,2
Waller,417,Proposition 7,,REP,Ballots Cast,4,44,47,95
Waller,417,Proposition 7,,REP,Under Votes,0,2,1,3
Waller,417,Proposition 7,,REP,Over Votes,0,0,0,0
Waller,417,Proposition 8,,REP,Yes,4,42,43,89
Waller,417,Proposition 8,,REP,No,0,2,3,5
Waller,417,Proposition 8,,REP,Ballots Cast,4,44,46,94
Waller,417,Proposition 8,,REP,Under Votes,0,2,2,4
Waller,417,Proposition 8,,REP,Over Votes,0,0,0,0
Waller,417,Proposition 9,,REP,Yes,4,41,44,89
Waller,417,Proposition 9,,REP,No,0,1,1,2
Waller,417,Proposition 9,,REP,Ballots Cast,4,42,45,91
Waller,417,Proposition 9,,REP,Under Votes,0,4,3,7
Waller,417,Proposition 9,,REP,Over Votes,0,0,0,0
Waller,417,Proposition 10,,REP,Yes,2,40,43,85
Waller,417,Proposition 10,,REP,No,2,3,3,8
Waller,417,Proposition 10,,REP,Ballots Cast,4,43,46,93
Waller,417,Proposition 10,,REP,Under Votes,0,3,2,5
Waller,417,Proposition 10,,REP,Over Votes,0,0,0,0
Waller,418,President,,DEM,Michael Bennet,0,0,0,0
Waller,418,President,,DEM,Marianne Williamson,0,0,0,0
Waller,418,President,,DEM,Cory Booker,0,1,0,1
Waller,418,President,,DEM,Bernie Sanders,1,11,21,33
Waller,418,President,,DEM,Tulsi Gabbard,0,0,0,0
Waller,418,President,,DEM,Deval Patrick,0,0,0,0
Waller,418,President,,DEM,Amy Klobuchar,0,2,0,2
Waller,418,President,,DEM,Julián Castro,0,0,0,0
Waller,418,President,,DEM,Elizabeth Warren,0,3,12,15
Waller,418,President,,DEM,John K. Delaney,0,0,0,0
Waller,418,President,,DEM,Robby Wells,0,0,0,0
Waller,418,President,,DEM,"Roque ""Rocky"" De La Fuente",0,0,0,0
Waller,418,President,,DEM,Andrew Yang,0,0,0,0
Waller,418,President,,DEM,Joseph R. Biden,3,7,52,62
Waller,418,President,,DEM,Michael R. Bloomberg,1,9,7,17
Waller,418,President,,DEM,Tom Steyer,0,1,0,1
Waller,418,President,,DEM,Pete Buttigieg,0,2,0,2
Waller,418,President,,DEM,Ballots Cast,5,36,92,133
Waller,418,President,,DEM,Under Votes,0,0,0,0
Waller,418,President,,DEM,Over Votes,0,0,0,0
Waller,418,U.S. Senate,,DEM,Royce West,0,4,4,8
Waller,418,U.S. Senate,,DEM,"Annie ""Mamá"" Garcia",0,6,13,19
Waller,418,U.S. Senate,,DEM,D. R. Hunter,0,1,0,1
Waller,418,U.S. Senate,,DEM,Sema Hernandez,0,1,7,8
Waller,418,U.S. Senate,,DEM,Adrian Ocegueda,0,1,0,1
Waller,418,U.S. Senate,,DEM,Chris Bell,0,9,21,30
Waller,418,U.S. Senate,,DEM,Cristina Tzintzun Ramirez,0,2,6,8
Waller,418,U.S. Senate,,DEM,Jack Daniel Foster Jr,0,0,1,1
Waller,418,U.S. Senate,,DEM,Amanda K. Edwards,0,1,8,9
Waller,418,U.S. Senate,,DEM,Victor Hugo Harris,1,1,1,3
Waller,418,U.S. Senate,,DEM,"Mary ""MJ"" Hegar",4,8,14,26
Waller,418,U.S. Senate,,DEM,Michael Cooper,0,1,3,4
Waller,418,U.S. Senate,,DEM,Ballots Cast,5,35,78,118
Waller,418,U.S. Senate,,DEM,Under Votes,0,1,14,15
Waller,418,U.S. Senate,,DEM,Over Votes,0,0,0,0
Waller,418,U.S. House,10,DEM,Mike Siegel,4,11,25,40
Waller,418,U.S. House,10,DEM,Shannon Hutcheson,1,9,47,57
Waller,418,U.S. House,10,DEM,Pritesh Gandhi,0,14,10,24
Waller,418,U.S. House,10,DEM,Ballots Cast,5,34,82,121
Waller,418,U.S. House,10,DEM,Under Votes,0,2,10,12
Waller,418,U.S. House,10,DEM,Over Votes,0,0,0,0
Waller,418,Railroad Commissioner,,DEM,"Roberto R. ""Beto"" Alonzo",1,10,20,31
Waller,418,Railroad Commissioner,,DEM,Chrysta Castañeda,3,12,20,35
Waller,418,Railroad Commissioner,,DEM,Mark Watson,1,2,20,23
Waller,418,Railroad Commissioner,,DEM,Kelly Stone,0,11,16,27
Waller,418,Railroad Commissioner,,DEM,Ballots Cast,5,35,76,116
Waller,418,Railroad Commissioner,,DEM,Under Votes,0,1,16,17
Waller,418,Railroad Commissioner,,DEM,Over Votes,0,0,0,0
Waller,418,"Chief Justice, Supreme Court",,DEM,Jerry Zimmerer,1,4,20,25
Waller,418,"Chief Justice, Supreme Court",,DEM,Amy Clark Meachum,4,31,62,97
Waller,418,"Chief Justice, Supreme Court",,DEM,Ballots Cast,5,35,82,122
Waller,418,"Chief Justice, Supreme Court",,DEM,Under Votes,0,1,10,11
Waller,418,"Chief Justice, Supreme Court",,DEM,Over Votes,0,0,0,0
Waller,418,"Justice, Supreme Court, Place 6 Unexpired Term",,DEM,Kathy Cheng,0,23,64,87
Waller,418,"Justice, Supreme Court, Place 6 Unexpired Term",,DEM,Larry Praeger,4,12,18,34
Waller,418,"Justice, Supreme Court, Place 6 Unexpired Term",,DEM,Ballots Cast,4,35,82,121
Waller,418,"Justice, Supreme Court, Place 6 Unexpired Term",,DEM,Under Votes,1,1,10,12
Waller,418,"Justice, Supreme Court, Place 6 Unexpired Term",,DEM,Over Votes,0,0,0,0
Waller,418,"Justice, Supreme Court, Place 7",,DEM,Staci Williams,3,27,45,75
Waller,418,"Justice, Supreme Court, Place 7",,DEM,Brandy Voss,1,8,34,43
Waller,418,"Justice, Supreme Court, Place 7",,DEM,Ballots Cast,4,35,79,118
Waller,418,"Justice, Supreme Court, Place 7",,DEM,Under Votes,1,1,13,15
Waller,418,"Justice, Supreme Court, Place 7",,DEM,Over Votes,0,0,0,0
Waller,418,"Justice, Supreme Court, Place 8",,DEM,Gisela D. Triana,2,29,60,91
Waller,418,"Justice, Supreme Court, Place 8",,DEM,Peter Kelly,2,6,20,28
Waller,418,"Justice, Supreme Court, Place 8",,DEM,Ballots Cast,4,35,80,119
Waller,418,"Justice, Supreme Court, Place 8",,DEM,Under Votes,1,1,12,14
Waller,418,"Justice, Supreme Court, Place 8",,DEM,Over Votes,0,0,0,0
Waller,418,"Judge, Court of Criminal Appeals, Place 3",,DEM,Elizabeth Davis Frizell,4,25,60,89
Waller,418,"Judge, Court of Criminal Appeals, Place 3",,DEM,William Pieratt Demond,0,6,8,14
Waller,418,"Judge, Court of Criminal Appeals, Place 3",,DEM,Dan Wood,0,4,13,17
Waller,418,"Judge, Court of Criminal Appeals, Place 3",,DEM,Ballots Cast,4,35,81,120
Waller,418,"Judge, Court of Criminal Appeals, Place 3",,DEM,Under Votes,1,1,11,13
Waller,418,"Judge, Court of Criminal Appeals, Place 3",,DEM,Over Votes,0,0,0,0
Waller,418,"Judge, Court of Criminal Appeals, Place 4",,DEM,Steven Miears,0,4,19,23
Waller,418,"Judge, Court of Criminal Appeals, Place 4",,DEM,Tina Clinton,4,31,61,96
Waller,418,"Judge, Court of Criminal Appeals, Place 4",,DEM,Ballots Cast,4,35,80,119
Waller,418,"Judge, Court of Criminal Appeals, Place 4",,DEM,Under Votes,1,1,12,14
Waller,418,"Judge, Court of Criminal Appeals, Place 4",,DEM,Over Votes,0,0,0,0
Waller,418,"Judge, Court of Criminal Appeals, Place 9",,DEM,Brandon Birmingham,4,33,76,113
Waller,418,"Judge, Court of Criminal Appeals, Place 9",,DEM,Ballots Cast,4,33,76,113
Waller,418,"Judge, Court of Criminal Appeals, Place 9",,DEM,Under Votes,1,3,16,20
Waller,418,"Judge, Court of Criminal Appeals, Place 9",,DEM,Over Votes,0,0,0,0
Waller,418,"Member, State Board of Education, District 10",,DEM,Stephen Wyman,1,2,14,17
Waller,418,"Member, State Board of Education, District 10",,DEM,Marsha Burnett-Webster,3,33,63,99
Waller,418,"Member, State Board of Education, District 10",,DEM,Ballots Cast,4,35,77,116
Waller,418,"Member, State Board of Education, District 10",,DEM,Under Votes,1,1,15,17
Waller,418,"Member, State Board of Education, District 10",,DEM,Over Votes,0,0,0,0
Waller,418,State Senate,18,DEM,Michael Antalan,4,33,72,109
Waller,418,State Senate,18,DEM,Ballots Cast,4,33,72,109
Waller,418,State Senate,18,DEM,Under Votes,1,3,20,24
Waller,418,State Senate,18,DEM,Over Votes,0,0,0,0
Waller,418,State Representative,3,DEM,Martin Shupp,4,33,71,108
Waller,418,State Representative,3,DEM,Ballots Cast,4,33,71,108
Waller,418,State Representative,3,DEM,Under Votes,1,3,21,25
Waller,418,State Representative,3,DEM,Over Votes,0,0,0,0
Waller,418,"Chief Justice, 14th Court of Appeals District",,DEM,Jane Robinson,4,27,58,89
Waller,418,"Chief Justice, 14th Court of Appeals District",,DEM,Jim Evans,0,8,17,25
Waller,418,"Chief Justice, 14th Court of Appeals District",,DEM,Ballots Cast,4,35,75,114
Waller,418,"Chief Justice, 14th Court of Appeals District",,DEM,Under Votes,1,1,17,19
Waller,418,"Chief Justice, 14th Court of Appeals District",,DEM,Over Votes,0,0,0,0
Waller,418,"Justice, 1st Court of Appeals District, Place 3",,DEM,Jim Sharp,1,7,19,27
Waller,418,"Justice, 1st Court of Appeals District, Place 3",,DEM,Dinesh Singhal,1,13,14,28
Waller,418,"Justice, 1st Court of Appeals District, Place 3",,DEM,Veronica Rivas-Molloy,2,15,47,64
Waller,418,"Justice, 1st Court of Appeals District, Place 3",,DEM,Ballots Cast,4,35,80,119
Waller,418,"Justice, 1st Court of Appeals District, Place 3",,DEM,Under Votes,1,1,12,14
Waller,418,"Justice, 1st Court of Appeals District, Place 3",,DEM,Over Votes,0,0,0,0
Waller,418,"Justice, 1st Court of Appeals District, Place 5",,DEM,Tim Hootman,1,13,30,44
Waller,418,"Justice, 1st Court of Appeals District, Place 5",,DEM,Amparo Monique Guerra,3,21,46,70
Waller,418,"Justice, 1st Court of Appeals District, Place 5",,DEM,Ballots Cast,4,34,76,114
Waller,418,"Justice, 1st Court of Appeals District, Place 5",,DEM,Under Votes,1,2,16,19
Waller,418,"Justice, 1st Court of Appeals District, Place 5",,DEM,Over Votes,0,0,0,0
Waller,418,"Justice, 14th Court of Appeals District, Place 7",,DEM,"Tamika ""Tami"" Craft",0,15,33,48
Waller,418,"Justice, 14th Court of Appeals District, Place 7",,DEM,Wally Kronzer,3,8,3,14
Waller,418,"Justice, 14th Court of Appeals District, Place 7",,DEM,V.R. Faulkner,0,1,1,2
Waller,418,"Justice, 14th Court of Appeals District, Place 7",,DEM,Cheri Thomas,0,8,24,32
Waller,418,"Justice, 14th Court of Appeals District, Place 7",,DEM,Dominic J. Merino,0,2,4,6
Waller,418,"Justice, 14th Court of Appeals District, Place 7",,DEM,Lennon C. Wright,1,1,10,12
Waller,418,"Justice, 14th Court of Appeals District, Place 7",,DEM,Ballots Cast,4,35,75,114
Waller,418,"Justice, 14th Court of Appeals District, Place 7",,DEM,Under Votes,1,1,17,19
Waller,418,"Justice, 14th Court of Appeals District, Place 7",,DEM,Over Votes,0,0,0,0
Waller,418,Sheriff,,DEM,Cedric D. Watson,4,33,75,112
Waller,418,Sheriff,,DEM,Ballots Cast,4,33,75,112
Waller,418,Sheriff,,DEM,Under Votes,1,3,17,21
Waller,418,Sheriff,,DEM,Over Votes,0,0,0,0
Waller,418,County Chairman,,DEM,Rosa Patlan Harris,4,34,74,112
Waller,418,County Chairman,,DEM,Ballots Cast,4,34,74,112
Waller,418,County Chairman,,DEM,Under Votes,1,2,18,21
Waller,418,County Chairman,,DEM,Over Votes,0,0,0,0
Waller,418,President,,REP,Donald J. Trump,18,151,239,408
Waller,418,President,,REP,Joe Walsh,0,2,1,3
Waller,418,President,,REP,Bob Ely,0,0,0,0
Waller,418,President,,REP,"Roque ""Rocky"" De La Fuente Guerra",0,0,0,0
Waller,418,President,,REP,Zoltan G. Istvan,0,0,0,0
Waller,418,President,,REP,Matthew John Matern,0,0,0,0
Waller,418,President,,REP,Bill Weld,0,0,1,1
Waller,418,President,,REP,Uncommitted,1,8,4,13
Waller,418,President,,REP,Ballots Cast,19,161,245,425
Waller,418,President,,REP,Under Votes,0,0,0,0
Waller,418,President,,REP,Over Votes,0,0,0,0
Waller,418,U.S. Senate,,REP,Dwayne Stovall,0,33,62,95
Waller,418,U.S. Senate,,REP,Mark Yancey,2,12,16,30
Waller,418,U.S. Senate,,REP,Virgil Bierschwale,0,0,2,2
Waller,418,U.S. Senate,,REP,John Anthony Castro,0,2,16,18
Waller,418,U.S. Senate,,REP,John Cornyn,17,110,138,265
Waller,418,U.S. Senate,,REP,Ballots Cast,19,157,234,410
Waller,418,U.S. Senate,,REP,Under Votes,0,4,11,15
Waller,418,U.S. Senate,,REP,Over Votes,0,0,0,0
Waller,418,U.S. House,10,REP,Michael McCaul,18,154,233,405
Waller,418,U.S. House,10,REP,Ballots Cast,18,154,233,405
Waller,418,U.S. House,10,REP,Under Votes,1,7,12,20
Waller,418,U.S. House,10,REP,Over Votes,0,0,0,0
Waller,418,Railroad Commissioner,,REP,Ryan Sitton,7,75,117,199
Waller,418,Railroad Commissioner,,REP,"James ""Jim"" Wright",11,69,96,176
Waller,418,Railroad Commissioner,,REP,Ballots Cast,18,144,213,375
Waller,418,Railroad Commissioner,,REP,Under Votes,1,17,32,50
Waller,418,Railroad Commissioner,,REP,Over Votes,0,0,0,0
Waller,418,"Chief Justice, Supreme Court",,REP,Nathan Hecht,17,148,219,384
Waller,418,"Chief Justice, Supreme Court",,REP,Ballots Cast,17,148,219,384
Waller,418,"Chief Justice, Supreme Court",,REP,Under Votes,2,13,26,41
Waller,418,"Chief Justice, Supreme Court",,REP,Over Votes,0,0,0,0
Waller,418,"Justice, Supreme Court, Place 6 Unexpired Term",,REP,Jane Bland,17,147,213,377
Waller,418,"Justice, Supreme Court, Place 6 Unexpired Term",,REP,Ballots Cast,17,147,213,377
Waller,418,"Justice, Supreme Court, Place 6 Unexpired Term",,REP,Under Votes,2,14,32,48
Waller,418,"Justice, Supreme Court, Place 6 Unexpired Term",,REP,Over Votes,0,0,0,0
Waller,418,"Justice, Supreme Court, Place 7",,REP,Jeff Boyd,19,145,219,383
Waller,418,"Justice, Supreme Court, Place 7",,REP,Ballots Cast,19,145,219,383
Waller,418,"Justice, Supreme Court, Place 7",,REP,Under Votes,0,16,26,42
Waller,418,"Justice, Supreme Court, Place 7",,REP,Over Votes,0,0,0,0
Waller,418,"Justice, Supreme Court, Place 8",,REP,Brett Busby,18,147,217,382
Waller,418,"Justice, Supreme Court, Place 8",,REP,Ballots Cast,18,147,217,382
Waller,418,"Justice, Supreme Court, Place 8",,REP,Under Votes,1,14,28,43
Waller,418,"Justice, Supreme Court, Place 8",,REP,Over Votes,0,0,0,0
Waller,418,"Judge, Court of Criminal Appeals, Place 3",,REP,Gina Parker,6,67,108,181
Waller,418,"Judge, Court of Criminal Appeals, Place 3",,REP,Bert Richardson,12,76,99,187
Waller,418,"Judge, Court of Criminal Appeals, Place 3",,REP,Ballots Cast,18,143,207,368
Waller,418,"Judge, Court of Criminal Appeals, Place 3",,REP,Under Votes,1,18,38,57
Waller,418,"Judge, Court of Criminal Appeals, Place 3",,REP,Over Votes,0,0,0,0
Waller,418,"Judge, Court of Criminal Appeals, Place 4",,REP,Kevin Patrick Yeary,18,145,212,375
Waller,418,"Judge, Court of Criminal Appeals, Place 4",,REP,Ballots Cast,18,145,212,375
Waller,418,"Judge, Court of Criminal Appeals, Place 4",,REP,Under Votes,1,16,33,50
Waller,418,"Judge, Court of Criminal Appeals, Place 4",,REP,Over Votes,0,0,0,0
Waller,418,"Judge, Court of Criminal Appeals, Place 9",,REP,David Newell,18,145,210,373
Waller,418,"Judge, Court of Criminal Appeals, Place 9",,REP,Ballots Cast,18,145,210,373
Waller,418,"Judge, Court of Criminal Appeals, Place 9",,REP,Under Votes,1,16,35,52
Waller,418,"Judge, Court of Criminal Appeals, Place 9",,REP,Over Votes,0,0,0,0
Waller,418,"Member, State Board of Education, District 10",,REP,Tom Maynard,18,143,215,376
Waller,418,"Member, State Board of Education, District 10",,REP,Ballots Cast,18,143,215,376
Waller,418,"Member, State Board of Education, District 10",,REP,Under Votes,1,18,30,49
Waller,418,"Member, State Board of Education, District 10",,REP,Over Votes,0,0,0,0
Waller,418,State Senate,18,REP,Lois W. Kolkhorst,18,148,223,389
Waller,418,State Senate,18,REP,Ballots Cast,18,148,223,389
Waller,418,State Senate,18,REP,Under Votes,1,13,22,36
Waller,418,State Senate,18,REP,Over Votes,0,0,0,0
Waller,418,State Representative,3,REP,Cecil Bell Jr,18,150,218,386
Waller,418,State Representative,3,REP,Ballots Cast,18,150,218,386
Waller,418,State Representative,3,REP,Under Votes,1,11,27,39
Waller,418,State Representative,3,REP,Over Votes,0,0,0,0
Waller,418,"Chief Justice, 14th Court of Appeals District",,REP,Tracy Elizabeth Christopher,18,146,211,375
Waller,418,"Chief Justice, 14th Court of Appeals District",,REP,Ballots Cast,18,146,211,375
Waller,418,"Chief Justice, 14th Court of Appeals District",,REP,Under Votes,1,15,34,50
Waller,418,"Chief Justice, 14th Court of Appeals District",,REP,Over Votes,0,0,0,0
Waller,418,"Justice, 1st Court of Appeals District, Place 3",,REP,Russell Lloyd,18,144,211,373
Waller,418,"Justice, 1st Court of Appeals District, Place 3",,REP,Ballots Cast,18,144,211,373
Waller,418,"Justice, 1st Court of Appeals District, Place 3",,REP,Under Votes,1,17,34,52
Waller,418,"Justice, 1st Court of Appeals District, Place 3",,REP,Over Votes,0,0,0,0
Waller,418,"Justice, 1st Court of Appeals District, Place 5",,REP,Chad Bridges,5,47,61,113
Waller,418,"Justice, 1st Court of Appeals District, Place 5",,REP,James Lombardino,2,15,31,48
Waller,418,"Justice, 1st Court of Appeals District, Place 5",,REP,Levi J. Benton,4,16,22,42
Waller,418,"Justice, 1st Court of Appeals District, Place 5",,REP,Terry Adams,8,55,72,135
Waller,418,"Justice, 1st Court of Appeals District, Place 5",,REP,Ballots Cast,19,133,186,338
Waller,418,"Justice, 1st Court of Appeals District, Place 5",,REP,Under Votes,0,28,59,87
Waller,418,"Justice, 1st Court of Appeals District, Place 5",,REP,Over Votes,0,0,0,0
Waller,418,"Justice, 14th Court of Appeals District, Place 7",,REP,Ken Wise,18,146,209,373
Waller,418,"Justice, 14th Court of Appeals District, Place 7",,REP,Ballots Cast,18,146,209,373
Waller,418,"Justice, 14th Court of Appeals District, Place 7",,REP,Under Votes,1,15,36,52
Waller,418,"Justice, 14th Court of Appeals District, Place 7",,REP,Over Votes,0,0,0,0
Waller,418,"District Judge, 506th Judicial District",,REP,Gary W. Chaney,18,147,208,373
Waller,418,"District Judge, 506th Judicial District",,REP,Ballots Cast,18,147,208,373
Waller,418,"District Judge, 506th Judicial District",,REP,Under Votes,1,14,37,52
Waller,418,"District Judge, 506th Judicial District",,REP,Over Votes,0,0,0,0
Waller,418,Sheriff,,REP,Dan Porter,1,35,65,101
Waller,418,Sheriff,,REP,R. Glenn Smith,10,38,76,124
Waller,418,Sheriff,,REP,Troy Guidry,8,84,93,185
Waller,418,Sheriff,,REP,Ballots Cast,19,157,234,410
Waller,418,Sheriff,,REP,Under Votes,0,4,11,15
Waller,418,Sheriff,,REP,Over Votes,0,0,0,0
Waller,418,County Tax Assessor-Collector,,REP,Ellen Contreras Shelburne,11,84,128,223
Waller,418,County Tax Assessor-Collector,,REP,Carolyn Miedke,8,67,84,159
Waller,418,County Tax Assessor-Collector,,REP,Ballots Cast,19,151,212,382
Waller,418,County Tax Assessor-Collector,,REP,Under Votes,0,10,33,43
Waller,418,County Tax Assessor-Collector,,REP,Over Votes,0,0,0,0
Waller,418,"Constable, Precinct 4",,REP,Joe Trimm Jr,18,149,216,383
Waller,418,"Constable, Precinct 4",,REP,Ballots Cast,18,149,216,383
Waller,418,"Constable, Precinct 4",,REP,Under Votes,1,12,29,42
Waller,418,"Constable, Precinct 4",,REP,Over Votes,0,0,0,0
Waller,418,County Chairman,,REP,David W. Luther,18,146,209,373
Waller,418,County Chairman,,REP,Ballots Cast,18,146,209,373
Waller,418,County Chairman,,REP,Under Votes,1,15,36,52
Waller,418,County Chairman,,REP,Over Votes,0,0,0,0
Waller,418,Proposition #1,,DEM,Yes,3,33,83,119
Waller,418,Proposition #1,,DEM,No,1,2,7,10
Waller,418,Proposition #1,,DEM,Ballots Cast,4,35,90,129
Waller,418,Proposition #1,,DEM,Under Votes,1,1,2,4
Waller,418,Proposition #1,,DEM,Over Votes,0,0,0,0
Waller,418,Proposition #2,,DEM,Yes,3,34,83,120
Waller,418,Proposition #2,,DEM,No,1,1,7,9
Waller,418,Proposition #2,,DEM,Ballots Cast,4,35,90,129
Waller,418,Proposition #2,,DEM,Under Votes,1,1,2,4
Waller,418,Proposition #2,,DEM,Over Votes,0,0,0,0
Waller,418,Proposition #3,,DEM,Yes,5,35,91,131
Waller,418,Proposition #3,,DEM,No,0,0,0,0
Waller,418,Proposition #3,,DEM,Ballots Cast,5,35,91,131
Waller,418,Proposition #3,,DEM,Under Votes,0,1,1,2
Waller,418,Proposition #3,,DEM,Over Votes,0,0,0,0
Waller,418,Proposition #4,,DEM,Yes,4,33,84,121
Waller,418,Proposition #4,,DEM,No,1,2,7,10
Waller,418,Proposition #4,,DEM,Ballots Cast,5,35,91,131
Waller,418,Proposition #4,,DEM,Under Votes,0,1,1,2
Waller,418,Proposition #4,,DEM,Over Votes,0,0,0,0
Waller,418,Proposition #5,,DEM,Yes,5,35,87,127
Waller,418,Proposition #5,,DEM,No,0,0,3,3
Waller,418,Proposition #5,,DEM,Ballots Cast,5,35,90,130
Waller,418,Proposition #5,,DEM,Under Votes,0,1,2,3
Waller,418,Proposition #5,,DEM,Over Votes,0,0,0,0
Waller,418,Proposition #6,,DEM,Yes,5,35,91,131
Waller,418,Proposition #6,,DEM,No,0,0,0,0
Waller,418,Proposition #6,,DEM,Ballots Cast,5,35,91,131
Waller,418,Proposition #6,,DEM,Under Votes,0,1,1,2
Waller,418,Proposition #6,,DEM,Over Votes,0,0,0,0
Waller,418,Proposition #7,,DEM,Yes,4,35,86,125
Waller,418,Proposition #7,,DEM,No,1,0,5,6
Waller,418,Proposition #7,,DEM,Ballots Cast,5,35,91,131
Waller,418,Proposition #7,,DEM,Under Votes,0,1,1,2
Waller,418,Proposition #7,,DEM,Over Votes,0,0,0,0
Waller,418,Proposition #8,,DEM,Yes,5,35,88,128
Waller,418,Proposition #8,,DEM,No,0,0,3,3
Waller,418,Proposition #8,,DEM,Ballots Cast,5,35,91,131
Waller,418,Proposition #8,,DEM,Under Votes,0,1,1,2
Waller,418,Proposition #8,,DEM,Over Votes,0,0,0,0
Waller,418,Proposition #9,,DEM,Yes,4,35,89,128
Waller,418,Proposition #9,,DEM,No,1,0,0,1
Waller,418,Proposition #9,,DEM,Ballots Cast,5,35,89,129
Waller,418,Proposition #9,,DEM,Under Votes,0,1,3,4
Waller,418,Proposition #9,,DEM,Over Votes,0,0,0,0
Waller,418,Proposition #10,,DEM,Yes,4,35,87,126
Waller,418,Proposition #10,,DEM,No,1,0,3,4
Waller,418,Proposition #10,,DEM,Ballots Cast,5,35,90,130
Waller,418,Proposition #10,,DEM,Under Votes,0,1,2,3
Waller,418,Proposition #10,,DEM,Over Votes,0,0,0,0
Waller,418,Proposition #11,,DEM,Yes,4,33,80,117
Waller,418,Proposition #11,,DEM,No,1,1,6,8
Waller,418,Proposition #11,,DEM,Ballots Cast,5,34,86,125
Waller,418,Proposition #11,,DEM,Under Votes,0,2,6,8
Waller,418,Proposition #11,,DEM,Over Votes,0,0,0,0
Waller,418,Proposition 1,,REP,Yes,18,148,223,389
Waller,418,Proposition 1,,REP,No,0,12,17,29
Waller,418,Proposition 1,,REP,Ballots Cast,18,160,240,418
Waller,418,Proposition 1,,REP,Under Votes,1,1,5,7
Waller,418,Proposition 1,,REP,Over Votes,0,0,0,0
Waller,418,Proposition 2,,REP,Yes,17,141,217,375
Waller,418,Proposition 2,,REP,No,2,19,23,44
Waller,418,Proposition 2,,REP,Ballots Cast,19,160,240,419
Waller,418,Proposition 2,,REP,Under Votes,0,1,5,6
Waller,418,Proposition 2,,REP,Over Votes,0,0,0,0
Waller,418,Proposition 3,,REP,Yes,19,152,228,399
Waller,418,Proposition 3,,REP,No,0,5,9,14
Waller,418,Proposition 3,,REP,Ballots Cast,19,157,237,413
Waller,418,Proposition 3,,REP,Under Votes,0,4,8,12
Waller,418,Proposition 3,,REP,Over Votes,0,0,0,0
Waller,418,Proposition 4,,REP,Yes,19,151,226,396
Waller,418,Proposition 4,,REP,No,0,10,11,21
Waller,418,Proposition 4,,REP,Ballots Cast,19,161,237,417
Waller,418,Proposition 4,,REP,Under Votes,0,0,8,8
Waller,418,Proposition 4,,REP,Over Votes,0,0,0,0
Waller,418,Proposition 5,,REP,Yes,19,154,218,391
Waller,418,Proposition 5,,REP,No,0,7,18,25
Waller,418,Proposition 5,,REP,Ballots Cast,19,161,236,416
Waller,418,Proposition 5,,REP,Under Votes,0,0,9,9
Waller,418,Proposition 5,,REP,Over Votes,0,0,0,0
Waller,418,Proposition 6,,REP,Yes,19,154,228,401
Waller,418,Proposition 6,,REP,No,0,6,12,18
Waller,418,Proposition 6,,REP,Ballots Cast,19,160,240,419
Waller,418,Proposition 6,,REP,Under Votes,0,1,5,6
Waller,418,Proposition 6,,REP,Over Votes,0,0,0,0
Waller,418,Proposition 7,,REP,Yes,19,158,235,412
Waller,418,Proposition 7,,REP,No,0,3,3,6
Waller,418,Proposition 7,,REP,Ballots Cast,19,161,238,418
Waller,418,Proposition 7,,REP,Under Votes,0,0,7,7
Waller,418,Proposition 7,,REP,Over Votes,0,0,0,0
Waller,418,Proposition 8,,REP,Yes,19,157,235,411
Waller,418,Proposition 8,,REP,No,0,3,3,6
Waller,418,Proposition 8,,REP,Ballots Cast,19,160,238,417
Waller,418,Proposition 8,,REP,Under Votes,0,1,7,8
Waller,418,Proposition 8,,REP,Over Votes,0,0,0,0
Waller,418,Proposition 9,,REP,Yes,19,154,233,406
Waller,418,Proposition 9,,REP,No,0,7,7,14
Waller,418,Proposition 9,,REP,Ballots Cast,19,161,240,420
Waller,418,Proposition 9,,REP,Under Votes,0,0,5,5
Waller,418,Proposition 9,,REP,Over Votes,0,0,0,0
Waller,418,Proposition 10,,REP,Yes,16,148,222,386
Waller,418,Proposition 10,,REP,No,2,11,13,26
Waller,418,Proposition 10,,REP,Ballots Cast,18,159,235,412
Waller,418,Proposition 10,,REP,Under Votes,1,2,10,13
Waller,418,Proposition 10,,REP,Over Votes,0,0,0,0
Waller,419,President,,DEM,Michael Bennet,0,0,0,0
Waller,419,President,,DEM,Marianne Williamson,0,0,0,0
Waller,419,President,,DEM,Cory Booker,0,0,0,0
Waller,419,President,,DEM,Bernie Sanders,0,4,9,13
Waller,419,President,,DEM,Tulsi Gabbard,0,0,0,0
Waller,419,President,,DEM,Deval Patrick,0,0,0,0
Waller,419,President,,DEM,Amy Klobuchar,0,0,0,0
Waller,419,President,,DEM,Julián Castro,0,0,0,0
Waller,419,President,,DEM,Elizabeth Warren,0,2,1,3
Waller,419,President,,DEM,John K. Delaney,0,0,0,0
Waller,419,President,,DEM,Robby Wells,0,0,0,0
Waller,419,President,,DEM,"Roque ""Rocky"" De La Fuente",0,0,0,0
Waller,419,President,,DEM,Andrew Yang,0,0,0,0
Waller,419,President,,DEM,Joseph R. Biden,0,3,18,21
Waller,419,President,,DEM,Michael R. Bloomberg,0,1,6,7
Waller,419,President,,DEM,Tom Steyer,0,0,0,0
Waller,419,President,,DEM,Pete Buttigieg,0,1,0,1
Waller,419,President,,DEM,Ballots Cast,0,11,34,45
Waller,419,President,,DEM,Under Votes,0,0,0,0
Waller,419,President,,DEM,Over Votes,0,0,0,0
Waller,419,U.S. Senate,,DEM,Royce West,0,0,0,0
Waller,419,U.S. Senate,,DEM,"Annie ""Mamá"" Garcia",0,2,2,4
Waller,419,U.S. Senate,,DEM,D. R. Hunter,0,0,1,1
Waller,419,U.S. Senate,,DEM,Sema Hernandez,0,2,4,6
Waller,419,U.S. Senate,,DEM,Adrian Ocegueda,0,0,1,1
Waller,419,U.S. Senate,,DEM,Chris Bell,0,2,6,8
Waller,419,U.S. Senate,,DEM,Cristina Tzintzun Ramirez,0,1,8,9
Waller,419,U.S. Senate,,DEM,Jack Daniel Foster Jr,0,0,0,0
Waller,419,U.S. Senate,,DEM,Amanda K. Edwards,0,1,1,2
Waller,419,U.S. Senate,,DEM,Victor Hugo Harris,0,0,1,1
Waller,419,U.S. Senate,,DEM,"Mary ""MJ"" Hegar",0,3,4,7
Waller,419,U.S. Senate,,DEM,Michael Cooper,0,0,1,1
Waller,419,U.S. Senate,,DEM,Ballots Cast,0,11,29,40
Waller,419,U.S. Senate,,DEM,Under Votes,0,0,5,5
Waller,419,U.S. Senate,,DEM,Over Votes,0,0,0,0
Waller,419,U.S. House,10,DEM,Mike Siegel,0,5,9,14
Waller,419,U.S. House,10,DEM,Shannon Hutcheson,0,3,10,13
Waller,419,U.S. House,10,DEM,Pritesh Gandhi,0,3,12,15
Waller,419,U.S. House,10,DEM,Ballots Cast,0,11,31,42
Waller,419,U.S. House,10,DEM,Under Votes,0,0,3,3
Waller,419,U.S. House,10,DEM,Over Votes,0,0,0,0
Waller,419,Railroad Commissioner,,DEM,"Roberto R. ""Beto"" Alonzo",0,4,4,8
Waller,419,Railroad Commissioner,,DEM,Chrysta Castañeda,0,4,10,14
Waller,419,Railroad Commissioner,,DEM,Mark Watson,0,1,4,5
Waller,419,Railroad Commissioner,,DEM,Kelly Stone,0,1,8,9
Waller,419,Railroad Commissioner,,DEM,Ballots Cast,0,10,26,36
Waller,419,Railroad Commissioner,,DEM,Under Votes,0,1,8,9
Waller,419,Railroad Commissioner,,DEM,Over Votes,0,0,0,0
Waller,419,"Chief Justice, Supreme Court",,DEM,Jerry Zimmerer,0,1,1,2
Waller,419,"Chief Justice, Supreme Court",,DEM,Amy Clark Meachum,0,10,28,38
Waller,419,"Chief Justice, Supreme Court",,DEM,Ballots Cast,0,11,29,40
Waller,419,"Chief Justice, Supreme Court",,DEM,Under Votes,0,0,5,5
Waller,419,"Chief Justice, Supreme Court",,DEM,Over Votes,0,0,0,0
Waller,419,"Justice, Supreme Court, Place 6 Unexpired Term",,DEM,Kathy Cheng,0,8,24,32
Waller,419,"Justice, Supreme Court, Place 6 Unexpired Term",,DEM,Larry Praeger,0,1,6,7
Waller,419,"Justice, Supreme Court, Place 6 Unexpired Term",,DEM,Ballots Cast,0,9,30,39
Waller,419,"Justice, Supreme Court, Place 6 Unexpired Term",,DEM,Under Votes,0,2,4,6
Waller,419,"Justice, Supreme Court, Place 6 Unexpired Term",,DEM,Over Votes,0,0,0,0
Waller,419,"Justice, Supreme Court, Place 7",,DEM,Staci Williams,0,7,21,28
Waller,419,"Justice, Supreme Court, Place 7",,DEM,Brandy Voss,0,3,8,11
Waller,419,"Justice, Supreme Court, Place 7",,DEM,Ballots Cast,0,10,29,39
Waller,419,"Justice, Supreme Court, Place 7",,DEM,Under Votes,0,1,5,6
Waller,419,"Justice, Supreme Court, Place 7",,DEM,Over Votes,0,0,0,0
Waller,419,"Justice, Supreme Court, Place 8",,DEM,Gisela D. Triana,0,10,19,29
Waller,419,"Justice, Supreme Court, Place 8",,DEM,Peter Kelly,0,1,9,10
Waller,419,"Justice, Supreme Court, Place 8",,DEM,Ballots Cast,0,11,28,39
Waller,419,"Justice, Supreme Court, Place 8",,DEM,Under Votes,0,0,6,6
Waller,419,"Justice, Supreme Court, Place 8",,DEM,Over Votes,0,0,0,0
Waller,419,"Judge, Court of Criminal Appeals, Place 3",,DEM,Elizabeth Davis Frizell,0,9,19,28
Waller,419,"Judge, Court of Criminal Appeals, Place 3",,DEM,William Pieratt Demond,0,1,4,5
Waller,419,"Judge, Court of Criminal Appeals, Place 3",,DEM,Dan Wood,0,1,5,6
Waller,419,"Judge, Court of Criminal Appeals, Place 3",,DEM,Ballots Cast,0,11,28,39
Waller,419,"Judge, Court of Criminal Appeals, Place 3",,DEM,Under Votes,0,0,6,6
Waller,419,"Judge, Court of Criminal Appeals, Place 3",,DEM,Over Votes,0,0,0,0
Waller,419,"Judge, Court of Criminal Appeals, Place 4",,DEM,Steven Miears,0,2,6,8
Waller,419,"Judge, Court of Criminal Appeals, Place 4",,DEM,Tina Clinton,0,8,23,31
Waller,419,"Judge, Court of Criminal Appeals, Place 4",,DEM,Ballots Cast,0,10,29,39
Waller,419,"Judge, Court of Criminal Appeals, Place 4",,DEM,Under Votes,0,1,5,6
Waller,419,"Judge, Court of Criminal Appeals, Place 4",,DEM,Over Votes,0,0,0,0
Waller,419,"Judge, Court of Criminal Appeals, Place 9",,DEM,Brandon Birmingham,0,7,27,34
Waller,419,"Judge, Court of Criminal Appeals, Place 9",,DEM,Ballots Cast,0,7,27,34
Waller,419,"Judge, Court of Criminal Appeals, Place 9",,DEM,Under Votes,0,4,7,11
Waller,419,"Judge, Court of Criminal Appeals, Place 9",,DEM,Over Votes,0,0,0,0
Waller,419,"Member, State Board of Education, District 10",,DEM,Stephen Wyman,0,0,4,4
Waller,419,"Member, State Board of Education, District 10",,DEM,Marsha Burnett-Webster,0,11,24,35
Waller,419,"Member, State Board of Education, District 10",,DEM,Ballots Cast,0,11,28,39
Waller,419,"Member, State Board of Education, District 10",,DEM,Under Votes,0,0,6,6
Waller,419,"Member, State Board of Education, District 10",,DEM,Over Votes,0,0,0,0
Waller,419,State Senate,18,DEM,Michael Antalan,0,7,27,34
Waller,419,State Senate,18,DEM,Ballots Cast,0,7,27,34
Waller,419,State Senate,18,DEM,Under Votes,0,4,7,11
Waller,419,State Senate,18,DEM,Over Votes,0,0,0,0
Waller,419,State Representative,3,DEM,Martin Shupp,0,7,28,35
Waller,419,State Representative,3,DEM,Ballots Cast,0,7,28,35
Waller,419,State Representative,3,DEM,Under Votes,0,4,6,10
Waller,419,State Representative,3,DEM,Over Votes,0,0,0,0
Waller,419,"Chief Justice, 14th Court of Appeals District",,DEM,Jane Robinson,0,8,22,30
Waller,419,"Chief Justice, 14th Court of Appeals District",,DEM,Jim Evans,0,1,7,8
Waller,419,"Chief Justice, 14th Court of Appeals District",,DEM,Ballots Cast,0,9,29,38
Waller,419,"Chief Justice, 14th Court of Appeals District",,DEM,Under Votes,0,2,5,7
Waller,419,"Chief Justice, 14th Court of Appeals District",,DEM,Over Votes,0,0,0,0
Waller,419,"Justice, 1st Court of Appeals District, Place 3",,DEM,Jim Sharp,0,0,4,4
Waller,419,"Justice, 1st Court of Appeals District, Place 3",,DEM,Dinesh Singhal,0,2,9,11
Waller,419,"Justice, 1st Court of Appeals District, Place 3",,DEM,Veronica Rivas-Molloy,0,7,14,21
Waller,419,"Justice, 1st Court of Appeals District, Place 3",,DEM,Ballots Cast,0,9,27,36
Waller,419,"Justice, 1st Court of Appeals District, Place 3",,DEM,Under Votes,0,2,7,9
Waller,419,"Justice, 1st Court of Appeals District, Place 3",,DEM,Over Votes,0,0,0,0
Waller,419,"Justice, 1st Court of Appeals District, Place 5",,DEM,Tim Hootman,0,3,14,17
Waller,419,"Justice, 1st Court of Appeals District, Place 5",,DEM,Amparo Monique Guerra,0,6,13,19
Waller,419,"Justice, 1st Court of Appeals District, Place 5",,DEM,Ballots Cast,0,9,27,36
Waller,419,"Justice, 1st Court of Appeals District, Place 5",,DEM,Under Votes,0,2,7,9
Waller,419,"Justice, 1st Court of Appeals District, Place 5",,DEM,Over Votes,0,0,0,0
Waller,419,"Justice, 14th Court of Appeals District, Place 7",,DEM,"Tamika ""Tami"" Craft",0,6,10,16
Waller,419,"Justice, 14th Court of Appeals District, Place 7",,DEM,Wally Kronzer,0,1,1,2
Waller,419,"Justice, 14th Court of Appeals District, Place 7",,DEM,V.R. Faulkner,0,0,2,2
Waller,419,"Justice, 14th Court of Appeals District, Place 7",,DEM,Cheri Thomas,0,1,5,6
Waller,419,"Justice, 14th Court of Appeals District, Place 7",,DEM,Dominic J. Merino,0,1,6,7
Waller,419,"Justice, 14th Court of Appeals District, Place 7",,DEM,Lennon C. Wright,0,0,2,2
Waller,419,"Justice, 14th Court of Appeals District, Place 7",,DEM,Ballots Cast,0,9,26,35
Waller,419,"Justice, 14th Court of Appeals District, Place 7",,DEM,Under Votes,0,2,8,10
Waller,419,"Justice, 14th Court of Appeals District, Place 7",,DEM,Over Votes,0,0,0,0
Waller,419,Sheriff,,DEM,Cedric D. Watson,0,7,28,35
Waller,419,Sheriff,,DEM,Ballots Cast,0,7,28,35
Waller,419,Sheriff,,DEM,Under Votes,0,4,6,10
Waller,419,Sheriff,,DEM,Over Votes,0,0,0,0
Waller,419,County Chairman,,DEM,Rosa Patlan Harris,0,8,24,32
Waller,419,County Chairman,,DEM,Ballots Cast,0,8,24,32
Waller,419,County Chairman,,DEM,Under Votes,0,3,10,13
Waller,419,County Chairman,,DEM,Over Votes,0,0,0,0
Waller,419,President,,REP,Donald J. Trump,0,27,65,92
Waller,419,President,,REP,Joe Walsh,0,0,0,0
Waller,419,President,,REP,Bob Ely,0,0,1,1
Waller,419,President,,REP,"Roque ""Rocky"" De La Fuente Guerra",0,0,0,0
Waller,419,President,,REP,Zoltan G. Istvan,0,0,0,0
Waller,419,President,,REP,Matthew John Matern,0,0,0,0
Waller,419,President,,REP,Bill Weld,0,0,0,0
Waller,419,President,,REP,Uncommitted,0,1,2,3
Waller,419,President,,REP,Ballots Cast,0,28,68,96
Waller,419,President,,REP,Under Votes,0,0,0,0
Waller,419,President,,REP,Over Votes,0,0,0,0
Waller,419,U.S. Senate,,REP,Dwayne Stovall,0,4,19,23
Waller,419,U.S. Senate,,REP,Mark Yancey,0,0,4,4
Waller,419,U.S. Senate,,REP,Virgil Bierschwale,0,0,0,0
Waller,419,U.S. Senate,,REP,John Anthony Castro,0,0,5,5
Waller,419,U.S. Senate,,REP,John Cornyn,0,22,34,56
Waller,419,U.S. Senate,,REP,Ballots Cast,0,26,62,88
Waller,419,U.S. Senate,,REP,Under Votes,0,2,6,8
Waller,419,U.S. Senate,,REP,Over Votes,0,0,0,0
Waller,419,U.S. House,10,REP,Michael McCaul,0,25,65,90
Waller,419,U.S. House,10,REP,Ballots Cast,0,25,65,90
Waller,419,U.S. House,10,REP,Under Votes,0,3,3,6
Waller,419,U.S. House,10,REP,Over Votes,0,0,0,0
Waller,419,Railroad Commissioner,,REP,Ryan Sitton,0,13,28,41
Waller,419,Railroad Commissioner,,REP,"James ""Jim"" Wright",0,12,33,45
Waller,419,Railroad Commissioner,,REP,Ballots Cast,0,25,61,86
Waller,419,Railroad Commissioner,,REP,Under Votes,0,3,7,10
Waller,419,Railroad Commissioner,,REP,Over Votes,0,0,0,0
Waller,419,"Chief Justice, Supreme Court",,REP,Nathan Hecht,0,24,61,85
Waller,419,"Chief Justice, Supreme Court",,REP,Ballots Cast,0,24,61,85
Waller,419,"Chief Justice, Supreme Court",,REP,Under Votes,0,4,7,11
Waller,419,"Chief Justice, Supreme Court",,REP,Over Votes,0,0,0,0
Waller,419,"Justice, Supreme Court, Place 6 Unexpired Term",,REP,Jane Bland,0,25,61,86
Waller,419,"Justice, Supreme Court, Place 6 Unexpired Term",,REP,Ballots Cast,0,25,61,86
Waller,419,"Justice, Supreme Court, Place 6 Unexpired Term",,REP,Under Votes,0,3,7,10
Waller,419,"Justice, Supreme Court, Place 6 Unexpired Term",,REP,Over Votes,0,0,0,0
Waller,419,"Justice, Supreme Court, Place 7",,REP,Jeff Boyd,0,25,61,86
Waller,419,"Justice, Supreme Court, Place 7",,REP,Ballots Cast,0,25,61,86
Waller,419,"Justice, Supreme Court, Place 7",,REP,Under Votes,0,3,7,10
Waller,419,"Justice, Supreme Court, Place 7",,REP,Over Votes,0,0,0,0
Waller,419,"Justice, Supreme Court, Place 8",,REP,Brett Busby,0,25,61,86
Waller,419,"Justice, Supreme Court, Place 8",,REP,Ballots Cast,0,25,61,86
Waller,419,"Justice, Supreme Court, Place 8",,REP,Under Votes,0,3,7,10
Waller,419,"Justice, Supreme Court, Place 8",,REP,Over Votes,0,0,0,0
Waller,419,"Judge, Court of Criminal Appeals, Place 3",,REP,Gina Parker,0,14,34,48
Waller,419,"Judge, Court of Criminal Appeals, Place 3",,REP,Bert Richardson,0,10,25,35
Waller,419,"Judge, Court of Criminal Appeals, Place 3",,REP,Ballots Cast,0,24,59,83
Waller,419,"Judge, Court of Criminal Appeals, Place 3",,REP,Under Votes,0,4,9,13
Waller,419,"Judge, Court of Criminal Appeals, Place 3",,REP,Over Votes,0,0,0,0
Waller,419,"Judge, Court of Criminal Appeals, Place 4",,REP,Kevin Patrick Yeary,0,25,61,86
Waller,419,"Judge, Court of Criminal Appeals, Place 4",,REP,Ballots Cast,0,25,61,86
Waller,419,"Judge, Court of Criminal Appeals, Place 4",,REP,Under Votes,0,3,7,10
Waller,419,"Judge, Court of Criminal Appeals, Place 4",,REP,Over Votes,0,0,0,0
Waller,419,"Judge, Court of Criminal Appeals, Place 9",,REP,David Newell,0,25,60,85
Waller,419,"Judge, Court of Criminal Appeals, Place 9",,REP,Ballots Cast,0,25,60,85
Waller,419,"Judge, Court of Criminal Appeals, Place 9",,REP,Under Votes,0,3,8,11
Waller,419,"Judge, Court of Criminal Appeals, Place 9",,REP,Over Votes,0,0,0,0
Waller,419,"Member, State Board of Education, District 10",,REP,Tom Maynard,0,25,61,86
Waller,419,"Member, State Board of Education, District 10",,REP,Ballots Cast,0,25,61,86
Waller,419,"Member, State Board of Education, District 10",,REP,Under Votes,0,3,7,10
Waller,419,"Member, State Board of Education, District 10",,REP,Over Votes,0,0,0,0
Waller,419,State Senate,18,REP,Lois W. Kolkhorst,0,24,63,87
Waller,419,State Senate,18,REP,Ballots Cast,0,24,63,87
Waller,419,State Senate,18,REP,Under Votes,0,4,5,9
Waller,419,State Senate,18,REP,Over Votes,0,0,0,0
Waller,419,State Representative,3,REP,Cecil Bell Jr,0,24,63,87
Waller,419,State Representative,3,REP,Ballots Cast,0,24,63,87
Waller,419,State Representative,3,REP,Under Votes,0,4,5,9
Waller,419,State Representative,3,REP,Over Votes,0,0,0,0
Waller,419,"Chief Justice, 14th Court of Appeals District",,REP,Tracy Elizabeth Christopher,0,25,62,87
Waller,419,"Chief Justice, 14th Court of Appeals District",,REP,Ballots Cast,0,25,62,87
Waller,419,"Chief Justice, 14th Court of Appeals District",,REP,Under Votes,0,3,6,9
Waller,419,"Chief Justice, 14th Court of Appeals District",,REP,Over Votes,0,0,0,0
Waller,419,"Justice, 1st Court of Appeals District, Place 3",,REP,Russell Lloyd,0,25,62,87
Waller,419,"Justice, 1st Court of Appeals District, Place 3",,REP,Ballots Cast,0,25,62,87
Waller,419,"Justice, 1st Court of Appeals District, Place 3",,REP,Under Votes,0,3,6,9
Waller,419,"Justice, 1st Court of Appeals District, Place 3",,REP,Over Votes,0,0,0,0
Waller,419,"Justice, 1st Court of Appeals District, Place 5",,REP,Chad Bridges,0,7,23,30
Waller,419,"Justice, 1st Court of Appeals District, Place 5",,REP,James Lombardino,0,5,7,12
Waller,419,"Justice, 1st Court of Appeals District, Place 5",,REP,Levi J. Benton,0,1,7,8
Waller,419,"Justice, 1st Court of Appeals District, Place 5",,REP,Terry Adams,0,10,19,29
Waller,419,"Justice, 1st Court of Appeals District, Place 5",,REP,Ballots Cast,0,23,56,79
Waller,419,"Justice, 1st Court of Appeals District, Place 5",,REP,Under Votes,0,5,12,17
Waller,419,"Justice, 1st Court of Appeals District, Place 5",,REP,Over Votes,0,0,0,0
Waller,419,"Justice, 14th Court of Appeals District, Place 7",,REP,Ken Wise,0,25,61,86
Waller,419,"Justice, 14th Court of Appeals District, Place 7",,REP,Ballots Cast,0,25,61,86
Waller,419,"Justice, 14th Court of Appeals District, Place 7",,REP,Under Votes,0,3,7,10
Waller,419,"Justice, 14th Court of Appeals District, Place 7",,REP,Over Votes,0,0,0,0
Waller,419,"District Judge, 506th Judicial District",,REP,Gary W. Chaney,0,25,62,87
Waller,419,"District Judge, 506th Judicial District",,REP,Ballots Cast,0,25,62,87
Waller,419,"District Judge, 506th Judicial District",,REP,Under Votes,0,3,6,9
Waller,419,"District Judge, 506th Judicial District",,REP,Over Votes,0,0,0,0
Waller,419,Sheriff,,REP,Dan Porter,0,10,49,59
Waller,419,Sheriff,,REP,R. Glenn Smith,0,8,3,11
Waller,419,Sheriff,,REP,Troy Guidry,0,8,14,22
Waller,419,Sheriff,,REP,Ballots Cast,0,26,66,92
Waller,419,Sheriff,,REP,Under Votes,0,2,2,4
Waller,419,Sheriff,,REP,Over Votes,0,0,0,0
Waller,419,County Tax Assessor-Collector,,REP,Ellen Contreras Shelburne,0,12,22,34
Waller,419,County Tax Assessor-Collector,,REP,Carolyn Miedke,0,13,38,51
Waller,419,County Tax Assessor-Collector,,REP,Ballots Cast,0,25,60,85
Waller,419,County Tax Assessor-Collector,,REP,Under Votes,0,3,8,11
Waller,419,County Tax Assessor-Collector,,REP,Over Votes,0,0,0,0
Waller,419,"Constable, Precinct 4",,REP,Joe Trimm Jr,0,25,59,84
Waller,419,"Constable, Precinct 4",,REP,Ballots Cast,0,25,59,84
Waller,419,"Constable, Precinct 4",,REP,Under Votes,0,3,9,12
Waller,419,"Constable, Precinct 4",,REP,Over Votes,0,0,0,0
Waller,419,County Chairman,,REP,David W. Luther,0,24,61,85
Waller,419,County Chairman,,REP,Ballots Cast,0,24,61,85
Waller,419,County Chairman,,REP,Under Votes,0,4,7,11
Waller,419,County Chairman,,REP,Over Votes,0,0,0,0
Waller,419,Proposition #1,,DEM,Yes,0,10,29,39
Waller,419,Proposition #1,,DEM,No,0,1,5,6
Waller,419,Proposition #1,,DEM,Ballots Cast,0,11,34,45
Waller,419,Proposition #1,,DEM,Under Votes,0,0,0,0
Waller,419,Proposition #1,,DEM,Over Votes,0,0,0,0
Waller,419,Proposition #2,,DEM,Yes,0,10,29,39
Waller,419,Proposition #2,,DEM,No,0,1,5,6
Waller,419,Proposition #2,,DEM,Ballots Cast,0,11,34,45
Waller,419,Proposition #2,,DEM,Under Votes,0,0,0,0
Waller,419,Proposition #2,,DEM,Over Votes,0,0,0,0
Waller,419,Proposition #3,,DEM,Yes,0,11,30,41
Waller,419,Proposition #3,,DEM,No,0,0,4,4
Waller,419,Proposition #3,,DEM,Ballots Cast,0,11,34,45
Waller,419,Proposition #3,,DEM,Under Votes,0,0,0,0
Waller,419,Proposition #3,,DEM,Over Votes,0,0,0,0
Waller,419,Proposition #4,,DEM,Yes,0,11,30,41
Waller,419,Proposition #4,,DEM,No,0,0,4,4
Waller,419,Proposition #4,,DEM,Ballots Cast,0,11,34,45
Waller,419,Proposition #4,,DEM,Under Votes,0,0,0,0
Waller,419,Proposition #4,,DEM,Over Votes,0,0,0,0
Waller,419,Proposition #5,,DEM,Yes,0,11,30,41
Waller,419,Proposition #5,,DEM,No,0,0,4,4
Waller,419,Proposition #5,,DEM,Ballots Cast,0,11,34,45
Waller,419,Proposition #5,,DEM,Under Votes,0,0,0,0
Waller,419,Proposition #5,,DEM,Over Votes,0,0,0,0
Waller,419,Proposition #6,,DEM,Yes,0,11,30,41
Waller,419,Proposition #6,,DEM,No,0,0,4,4
Waller,419,Proposition #6,,DEM,Ballots Cast,0,11,34,45
Waller,419,Proposition #6,,DEM,Under Votes,0,0,0,0
Waller,419,Proposition #6,,DEM,Over Votes,0,0,0,0
Waller,419,Proposition #7,,DEM,Yes,0,9,29,38
Waller,419,Proposition #7,,DEM,No,0,2,5,7
Waller,419,Proposition #7,,DEM,Ballots Cast,0,11,34,45
Waller,419,Proposition #7,,DEM,Under Votes,0,0,0,0
Waller,419,Proposition #7,,DEM,Over Votes,0,0,0,0
Waller,419,Proposition #8,,DEM,Yes,0,11,31,42
Waller,419,Proposition #8,,DEM,No,0,0,3,3
Waller,419,Proposition #8,,DEM,Ballots Cast,0,11,34,45
Waller,419,Proposition #8,,DEM,Under Votes,0,0,0,0
Waller,419,Proposition #8,,DEM,Over Votes,0,0,0,0
Waller,419,Proposition #9,,DEM,Yes,0,10,31,41
Waller,419,Proposition #9,,DEM,No,0,1,3,4
Waller,419,Proposition #9,,DEM,Ballots Cast,0,11,34,45
Waller,419,Proposition #9,,DEM,Under Votes,0,0,0,0
Waller,419,Proposition #9,,DEM,Over Votes,0,0,0,0
Waller,419,Proposition #10,,DEM,Yes,0,11,29,40
Waller,419,Proposition #10,,DEM,No,0,0,5,5
Waller,419,Proposition #10,,DEM,Ballots Cast,0,11,34,45
Waller,419,Proposition #10,,DEM,Under Votes,0,0,0,0
Waller,419,Proposition #10,,DEM,Over Votes,0,0,0,0
Waller,419,Proposition #11,,DEM,Yes,0,9,28,37
Waller,419,Proposition #11,,DEM,No,0,2,6,8
Waller,419,Proposition #11,,DEM,Ballots Cast,0,11,34,45
Waller,419,Proposition #11,,DEM,Under Votes,0,0,0,0
Waller,419,Proposition #11,,DEM,Over Votes,0,0,0,0
Waller,419,Proposition 1,,REP,Yes,0,23,63,86
Waller,419,Proposition 1,,REP,No,0,2,5,7
Waller,419,Proposition 1,,REP,Ballots Cast,0,25,68,93
Waller,419,Proposition 1,,REP,Under Votes,0,3,0,3
Waller,419,Proposition 1,,REP,Over Votes,0,0,0,0
Waller,419,Proposition 2,,REP,Yes,0,25,61,86
Waller,419,Proposition 2,,REP,No,0,2,7,9
Waller,419,Proposition 2,,REP,Ballots Cast,0,27,68,95
Waller,419,Proposition 2,,REP,Under Votes,0,1,0,1
Waller,419,Proposition 2,,REP,Over Votes,0,0,0,0
Waller,419,Proposition 3,,REP,Yes,0,24,62,86
Waller,419,Proposition 3,,REP,No,0,2,6,8
Waller,419,Proposition 3,,REP,Ballots Cast,0,26,68,94
Waller,419,Proposition 3,,REP,Under Votes,0,2,0,2
Waller,419,Proposition 3,,REP,Over Votes,0,0,0,0
Waller,419,Proposition 4,,REP,Yes,0,26,63,89
Waller,419,Proposition 4,,REP,No,0,0,4,4
Waller,419,Proposition 4,,REP,Ballots Cast,0,26,67,93
Waller,419,Proposition 4,,REP,Under Votes,0,2,1,3
Waller,419,Proposition 4,,REP,Over Votes,0,0,0,0
Waller,419,Proposition 5,,REP,Yes,0,26,63,89
Waller,419,Proposition 5,,REP,No,0,1,5,6
Waller,419,Proposition 5,,REP,Ballots Cast,0,27,68,95
Waller,419,Proposition 5,,REP,Under Votes,0,1,0,1
Waller,419,Proposition 5,,REP,Over Votes,0,0,0,0
Waller,419,Proposition 6,,REP,Yes,0,25,66,91
Waller,419,Proposition 6,,REP,No,0,1,1,2
Waller,419,Proposition 6,,REP,Ballots Cast,0,26,67,93
Waller,419,Proposition 6,,REP,Under Votes,0,2,1,3
Waller,419,Proposition 6,,REP,Over Votes,0,0,0,0
Waller,419,Proposition 7,,REP,Yes,0,23,67,90
Waller,419,Proposition 7,,REP,No,0,1,0,1
Waller,419,Proposition 7,,REP,Ballots Cast,0,24,67,91
Waller,419,Proposition 7,,REP,Under Votes,0,4,1,5
Waller,419,Proposition 7,,REP,Over Votes,0,0,0,0
Waller,419,Proposition 8,,REP,Yes,0,26,67,93
Waller,419,Proposition 8,,REP,No,0,0,0,0
Waller,419,Proposition 8,,REP,Ballots Cast,0,26,67,93
Waller,419,Proposition 8,,REP,Under Votes,0,2,1,3
Waller,419,Proposition 8,,REP,Over Votes,0,0,0,0
Waller,419,Proposition 9,,REP,Yes,0,23,67,90
Waller,419,Proposition 9,,REP,No,0,2,0,2
Waller,419,Proposition 9,,REP,Ballots Cast,0,25,67,92
Waller,419,Proposition 9,,REP,Under Votes,0,3,1,4
Waller,419,Proposition 9,,REP,Over Votes,0,0,0,0
Waller,419,Proposition 10,,REP,Yes,0,26,64,90
Waller,419,Proposition 10,,REP,No,0,0,4,4
Waller,419,Proposition 10,,REP,Ballots Cast,0,26,68,94
Waller,419,Proposition 10,,REP,Under Votes,0,2,0,2
Waller,419,Proposition 10,,REP,Over Votes,0,0,0,0
Waller,420,President,,DEM,Michael Bennet,0,0,1,1
Waller,420,President,,DEM,Marianne Williamson,0,0,0,0
Waller,420,President,,DEM,Cory Booker,0,0,1,1
Waller,420,President,,DEM,Bernie Sanders,0,11,22,33
Waller,420,President,,DEM,Tulsi Gabbard,0,0,0,0
Waller,420,President,,DEM,Deval Patrick,0,0,0,0
Waller,420,President,,DEM,Amy Klobuchar,1,3,0,4
Waller,420,President,,DEM,Julián Castro,0,0,0,0
Waller,420,President,,DEM,Elizabeth Warren,0,7,18,25
Waller,420,President,,DEM,John K. Delaney,0,0,0,0
Waller,420,President,,DEM,Robby Wells,0,0,0,0
Waller,420,President,,DEM,"Roque ""Rocky"" De La Fuente",0,0,0,0
Waller,420,President,,DEM,Andrew Yang,0,0,1,1
Waller,420,President,,DEM,Joseph R. Biden,2,8,63,73
Waller,420,President,,DEM,Michael R. Bloomberg,2,9,8,19
Waller,420,President,,DEM,Tom Steyer,0,0,0,0
Waller,420,President,,DEM,Pete Buttigieg,0,6,0,6
Waller,420,President,,DEM,Ballots Cast,5,44,114,163
Waller,420,President,,DEM,Under Votes,0,0,0,0
Waller,420,President,,DEM,Over Votes,0,0,0,0
Waller,420,U.S. Senate,,DEM,Royce West,3,5,13,21
Waller,420,U.S. Senate,,DEM,"Annie ""Mamá"" Garcia",0,2,15,17
Waller,420,U.S. Senate,,DEM,D. R. Hunter,0,0,2,2
Waller,420,U.S. Senate,,DEM,Sema Hernandez,0,2,5,7
Waller,420,U.S. Senate,,DEM,Adrian Ocegueda,0,0,5,5
Waller,420,U.S. Senate,,DEM,Chris Bell,1,15,19,35
Waller,420,U.S. Senate,,DEM,Cristina Tzintzun Ramirez,0,5,12,17
Waller,420,U.S. Senate,,DEM,Jack Daniel Foster Jr,0,0,0,0
Waller,420,U.S. Senate,,DEM,Amanda K. Edwards,0,1,5,6
Waller,420,U.S. Senate,,DEM,Victor Hugo Harris,0,0,1,1
Waller,420,U.S. Senate,,DEM,"Mary ""MJ"" Hegar",1,10,21,32
Waller,420,U.S. Senate,,DEM,Michael Cooper,0,0,4,4
Waller,420,U.S. Senate,,DEM,Ballots Cast,5,40,102,147
Waller,420,U.S. Senate,,DEM,Under Votes,0,4,12,16
Waller,420,U.S. Senate,,DEM,Over Votes,0,0,0,0
Waller,420,U.S. House,10,DEM,Mike Siegel,2,11,42,55
Waller,420,U.S. House,10,DEM,Shannon Hutcheson,1,13,36,50
Waller,420,U.S. House,10,DEM,Pritesh Gandhi,2,14,26,42
Waller,420,U.S. House,10,DEM,Ballots Cast,5,38,104,147
Waller,420,U.S. House,10,DEM,Under Votes,0,6,10,16
Waller,420,U.S. House,10,DEM,Over Votes,0,0,0,0
Waller,420,Railroad Commissioner,,DEM,"Roberto R. ""Beto"" Alonzo",2,9,24,35
Waller,420,Railroad Commissioner,,DEM,Chrysta Castañeda,0,13,30,43
Waller,420,Railroad Commissioner,,DEM,Mark Watson,0,8,14,22
Waller,420,Railroad Commissioner,,DEM,Kelly Stone,2,7,24,33
Waller,420,Railroad Commissioner,,DEM,Ballots Cast,4,37,92,133
Waller,420,Railroad Commissioner,,DEM,Under Votes,1,7,22,30
Waller,420,Railroad Commissioner,,DEM,Over Votes,0,0,0,0
Waller,420,"Chief Justice, Supreme Court",,DEM,Jerry Zimmerer,0,5,11,16
Waller,420,"Chief Justice, Supreme Court",,DEM,Amy Clark Meachum,4,33,86,123
Waller,420,"Chief Justice, Supreme Court",,DEM,Ballots Cast,4,38,97,139
Waller,420,"Chief Justice, Supreme Court",,DEM,Under Votes,1,6,17,24
Waller,420,"Chief Justice, Supreme Court",,DEM,Over Votes,0,0,0,0
Waller,420,"Justice, Supreme Court, Place 6 Unexpired Term",,DEM,Kathy Cheng,4,28,78,110
Waller,420,"Justice, Supreme Court, Place 6 Unexpired Term",,DEM,Larry Praeger,0,8,18,26
Waller,420,"Justice, Supreme Court, Place 6 Unexpired Term",,DEM,Ballots Cast,4,36,96,136
Waller,420,"Justice, Supreme Court, Place 6 Unexpired Term",,DEM,Under Votes,1,8,18,27
Waller,420,"Justice, Supreme Court, Place 6 Unexpired Term",,DEM,Over Votes,0,0,0,0
Waller,420,"Justice, Supreme Court, Place 7",,DEM,Staci Williams,4,21,58,83
Waller,420,"Justice, Supreme Court, Place 7",,DEM,Brandy Voss,0,16,34,50
Waller,420,"Justice, Supreme Court, Place 7",,DEM,Ballots Cast,4,37,92,133
Waller,420,"Justice, Supreme Court, Place 7",,DEM,Under Votes,1,7,22,30
Waller,420,"Justice, Supreme Court, Place 7",,DEM,Over Votes,0,0,0,0
Waller,420,"Justice, Supreme Court, Place 8",,DEM,Gisela D. Triana,2,24,65,91
Waller,420,"Justice, Supreme Court, Place 8",,DEM,Peter Kelly,2,14,27,43
Waller,420,"Justice, Supreme Court, Place 8",,DEM,Ballots Cast,4,38,92,134
Waller,420,"Justice, Supreme Court, Place 8",,DEM,Under Votes,1,6,22,29
Waller,420,"Justice, Supreme Court, Place 8",,DEM,Over Votes,0,0,0,0
Waller,420,"Judge, Court of Criminal Appeals, Place 3",,DEM,Elizabeth Davis Frizell,3,31,72,106
Waller,420,"Judge, Court of Criminal Appeals, Place 3",,DEM,William Pieratt Demond,1,2,6,9
Waller,420,"Judge, Court of Criminal Appeals, Place 3",,DEM,Dan Wood,0,4,14,18
Waller,420,"Judge, Court of Criminal Appeals, Place 3",,DEM,Ballots Cast,4,37,92,133
Waller,420,"Judge, Court of Criminal Appeals, Place 3",,DEM,Under Votes,1,7,22,30
Waller,420,"Judge, Court of Criminal Appeals, Place 3",,DEM,Over Votes,0,0,0,0
Waller,420,"Judge, Court of Criminal Appeals, Place 4",,DEM,Steven Miears,0,5,21,26
Waller,420,"Judge, Court of Criminal Appeals, Place 4",,DEM,Tina Clinton,4,30,70,104
Waller,420,"Judge, Court of Criminal Appeals, Place 4",,DEM,Ballots Cast,4,35,91,130
Waller,420,"Judge, Court of Criminal Appeals, Place 4",,DEM,Under Votes,1,9,23,33
Waller,420,"Judge, Court of Criminal Appeals, Place 4",,DEM,Over Votes,0,0,0,0
Waller,420,"Judge, Court of Criminal Appeals, Place 9",,DEM,Brandon Birmingham,2,33,83,118
Waller,420,"Judge, Court of Criminal Appeals, Place 9",,DEM,Ballots Cast,2,33,83,118
Waller,420,"Judge, Court of Criminal Appeals, Place 9",,DEM,Under Votes,3,11,31,45
Waller,420,"Judge, Court of Criminal Appeals, Place 9",,DEM,Over Votes,0,0,0,0
Waller,420,"Member, State Board of Education, District 10",,DEM,Stephen Wyman,0,5,9,14
Waller,420,"Member, State Board of Education, District 10",,DEM,Marsha Burnett-Webster,3,33,79,115
Waller,420,"Member, State Board of Education, District 10",,DEM,Ballots Cast,3,38,88,129
Waller,420,"Member, State Board of Education, District 10",,DEM,Under Votes,2,6,26,34
Waller,420,"Member, State Board of Education, District 10",,DEM,Over Votes,0,0,0,0
Waller,420,State Senate,18,DEM,Michael Antalan,2,32,86,120
Waller,420,State Senate,18,DEM,Ballots Cast,2,32,86,120
Waller,420,State Senate,18,DEM,Under Votes,3,12,28,43
Waller,420,State Senate,18,DEM,Over Votes,0,0,0,0
Waller,420,State Representative,3,DEM,Martin Shupp,2,33,85,120
Waller,420,State Representative,3,DEM,Ballots Cast,2,33,85,120
Waller,420,State Representative,3,DEM,Under Votes,3,11,29,43
Waller,420,State Representative,3,DEM,Over Votes,0,0,0,0
Waller,420,"Chief Justice, 14th Court of Appeals District",,DEM,Jane Robinson,3,33,81,117
Waller,420,"Chief Justice, 14th Court of Appeals District",,DEM,Jim Evans,0,5,11,16
Waller,420,"Chief Justice, 14th Court of Appeals District",,DEM,Ballots Cast,3,38,92,133
Waller,420,"Chief Justice, 14th Court of Appeals District",,DEM,Under Votes,2,6,22,30
Waller,420,"Chief Justice, 14th Court of Appeals District",,DEM,Over Votes,0,0,0,0
Waller,420,"Justice, 1st Court of Appeals District, Place 3",,DEM,Jim Sharp,1,6,14,21
Waller,420,"Justice, 1st Court of Appeals District, Place 3",,DEM,Dinesh Singhal,1,8,23,32
Waller,420,"Justice, 1st Court of Appeals District, Place 3",,DEM,Veronica Rivas-Molloy,2,23,55,80
Waller,420,"Justice, 1st Court of Appeals District, Place 3",,DEM,Ballots Cast,4,37,92,133
Waller,420,"Justice, 1st Court of Appeals District, Place 3",,DEM,Under Votes,1,7,22,30
Waller,420,"Justice, 1st Court of Appeals District, Place 3",,DEM,Over Votes,0,0,0,0
Waller,420,"Justice, 1st Court of Appeals District, Place 5",,DEM,Tim Hootman,0,9,30,39
Waller,420,"Justice, 1st Court of Appeals District, Place 5",,DEM,Amparo Monique Guerra,4,26,56,86
Waller,420,"Justice, 1st Court of Appeals District, Place 5",,DEM,Ballots Cast,4,35,86,125
Waller,420,"Justice, 1st Court of Appeals District, Place 5",,DEM,Under Votes,1,9,28,38
Waller,420,"Justice, 1st Court of Appeals District, Place 5",,DEM,Over Votes,0,0,0,0
Waller,420,"Justice, 14th Court of Appeals District, Place 7",,DEM,"Tamika ""Tami"" Craft",3,15,32,50
Waller,420,"Justice, 14th Court of Appeals District, Place 7",,DEM,Wally Kronzer,0,1,11,12
Waller,420,"Justice, 14th Court of Appeals District, Place 7",,DEM,V.R. Faulkner,0,2,3,5
Waller,420,"Justice, 14th Court of Appeals District, Place 7",,DEM,Cheri Thomas,1,14,25,40
Waller,420,"Justice, 14th Court of Appeals District, Place 7",,DEM,Dominic J. Merino,0,1,7,8
Waller,420,"Justice, 14th Court of Appeals District, Place 7",,DEM,Lennon C. Wright,0,4,7,11
Waller,420,"Justice, 14th Court of Appeals District, Place 7",,DEM,Ballots Cast,4,37,85,126
Waller,420,"Justice, 14th Court of Appeals District, Place 7",,DEM,Under Votes,1,7,29,37
Waller,420,"Justice, 14th Court of Appeals District, Place 7",,DEM,Over Votes,0,0,0,0
Waller,420,Sheriff,,DEM,Cedric D. Watson,2,35,84,121
Waller,420,Sheriff,,DEM,Ballots Cast,2,35,84,121
Waller,420,Sheriff,,DEM,Under Votes,3,9,30,42
Waller,420,Sheriff,,DEM,Over Votes,0,0,0,0
Waller,420,County Chairman,,DEM,Rosa Patlan Harris,2,38,87,127
Waller,420,County Chairman,,DEM,Ballots Cast,2,38,87,127
Waller,420,County Chairman,,DEM,Under Votes,3,6,27,36
Waller,420,County Chairman,,DEM,Over Votes,0,0,0,0
Waller,420,President,,REP,Donald J. Trump,31,101,200,332
Waller,420,President,,REP,Joe Walsh,0,1,3,4
Waller,420,President,,REP,Bob Ely,0,0,0,0
Waller,420,President,,REP,"Roque ""Rocky"" De La Fuente Guerra",0,0,0,0
Waller,420,President,,REP,Zoltan G. Istvan,0,0,0,0
Waller,420,President,,REP,Matthew John Matern,0,0,0,0
Waller,420,President,,REP,Bill Weld,0,0,4,4
Waller,420,President,,REP,Uncommitted,1,8,8,17
Waller,420,President,,REP,Ballots Cast,32,110,215,357
Waller,420,President,,REP,Under Votes,0,0,1,1
Waller,420,President,,REP,Over Votes,0,0,0,0
Waller,420,U.S. Senate,,REP,Dwayne Stovall,3,32,33,68
Waller,420,U.S. Senate,,REP,Mark Yancey,0,6,12,18
Waller,420,U.S. Senate,,REP,Virgil Bierschwale,0,0,0,0
Waller,420,U.S. Senate,,REP,John Anthony Castro,1,2,10,13
Waller,420,U.S. Senate,,REP,John Cornyn,28,68,148,244
Waller,420,U.S. Senate,,REP,Ballots Cast,32,108,203,343
Waller,420,U.S. Senate,,REP,Under Votes,0,2,13,15
Waller,420,U.S. Senate,,REP,Over Votes,0,0,0,0
Waller,420,U.S. House,10,REP,Michael McCaul,31,108,199,338
Waller,420,U.S. House,10,REP,Ballots Cast,31,108,199,338
Waller,420,U.S. House,10,REP,Under Votes,1,2,17,20
Waller,420,U.S. House,10,REP,Over Votes,0,0,0,0
Waller,420,Railroad Commissioner,,REP,Ryan Sitton,21,59,92,172
Waller,420,Railroad Commissioner,,REP,"James ""Jim"" Wright",10,43,92,145
Waller,420,Railroad Commissioner,,REP,Ballots Cast,31,102,184,317
Waller,420,Railroad Commissioner,,REP,Under Votes,1,8,32,41
Waller,420,Railroad Commissioner,,REP,Over Votes,0,0,0,0
Waller,420,"Chief Justice, Supreme Court",,REP,Nathan Hecht,31,101,185,317
Waller,420,"Chief Justice, Supreme Court",,REP,Ballots Cast,31,101,185,317
Waller,420,"Chief Justice, Supreme Court",,REP,Under Votes,1,9,31,41
Waller,420,"Chief Justice, Supreme Court",,REP,Over Votes,0,0,0,0
Waller,420,"Justice, Supreme Court, Place 6 Unexpired Term",,REP,Jane Bland,30,100,180,310
Waller,420,"Justice, Supreme Court, Place 6 Unexpired Term",,REP,Ballots Cast,30,100,180,310
Waller,420,"Justice, Supreme Court, Place 6 Unexpired Term",,REP,Under Votes,2,10,36,48
Waller,420,"Justice, Supreme Court, Place 6 Unexpired Term",,REP,Over Votes,0,0,0,0
Waller,420,"Justice, Supreme Court, Place 7",,REP,Jeff Boyd,30,100,181,311
Waller,420,"Justice, Supreme Court, Place 7",,REP,Ballots Cast,30,100,181,311
Waller,420,"Justice, Supreme Court, Place 7",,REP,Under Votes,2,10,35,47
Waller,420,"Justice, Supreme Court, Place 7",,REP,Over Votes,0,0,0,0
Waller,420,"Justice, Supreme Court, Place 8",,REP,Brett Busby,30,100,180,310
Waller,420,"Justice, Supreme Court, Place 8",,REP,Ballots Cast,30,100,180,310
Waller,420,"Justice, Supreme Court, Place 8",,REP,Under Votes,2,10,36,48
Waller,420,"Justice, Supreme Court, Place 8",,REP,Over Votes,0,0,0,0
Waller,420,"Judge, Court of Criminal Appeals, Place 3",,REP,Gina Parker,17,49,95,161
Waller,420,"Judge, Court of Criminal Appeals, Place 3",,REP,Bert Richardson,10,45,72,127
Waller,420,"Judge, Court of Criminal Appeals, Place 3",,REP,Ballots Cast,27,94,167,288
Waller,420,"Judge, Court of Criminal Appeals, Place 3",,REP,Under Votes,5,16,49,70
Waller,420,"Judge, Court of Criminal Appeals, Place 3",,REP,Over Votes,0,0,0,0
Waller,420,"Judge, Court of Criminal Appeals, Place 4",,REP,Kevin Patrick Yeary,27,95,180,302
Waller,420,"Judge, Court of Criminal Appeals, Place 4",,REP,Ballots Cast,27,95,180,302
Waller,420,"Judge, Court of Criminal Appeals, Place 4",,REP,Under Votes,5,15,36,56
Waller,420,"Judge, Court of Criminal Appeals, Place 4",,REP,Over Votes,0,0,0,0
Waller,420,"Judge, Court of Criminal Appeals, Place 9",,REP,David Newell,28,96,181,305
Waller,420,"Judge, Court of Criminal Appeals, Place 9",,REP,Ballots Cast,28,96,181,305
Waller,420,"Judge, Court of Criminal Appeals, Place 9",,REP,Under Votes,4,14,35,53
Waller,420,"Judge, Court of Criminal Appeals, Place 9",,REP,Over Votes,0,0,0,0
Waller,420,"Member, State Board of Education, District 10",,REP,Tom Maynard,28,96,180,304
Waller,420,"Member, State Board of Education, District 10",,REP,Ballots Cast,28,96,180,304
Waller,420,"Member, State Board of Education, District 10",,REP,Under Votes,4,14,36,54
Waller,420,"Member, State Board of Education, District 10",,REP,Over Votes,0,0,0,0
Waller,420,State Senate,18,REP,Lois W. Kolkhorst,30,101,183,314
Waller,420,State Senate,18,REP,Ballots Cast,30,101,183,314
Waller,420,State Senate,18,REP,Under Votes,2,9,33,44
Waller,420,State Senate,18,REP,Over Votes,0,0,0,0
Waller,420,State Representative,3,REP,Cecil Bell Jr,30,102,184,316
Waller,420,State Representative,3,REP,Ballots Cast,30,102,184,316
Waller,420,State Representative,3,REP,Under Votes,2,8,32,42
Waller,420,State Representative,3,REP,Over Votes,0,0,0,0
Waller,420,"Chief Justice, 14th Court of Appeals District",,REP,Tracy Elizabeth Christopher,28,97,176,301
Waller,420,"Chief Justice, 14th Court of Appeals District",,REP,Ballots Cast,28,97,176,301
Waller,420,"Chief Justice, 14th Court of Appeals District",,REP,Under Votes,4,13,40,57
Waller,420,"Chief Justice, 14th Court of Appeals District",,REP,Over Votes,0,0,0,0
Waller,420,"Justice, 1st Court of Appeals District, Place 3",,REP,Russell Lloyd,25,96,178,299
Waller,420,"Justice, 1st Court of Appeals District, Place 3",,REP,Ballots Cast,25,96,178,299
Waller,420,"Justice, 1st Court of Appeals District, Place 3",,REP,Under Votes,7,14,38,59
Waller,420,"Justice, 1st Court of Appeals District, Place 3",,REP,Over Votes,0,0,0,0
Waller,420,"Justice, 1st Court of Appeals District, Place 5",,REP,Chad Bridges,3,24,43,70
Waller,420,"Justice, 1st Court of Appeals District, Place 5",,REP,James Lombardino,2,15,24,41
Waller,420,"Justice, 1st Court of Appeals District, Place 5",,REP,Levi J. Benton,3,5,23,31
Waller,420,"Justice, 1st Court of Appeals District, Place 5",,REP,Terry Adams,21,37,68,126
Waller,420,"Justice, 1st Court of Appeals District, Place 5",,REP,Ballots Cast,29,81,158,268
Waller,420,"Justice, 1st Court of Appeals District, Place 5",,REP,Under Votes,3,29,58,90
Waller,420,"Justice, 1st Court of Appeals District, Place 5",,REP,Over Votes,0,0,0,0
Waller,420,"Justice, 14th Court of Appeals District, Place 7",,REP,Ken Wise,26,97,176,299
Waller,420,"Justice, 14th Court of Appeals District, Place 7",,REP,Ballots Cast,26,97,176,299
Waller,420,"Justice, 14th Court of Appeals District, Place 7",,REP,Under Votes,6,13,40,59
Waller,420,"Justice, 14th Court of Appeals District, Place 7",,REP,Over Votes,0,0,0,0
Waller,420,"District Judge, 506th Judicial District",,REP,Gary W. Chaney,27,100,176,303
Waller,420,"District Judge, 506th Judicial District",,REP,Ballots Cast,27,100,176,303
Waller,420,"District Judge, 506th Judicial District",,REP,Under Votes,5,10,40,55
Waller,420,"District Judge, 506th Judicial District",,REP,Over Votes,0,0,0,0
Waller,420,Sheriff,,REP,Dan Porter,4,28,66,98
Waller,420,Sheriff,,REP,R. Glenn Smith,20,47,83,150
Waller,420,Sheriff,,REP,Troy Guidry,6,27,46,79
Waller,420,Sheriff,,REP,Ballots Cast,30,102,195,327
Waller,420,Sheriff,,REP,Under Votes,2,8,21,31
Waller,420,Sheriff,,REP,Over Votes,0,0,0,0
Waller,420,County Tax Assessor-Collector,,REP,Ellen Contreras Shelburne,24,74,87,185
Waller,420,County Tax Assessor-Collector,,REP,Carolyn Miedke,5,23,94,122
Waller,420,County Tax Assessor-Collector,,REP,Ballots Cast,29,97,181,307
Waller,420,County Tax Assessor-Collector,,REP,Under Votes,3,13,35,51
Waller,420,County Tax Assessor-Collector,,REP,Over Votes,0,0,0,0
Waller,420,"Constable, Precinct 4",,REP,Joe Trimm Jr,25,96,179,300
Waller,420,"Constable, Precinct 4",,REP,Ballots Cast,25,96,179,300
Waller,420,"Constable, Precinct 4",,REP,Under Votes,7,14,37,58
Waller,420,"Constable, Precinct 4",,REP,Over Votes,0,0,0,0
Waller,420,County Chairman,,REP,David W. Luther,27,96,176,299
Waller,420,County Chairman,,REP,Ballots Cast,27,96,176,299
Waller,420,County Chairman,,REP,Under Votes,5,14,40,59
Waller,420,County Chairman,,REP,Over Votes,0,0,0,0
Waller,420,Proposition #1,,DEM,Yes,4,38,101,143
Waller,420,Proposition #1,,DEM,No,1,3,9,13
Waller,420,Proposition #1,,DEM,Ballots Cast,5,41,110,156
Waller,420,Proposition #1,,DEM,Under Votes,0,3,4,7
Waller,420,Proposition #1,,DEM,Over Votes,0,0,0,0
Waller,420,Proposition #2,,DEM,Yes,5,39,110,154
Waller,420,Proposition #2,,DEM,No,0,3,2,5
Waller,420,Proposition #2,,DEM,Ballots Cast,5,42,112,159
Waller,420,Proposition #2,,DEM,Under Votes,0,2,2,4
Waller,420,Proposition #2,,DEM,Over Votes,0,0,0,0
Waller,420,Proposition #3,,DEM,Yes,5,42,110,157
Waller,420,Proposition #3,,DEM,No,0,0,1,1
Waller,420,Proposition #3,,DEM,Ballots Cast,5,42,111,158
Waller,420,Proposition #3,,DEM,Under Votes,0,2,3,5
Waller,420,Proposition #3,,DEM,Over Votes,0,0,0,0
Waller,420,Proposition #4,,DEM,Yes,5,38,104,147
Waller,420,Proposition #4,,DEM,No,0,4,6,10
Waller,420,Proposition #4,,DEM,Ballots Cast,5,42,110,157
Waller,420,Proposition #4,,DEM,Under Votes,0,2,4,6
Waller,420,Proposition #4,,DEM,Over Votes,0,0,0,0
Waller,420,Proposition #5,,DEM,Yes,5,41,110,156
Waller,420,Proposition #5,,DEM,No,0,1,1,2
Waller,420,Proposition #5,,DEM,Ballots Cast,5,42,111,158
Waller,420,Proposition #5,,DEM,Under Votes,0,2,3,5
Waller,420,Proposition #5,,DEM,Over Votes,0,0,0,0
Waller,420,Proposition #6,,DEM,Yes,5,42,110,157
Waller,420,Proposition #6,,DEM,No,0,0,1,1
Waller,420,Proposition #6,,DEM,Ballots Cast,5,42,111,158
Waller,420,Proposition #6,,DEM,Under Votes,0,2,3,5
Waller,420,Proposition #6,,DEM,Over Votes,0,0,0,0
Waller,420,Proposition #7,,DEM,Yes,5,39,105,149
Waller,420,Proposition #7,,DEM,No,0,3,5,8
Waller,420,Proposition #7,,DEM,Ballots Cast,5,42,110,157
Waller,420,Proposition #7,,DEM,Under Votes,0,2,4,6
Waller,420,Proposition #7,,DEM,Over Votes,0,0,0,0
Waller,420,Proposition #8,,DEM,Yes,5,38,108,151
Waller,420,Proposition #8,,DEM,No,0,4,2,6
Waller,420,Proposition #8,,DEM,Ballots Cast,5,42,110,157
Waller,420,Proposition #8,,DEM,Under Votes,0,2,4,6
Waller,420,Proposition #8,,DEM,Over Votes,0,0,0,0
Waller,420,Proposition #9,,DEM,Yes,5,41,107,153
Waller,420,Proposition #9,,DEM,No,0,1,3,4
Waller,420,Proposition #9,,DEM,Ballots Cast,5,42,110,157
Waller,420,Proposition #9,,DEM,Under Votes,0,2,4,6
Waller,420,Proposition #9,,DEM,Over Votes,0,0,0,0
Waller,420,Proposition #10,,DEM,Yes,5,40,103,148
Waller,420,Proposition #10,,DEM,No,0,2,7,9
Waller,420,Proposition #10,,DEM,Ballots Cast,5,42,110,157
Waller,420,Proposition #10,,DEM,Under Votes,0,2,4,6
Waller,420,Proposition #10,,DEM,Over Votes,0,0,0,0
Waller,420,Proposition #11,,DEM,Yes,5,39,101,145
Waller,420,Proposition #11,,DEM,No,0,3,8,11
Waller,420,Proposition #11,,DEM,Ballots Cast,5,42,109,156
Waller,420,Proposition #11,,DEM,Under Votes,0,2,5,7
Waller,420,Proposition #11,,DEM,Over Votes,0,0,0,0
Waller,420,Proposition 1,,REP,Yes,28,104,197,329
Waller,420,Proposition 1,,REP,No,3,6,16,25
Waller,420,Proposition 1,,REP,Ballots Cast,31,110,213,354
Waller,420,Proposition 1,,REP,Under Votes,1,0,3,4
Waller,420,Proposition 1,,REP,Over Votes,0,0,0,0
Waller,420,Proposition 2,,REP,Yes,29,100,185,314
Waller,420,Proposition 2,,REP,No,2,8,28,38
Waller,420,Proposition 2,,REP,Ballots Cast,31,108,213,352
Waller,420,Proposition 2,,REP,Under Votes,1,2,3,6
Waller,420,Proposition 2,,REP,Over Votes,0,0,0,0
Waller,420,Proposition 3,,REP,Yes,31,104,201,336
Waller,420,Proposition 3,,REP,No,0,5,8,13
Waller,420,Proposition 3,,REP,Ballots Cast,31,109,209,349
Waller,420,Proposition 3,,REP,Under Votes,1,1,7,9
Waller,420,Proposition 3,,REP,Over Votes,0,0,0,0
Waller,420,Proposition 4,,REP,Yes,31,101,203,335
Waller,420,Proposition 4,,REP,No,0,8,10,18
Waller,420,Proposition 4,,REP,Ballots Cast,31,109,213,353
Waller,420,Proposition 4,,REP,Under Votes,1,1,3,5
Waller,420,Proposition 4,,REP,Over Votes,0,0,0,0
Waller,420,Proposition 5,,REP,Yes,28,100,195,323
Waller,420,Proposition 5,,REP,No,3,9,17,29
Waller,420,Proposition 5,,REP,Ballots Cast,31,109,212,352
Waller,420,Proposition 5,,REP,Under Votes,1,1,4,6
Waller,420,Proposition 5,,REP,Over Votes,0,0,0,0
Waller,420,Proposition 6,,REP,Yes,30,105,203,338
Waller,420,Proposition 6,,REP,No,0,3,9,12
Waller,420,Proposition 6,,REP,Ballots Cast,30,108,212,350
Waller,420,Proposition 6,,REP,Under Votes,2,2,4,8
Waller,420,Proposition 6,,REP,Over Votes,0,0,0,0
Waller,420,Proposition 7,,REP,Yes,31,108,207,346
Waller,420,Proposition 7,,REP,No,0,0,2,2
Waller,420,Proposition 7,,REP,Ballots Cast,31,108,209,348
Waller,420,Proposition 7,,REP,Under Votes,1,2,7,10
Waller,420,Proposition 7,,REP,Over Votes,0,0,0,0
Waller,420,Proposition 8,,REP,Yes,31,107,209,347
Waller,420,Proposition 8,,REP,No,0,1,3,4
Waller,420,Proposition 8,,REP,Ballots Cast,31,108,212,351
Waller,420,Proposition 8,,REP,Under Votes,1,2,4,7
Waller,420,Proposition 8,,REP,Over Votes,0,0,0,0
Waller,420,Proposition 9,,REP,Yes,31,104,205,340
Waller,420,Proposition 9,,REP,No,0,3,5,8
Waller,420,Proposition 9,,REP,Ballots Cast,31,107,210,348
Waller,420,Proposition 9,,REP,Under Votes,1,3,6,10
Waller,420,Proposition 9,,REP,Over Votes,0,0,0,0
Waller,420,Proposition 10,,REP,Yes,29,102,196,327
Waller,420,Proposition 10,,REP,No,2,2,11,15
Waller,420,Proposition 10,,REP,Ballots Cast,31,104,207,342
Waller,420,Proposition 10,,REP,Under Votes,1,6,9,16
Waller,420,Proposition 10,,REP,Over Votes,0,0,0,0