county,precinct,office,district,party,candidate,votes,early_votes,election_day,absentee
Ector,101,President,,REP,Donald J. Trump / Michael R. Pence,2167,1688,479,0
Ector,101,President,,REP,Over Votes,0,0,0,0
Ector,101,President,,REP,Under Votes,26,21,5,0
Ector,101,President,,DEM,Joseph R. Biden / Kamala D. Harris,576,430,146,0
Ector,101,President,,LIB,"Jo Jorgensen / Jeremy ""Spike"" Cohen",21,15,6,0
Ector,101,President,,GRN,Howie Hawkins / Angela Walker,3,1,2,0
Ector,101,President,,,President R. Boddie/Eric C. Stoneham,0,0,0,0
Ector,101,President,,,Brian Carroll/Amar Patel,0,0,0,0
Ector,101,President,,,Todd Cella/Tim Cella,0,0,0,0
Ector,101,President,,,Jesse Cuellar/Jimmy Monreal,0,0,0,0
Ector,101,President,,,Tom Hoefling/Andy Prior,0,0,0,0
Ector,101,President,,,Gloria La Riva/Leonard Peltier,0,0,0,0
Ector,101,President,,,Abram Loeb/Jennifer Jairala,0,0,0,0
Ector,101,President,,,Robert Morrow/Anne Beckett,0,0,0,0
Ector,101,President,,,Kasey Wells/Rachel Wells,0,0,0,0
Ector,101,U.S. Senate,,REP,John Cornyn,2062,1632,430,0
Ector,101,U.S. Senate,,REP,Over Votes,0,0,0,0
Ector,101,U.S. Senate,,REP,Under Votes,96,77,19,0
Ector,101,U.S. Senate,,DEM,"Mary ""MJ"" Hegar",563,402,161,0
Ector,101,U.S. Senate,,LIB,Kerry Douglas McKennon,56,34,22,0
Ector,101,U.S. Senate,,GRN,David B. Collins,16,10,6,0
Ector,101,U.S. Senate,,,Ricardo Turullols-Bonilla,0,0,0,0
Ector,101,U.S. House,11,REP,August Pfluger,2075,1633,442,0
Ector,101,U.S. House,11,REP,Over Votes,0,0,0,0
Ector,101,U.S. House,11,REP,Under Votes,112,91,21,0
Ector,101,U.S. House,11,DEM,Jon Mark Hogg,553,393,160,0
Ector,101,U.S. House,11,LIB,Wacey Alpha Cody,53,38,15,0
Ector,101,Railroad Commissioner,,REP,"James ""Jim"" Wright",2038,1612,426,0
Ector,101,Railroad Commissioner,,REP,Over Votes,0,0,0,0
Ector,101,Railroad Commissioner,,REP,Under Votes,98,80,18,0
Ector,101,Railroad Commissioner,,DEM,Chrysta Castañeda,584,414,170,0
Ector,101,Railroad Commissioner,,LIB,Matt Sterett,53,35,18,0
Ector,101,Railroad Commissioner,,GRN,"Katija ""Kat"" Gruene",20,14,6,0
Ector,101,"Chief Justice, Supreme Court",,REP,Nathan Hecht,2034,1604,430,0
Ector,101,"Chief Justice, Supreme Court",,REP,Over Votes,0,0,0,0
Ector,101,"Chief Justice, Supreme Court",,REP,Under Votes,100,81,19,0
Ector,101,"Chief Justice, Supreme Court",,DEM,Amy Clark Meachum,604,435,169,0
Ector,101,"Chief Justice, Supreme Court",,LIB,Mark Ash,55,35,20,0
Ector,101,"Justice, Supreme Court, Place 6, (Unexpired Term)",,REP,Jane Bland,2106,1656,450,0
Ector,101,"Justice, Supreme Court, Place 6, (Unexpired Term)",,REP,Over Votes,0,0,0,0
Ector,101,"Justice, Supreme Court, Place 6, (Unexpired Term)",,REP,Under Votes,109,89,20,0
Ector,101,"Justice, Supreme Court, Place 6, (Unexpired Term)",,DEM,Kathy Cheng,578,410,168,0
Ector,101,"Justice, Supreme Court, Place 7",,REP,Jeff Boyd,2045,1608,437,0
Ector,101,"Justice, Supreme Court, Place 7",,REP,Over Votes,0,0,0,0
Ector,101,"Justice, Supreme Court, Place 7",,REP,Under Votes,107,87,20,0
Ector,101,"Justice, Supreme Court, Place 7",,DEM,Staci Williams,582,420,162,0
Ector,101,"Justice, Supreme Court, Place 7",,LIB,William Bryan Strange III,59,40,19,0
Ector,101,"Justice, Supreme Court, Place 8",,REP,Brett Busby,2028,1596,432,0
Ector,101,"Justice, Supreme Court, Place 8",,REP,Over Votes,0,0,0,0
Ector,101,"Justice, Supreme Court, Place 8",,REP,Under Votes,100,81,19,0
Ector,101,"Justice, Supreme Court, Place 8",,DEM,Gisela D. Triana,608,437,171,0
Ector,101,"Justice, Supreme Court, Place 8",,LIB,Tom Oxford,57,41,16,0
Ector,101,"Judge, Court of Criminal Appeals, Place 3",,REP,Bert Richardson,2073,1632,441,0
Ector,101,"Judge, Court of Criminal Appeals, Place 3",,REP,Over Votes,0,0,0,0
Ector,101,"Judge, Court of Criminal Appeals, Place 3",,REP,Under Votes,107,85,22,0
Ector,101,"Judge, Court of Criminal Appeals, Place 3",,DEM,Elizabeth Davis Frizell,613,438,175,0
Ector,101,"Judge, Court of Criminal Appeals, Place 4",,REP,Kevin Patrick Yeary,2093,1638,455,0
Ector,101,"Judge, Court of Criminal Appeals, Place 4",,REP,Over Votes,0,0,0,0
Ector,101,"Judge, Court of Criminal Appeals, Place 4",,REP,Under Votes,108,88,20,0
Ector,101,"Judge, Court of Criminal Appeals, Place 4",,DEM,Tina Clinton,592,429,163,0
Ector,101,"Judge, Court of Criminal Appeals, Place 9",,REP,David Newell,2099,1645,454,0
Ector,101,"Judge, Court of Criminal Appeals, Place 9",,REP,Over Votes,0,0,0,0
Ector,101,"Judge, Court of Criminal Appeals, Place 9",,REP,Under Votes,113,93,20,0
Ector,101,"Judge, Court of Criminal Appeals, Place 9",,DEM,Brandon Birmingham,581,417,164,0
Ector,101,"Member, State Board of Education, District 1",,REP,Jennifer Ivey,2049,1610,439,0
Ector,101,"Member, State Board of Education, District 1",,REP,Over Votes,0,0,0,0
Ector,101,"Member, State Board of Education, District 1",,REP,Under Votes,112,94,18,0
Ector,101,"Member, State Board of Education, District 1",,DEM,Georgina Perez,632,451,181,0
Ector,101,State Representative,81,REP,Brooks Landgraf,2370,1825,545,0
Ector,101,State Representative,81,REP,Over Votes,0,0,0,0
Ector,101,State Representative,81,REP,Under Votes,423,330,93,0
Ector,101,"Justice, 11th Court of Appeals District, Place 2",,REP,Bruce Williams,2326,1787,539,0
Ector,101,"Justice, 11th Court of Appeals District, Place 2",,REP,Over Votes,0,0,0,0
Ector,101,"Justice, 11th Court of Appeals District, Place 2",,REP,Under Votes,467,368,99,0
Ector,101,"Justice, 11th Court of Appeals District, Place 3 (Unexpired Term)",,REP,W. Stacy Trotter,2306,1776,530,0
Ector,101,"Justice, 11th Court of Appeals District, Place 3 (Unexpired Term)",,REP,Over Votes,0,0,0,0
Ector,101,"Justice, 11th Court of Appeals District, Place 3 (Unexpired Term)",,REP,Under Votes,487,379,108,0
Ector,101,"District Judge, 161st Judicial District",,REP,Justin Low,2285,1749,536,0
Ector,101,"District Judge, 161st Judicial District",,REP,Over Votes,0,0,0,0
Ector,101,"District Judge, 161st Judicial District",,REP,Under Votes,508,406,102,0
Ector,101,"District Judge, 446th Judicial District",,REP,Sara Kate Billingsley,2309,1776,533,0
Ector,101,"District Judge, 446th Judicial District",,REP,Over Votes,0,0,0,0
Ector,101,"District Judge, 446th Judicial District",,REP,Under Votes,484,379,105,0
Ector,101,"District Attorney, 70th Judicial District",,REP,Dusty Gallivan,2322,1788,534,0
Ector,101,"District Attorney, 70th Judicial District",,REP,Over Votes,0,0,0,0
Ector,101,"District Attorney, 70th Judicial District",,REP,Under Votes,471,367,104,0
Ector,102,President,,REP,Donald J. Trump / Michael R. Pence,1390,1019,371,0
Ector,102,President,,REP,Over Votes,0,0,0,0
Ector,102,President,,REP,Under Votes,12,7,5,0
Ector,102,President,,DEM,Joseph R. Biden / Kamala D. Harris,493,384,109,0
Ector,102,President,,LIB,"Jo Jorgensen / Jeremy ""Spike"" Cohen",17,11,6,0
Ector,102,President,,GRN,Howie Hawkins / Angela Walker,4,1,3,0
Ector,102,President,,,President R. Boddie/Eric C. Stoneham,0,0,0,0
Ector,102,President,,,Brian Carroll/Amar Patel,0,0,0,0
Ector,102,President,,,Todd Cella/Tim Cella,0,0,0,0
Ector,102,President,,,Jesse Cuellar/Jimmy Monreal,0,0,0,0
Ector,102,President,,,Tom Hoefling/Andy Prior,0,0,0,0
Ector,102,President,,,Gloria La Riva/Leonard Peltier,0,0,0,0
Ector,102,President,,,Abram Loeb/Jennifer Jairala,0,0,0,0
Ector,102,President,,,Robert Morrow/Anne Beckett,0,0,0,0
Ector,102,President,,,Kasey Wells/Rachel Wells,0,0,0,0
Ector,102,U.S. Senate,,REP,John Cornyn,1314,971,343,0
Ector,102,U.S. Senate,,REP,Over Votes,1,1,0,0
Ector,102,U.S. Senate,,REP,Under Votes,80,63,17,0
Ector,102,U.S. Senate,,DEM,"Mary ""MJ"" Hegar",473,359,114,0
Ector,102,U.S. Senate,,LIB,Kerry Douglas McKennon,28,18,10,0
Ector,102,U.S. Senate,,GRN,David B. Collins,20,10,10,0
Ector,102,U.S. Senate,,,Ricardo Turullols-Bonilla,0,0,0,0
Ector,102,U.S. House,11,REP,August Pfluger,1324,975,349,0
Ector,102,U.S. House,11,REP,Over Votes,0,0,0,0
Ector,102,U.S. House,11,REP,Under Votes,91,72,19,0
Ector,102,U.S. House,11,DEM,Jon Mark Hogg,457,342,115,0
Ector,102,U.S. House,11,LIB,Wacey Alpha Cody,44,33,11,0
Ector,102,Railroad Commissioner,,REP,"James ""Jim"" Wright",1296,949,347,0
Ector,102,Railroad Commissioner,,REP,Over Votes,0,0,0,0
Ector,102,Railroad Commissioner,,REP,Under Votes,92,75,17,0
Ector,102,Railroad Commissioner,,DEM,Chrysta Castañeda,486,368,118,0
Ector,102,Railroad Commissioner,,LIB,Matt Sterett,34,25,9,0
Ector,102,Railroad Commissioner,,GRN,"Katija ""Kat"" Gruene",8,5,3,0
Ector,102,"Chief Justice, Supreme Court",,REP,Nathan Hecht,1288,959,329,0
Ector,102,"Chief Justice, Supreme Court",,REP,Over Votes,0,0,0,0
Ector,102,"Chief Justice, Supreme Court",,REP,Under Votes,96,75,21,0
Ector,102,"Chief Justice, Supreme Court",,DEM,Amy Clark Meachum,487,360,127,0
Ector,102,"Chief Justice, Supreme Court",,LIB,Mark Ash,45,28,17,0
Ector,102,"Justice, Supreme Court, Place 6, (Unexpired Term)",,REP,Jane Bland,1333,980,353,0
Ector,102,"Justice, Supreme Court, Place 6, (Unexpired Term)",,REP,Over Votes,0,0,0,0
Ector,102,"Justice, Supreme Court, Place 6, (Unexpired Term)",,REP,Under Votes,102,82,20,0
Ector,102,"Justice, Supreme Court, Place 6, (Unexpired Term)",,DEM,Kathy Cheng,481,360,121,0
Ector,102,"Justice, Supreme Court, Place 7",,REP,Jeff Boyd,1311,966,345,0
Ector,102,"Justice, Supreme Court, Place 7",,REP,Over Votes,0,0,0,0
Ector,102,"Justice, Supreme Court, Place 7",,REP,Under Votes,103,81,22,0
Ector,102,"Justice, Supreme Court, Place 7",,DEM,Staci Williams,471,353,118,0
Ector,102,"Justice, Supreme Court, Place 7",,LIB,William Bryan Strange III,31,22,9,0
Ector,102,"Justice, Supreme Court, Place 8",,REP,Brett Busby,1272,943,329,0
Ector,102,"Justice, Supreme Court, Place 8",,REP,Over Votes,0,0,0,0
Ector,102,"Justice, Supreme Court, Place 8",,REP,Under Votes,105,83,22,0
Ector,102,"Justice, Supreme Court, Place 8",,DEM,Gisela D. Triana,498,366,132,0
Ector,102,"Justice, Supreme Court, Place 8",,LIB,Tom Oxford,41,30,11,0
Ector,102,"Judge, Court of Criminal Appeals, Place 3",,REP,Bert Richardson,1303,956,347,0
Ector,102,"Judge, Court of Criminal Appeals, Place 3",,REP,Over Votes,0,0,0,0
Ector,102,"Judge, Court of Criminal Appeals, Place 3",,REP,Under Votes,103,81,22,0
Ector,102,"Judge, Court of Criminal Appeals, Place 3",,DEM,Elizabeth Davis Frizell,510,385,125,0
Ector,102,"Judge, Court of Criminal Appeals, Place 4",,REP,Kevin Patrick Yeary,1325,976,349,0
Ector,102,"Judge, Court of Criminal Appeals, Place 4",,REP,Over Votes,0,0,0,0
Ector,102,"Judge, Court of Criminal Appeals, Place 4",,REP,Under Votes,105,82,23,0
Ector,102,"Judge, Court of Criminal Appeals, Place 4",,DEM,Tina Clinton,486,364,122,0
Ector,102,"Judge, Court of Criminal Appeals, Place 9",,REP,David Newell,1338,982,356,0
Ector,102,"Judge, Court of Criminal Appeals, Place 9",,REP,Over Votes,0,0,0,0
Ector,102,"Judge, Court of Criminal Appeals, Place 9",,REP,Under Votes,102,79,23,0
Ector,102,"Judge, Court of Criminal Appeals, Place 9",,DEM,Brandon Birmingham,476,361,115,0
Ector,102,"Member, State Board of Education, District 1",,REP,Jennifer Ivey,1292,956,336,0
Ector,102,"Member, State Board of Education, District 1",,REP,Over Votes,0,0,0,0
Ector,102,"Member, State Board of Education, District 1",,REP,Under Votes,103,80,23,0
Ector,102,"Member, State Board of Education, District 1",,DEM,Georgina Perez,521,386,135,0
Ector,102,State Representative,81,REP,Brooks Landgraf,1587,1161,426,0
Ector,102,State Representative,81,REP,Over Votes,0,0,0,0
Ector,102,State Representative,81,REP,Under Votes,329,261,68,0
Ector,102,"Justice, 11th Court of Appeals District, Place 2",,REP,Bruce Williams,1561,1140,421,0
Ector,102,"Justice, 11th Court of Appeals District, Place 2",,REP,Over Votes,0,0,0,0
Ector,102,"Justice, 11th Court of Appeals District, Place 2",,REP,Under Votes,355,282,73,0
Ector,102,"Justice, 11th Court of Appeals District, Place 3 (Unexpired Term)",,REP,W. Stacy Trotter,1563,1151,412,0
Ector,102,"Justice, 11th Court of Appeals District, Place 3 (Unexpired Term)",,REP,Over Votes,0,0,0,0
Ector,102,"Justice, 11th Court of Appeals District, Place 3 (Unexpired Term)",,REP,Under Votes,353,271,82,0
Ector,102,"District Judge, 161st Judicial District",,REP,Justin Low,1551,1139,412,0
Ector,102,"District Judge, 161st Judicial District",,REP,Over Votes,0,0,0,0
Ector,102,"District Judge, 161st Judicial District",,REP,Under Votes,365,283,82,0
Ector,102,"District Judge, 446th Judicial District",,REP,Sara Kate Billingsley,1560,1140,420,0
Ector,102,"District Judge, 446th Judicial District",,REP,Over Votes,0,0,0,0
Ector,102,"District Judge, 446th Judicial District",,REP,Under Votes,356,282,74,0
Ector,102,"District Attorney, 70th Judicial District",,REP,Dusty Gallivan,1574,1157,417,0
Ector,102,"District Attorney, 70th Judicial District",,REP,Over Votes,0,0,0,0
Ector,102,"District Attorney, 70th Judicial District",,REP,Under Votes,342,265,77,0
Ector,103,President,,REP,Donald J. Trump / Michael R. Pence,740,565,175,0
Ector,103,President,,REP,Over Votes,0,0,0,0
Ector,103,President,,REP,Under Votes,6,5,1,0
Ector,103,President,,DEM,Joseph R. Biden / Kamala D. Harris,199,147,52,0
Ector,103,President,,LIB,"Jo Jorgensen / Jeremy ""Spike"" Cohen",6,4,2,0
Ector,103,President,,GRN,Howie Hawkins / Angela Walker,2,1,1,0
Ector,103,President,,,President R. Boddie/Eric C. Stoneham,0,0,0,0
Ector,103,President,,,Brian Carroll/Amar Patel,0,0,0,0
Ector,103,President,,,Todd Cella/Tim Cella,0,0,0,0
Ector,103,President,,,Jesse Cuellar/Jimmy Monreal,0,0,0,0
Ector,103,President,,,Tom Hoefling/Andy Prior,0,0,0,0
Ector,103,President,,,Gloria La Riva/Leonard Peltier,0,0,0,0
Ector,103,President,,,Abram Loeb/Jennifer Jairala,0,0,0,0
Ector,103,President,,,Robert Morrow/Anne Beckett,0,0,0,0
Ector,103,President,,,Kasey Wells/Rachel Wells,0,0,0,0
Ector,103,U.S. Senate,,REP,John Cornyn,696,537,159,0
Ector,103,U.S. Senate,,REP,Over Votes,0,0,0,0
Ector,103,U.S. Senate,,REP,Under Votes,40,31,9,0
Ector,103,U.S. Senate,,DEM,"Mary ""MJ"" Hegar",195,140,55,0
Ector,103,U.S. Senate,,LIB,Kerry Douglas McKennon,17,12,5,0
Ector,103,U.S. Senate,,GRN,David B. Collins,5,2,3,0
Ector,103,U.S. Senate,,,Ricardo Turullols-Bonilla,0,0,0,0
Ector,103,U.S. House,11,REP,August Pfluger,702,538,164,0
Ector,103,U.S. House,11,REP,Over Votes,0,0,0,0
Ector,103,U.S. House,11,REP,Under Votes,46,38,8,0
Ector,103,U.S. House,11,DEM,Jon Mark Hogg,180,128,52,0
Ector,103,U.S. House,11,LIB,Wacey Alpha Cody,25,18,7,0
Ector,103,Railroad Commissioner,,REP,"James ""Jim"" Wright",691,540,151,0
Ector,103,Railroad Commissioner,,REP,Over Votes,0,0,0,0
Ector,103,Railroad Commissioner,,REP,Under Votes,41,33,8,0
Ector,103,Railroad Commissioner,,DEM,Chrysta Castañeda,192,132,60,0
Ector,103,Railroad Commissioner,,LIB,Matt Sterett,19,11,8,0
Ector,103,Railroad Commissioner,,GRN,"Katija ""Kat"" Gruene",10,6,4,0
Ector,103,"Chief Justice, Supreme Court",,REP,Nathan Hecht,684,530,154,0
Ector,103,"Chief Justice, Supreme Court",,REP,Over Votes,0,0,0,0
Ector,103,"Chief Justice, Supreme Court",,REP,Under Votes,43,35,8,0
Ector,103,"Chief Justice, Supreme Court",,DEM,Amy Clark Meachum,200,135,65,0
Ector,103,"Chief Justice, Supreme Court",,LIB,Mark Ash,26,22,4,0
Ector,103,"Justice, Supreme Court, Place 6, (Unexpired Term)",,REP,Jane Bland,709,545,164,0
Ector,103,"Justice, Supreme Court, Place 6, (Unexpired Term)",,REP,Over Votes,0,0,0,0
Ector,103,"Justice, Supreme Court, Place 6, (Unexpired Term)",,REP,Under Votes,44,35,9,0
Ector,103,"Justice, Supreme Court, Place 6, (Unexpired Term)",,DEM,Kathy Cheng,200,142,58,0
Ector,103,"Justice, Supreme Court, Place 7",,REP,Jeff Boyd,696,536,160,0
Ector,103,"Justice, Supreme Court, Place 7",,REP,Over Votes,0,0,0,0
Ector,103,"Justice, Supreme Court, Place 7",,REP,Under Votes,47,38,9,0
Ector,103,"Justice, Supreme Court, Place 7",,DEM,Staci Williams,182,126,56,0
Ector,103,"Justice, Supreme Court, Place 7",,LIB,William Bryan Strange III,28,22,6,0
Ector,103,"Justice, Supreme Court, Place 8",,REP,Brett Busby,682,527,155,0
Ector,103,"Justice, Supreme Court, Place 8",,REP,Over Votes,0,0,0,0
Ector,103,"Justice, Supreme Court, Place 8",,REP,Under Votes,46,37,9,0
Ector,103,"Justice, Supreme Court, Place 8",,DEM,Gisela D. Triana,193,136,57,0
Ector,103,"Justice, Supreme Court, Place 8",,LIB,Tom Oxford,32,22,10,0
Ector,103,"Judge, Court of Criminal Appeals, Place 3",,REP,Bert Richardson,702,542,160,0
Ector,103,"Judge, Court of Criminal Appeals, Place 3",,REP,Over Votes,0,0,0,0
Ector,103,"Judge, Court of Criminal Appeals, Place 3",,REP,Under Votes,48,37,11,0
Ector,103,"Judge, Court of Criminal Appeals, Place 3",,DEM,Elizabeth Davis Frizell,203,143,60,0
Ector,103,"Judge, Court of Criminal Appeals, Place 4",,REP,Kevin Patrick Yeary,705,539,166,0
Ector,103,"Judge, Court of Criminal Appeals, Place 4",,REP,Over Votes,0,0,0,0
Ector,103,"Judge, Court of Criminal Appeals, Place 4",,REP,Under Votes,47,38,9,0
Ector,103,"Judge, Court of Criminal Appeals, Place 4",,DEM,Tina Clinton,201,145,56,0
Ector,103,"Judge, Court of Criminal Appeals, Place 9",,REP,David Newell,712,547,165,0
Ector,103,"Judge, Court of Criminal Appeals, Place 9",,REP,Over Votes,0,0,0,0
Ector,103,"Judge, Court of Criminal Appeals, Place 9",,REP,Under Votes,50,40,10,0
Ector,103,"Judge, Court of Criminal Appeals, Place 9",,DEM,Brandon Birmingham,191,135,56,0
Ector,103,"Member, State Board of Education, District 1",,REP,Jennifer Ivey,681,523,158,0
Ector,103,"Member, State Board of Education, District 1",,REP,Over Votes,0,0,0,0
Ector,103,"Member, State Board of Education, District 1",,REP,Under Votes,54,43,11,0
Ector,103,"Member, State Board of Education, District 1",,DEM,Georgina Perez,218,156,62,0
Ector,103,State Representative,81,REP,Brooks Landgraf,819,616,203,0
Ector,103,State Representative,81,REP,Over Votes,0,0,0,0
Ector,103,State Representative,81,REP,Under Votes,134,106,28,0
Ector,103,"Justice, 11th Court of Appeals District, Place 2",,REP,Bruce Williams,799,598,201,0
Ector,103,"Justice, 11th Court of Appeals District, Place 2",,REP,Over Votes,0,0,0,0
Ector,103,"Justice, 11th Court of Appeals District, Place 2",,REP,Under Votes,154,124,30,0
Ector,103,"Justice, 11th Court of Appeals District, Place 3 (Unexpired Term)",,REP,W. Stacy Trotter,797,594,203,0
Ector,103,"Justice, 11th Court of Appeals District, Place 3 (Unexpired Term)",,REP,Over Votes,0,0,0,0
Ector,103,"Justice, 11th Court of Appeals District, Place 3 (Unexpired Term)",,REP,Under Votes,156,128,28,0
Ector,103,"District Judge, 161st Judicial District",,REP,Justin Low,797,596,201,0
Ector,103,"District Judge, 161st Judicial District",,REP,Over Votes,0,0,0,0
Ector,103,"District Judge, 161st Judicial District",,REP,Under Votes,156,126,30,0
Ector,103,"District Judge, 446th Judicial District",,REP,Sara Kate Billingsley,793,591,202,0
Ector,103,"District Judge, 446th Judicial District",,REP,Over Votes,0,0,0,0
Ector,103,"District Judge, 446th Judicial District",,REP,Under Votes,160,131,29,0
Ector,103,"District Attorney, 70th Judicial District",,REP,Dusty Gallivan,794,594,200,0
Ector,103,"District Attorney, 70th Judicial District",,REP,Over Votes,0,0,0,0
Ector,103,"District Attorney, 70th Judicial District",,REP,Under Votes,159,128,31,0
Ector,104,President,,REP,Donald J. Trump / Michael R. Pence,149,118,31,0
Ector,104,President,,REP,Over Votes,0,0,0,0
Ector,104,President,,REP,Under Votes,0,0,0,0
Ector,104,President,,DEM,Joseph R. Biden / Kamala D. Harris,40,32,8,0
Ector,104,President,,LIB,"Jo Jorgensen / Jeremy ""Spike"" Cohen",0,0,0,0
Ector,104,President,,GRN,Howie Hawkins / Angela Walker,0,0,0,0
Ector,104,President,,,President R. Boddie/Eric C. Stoneham,0,0,0,0
Ector,104,President,,,Brian Carroll/Amar Patel,0,0,0,0
Ector,104,President,,,Todd Cella/Tim Cella,0,0,0,0
Ector,104,President,,,Jesse Cuellar/Jimmy Monreal,0,0,0,0
Ector,104,President,,,Tom Hoefling/Andy Prior,0,0,0,0
Ector,104,President,,,Gloria La Riva/Leonard Peltier,0,0,0,0
Ector,104,President,,,Abram Loeb/Jennifer Jairala,0,0,0,0
Ector,104,President,,,Robert Morrow/Anne Beckett,0,0,0,0
Ector,104,President,,,Kasey Wells/Rachel Wells,0,0,0,0
Ector,104,U.S. Senate,,REP,John Cornyn,143,115,28,0
Ector,104,U.S. Senate,,REP,Over Votes,0,0,0,0
Ector,104,U.S. Senate,,REP,Under Votes,10,7,3,0
Ector,104,U.S. Senate,,DEM,"Mary ""MJ"" Hegar",33,26,7,0
Ector,104,U.S. Senate,,LIB,Kerry Douglas McKennon,2,2,0,0
Ector,104,U.S. Senate,,GRN,David B. Collins,1,0,1,0
Ector,104,U.S. Senate,,,Ricardo Turullols-Bonilla,0,0,0,0
Ector,104,U.S. House,11,REP,August Pfluger,142,115,27,0
Ector,104,U.S. House,11,REP,Over Votes,0,0,0,0
Ector,104,U.S. House,11,REP,Under Votes,13,8,5,0
Ector,104,U.S. House,11,DEM,Jon Mark Hogg,32,26,6,0
Ector,104,U.S. House,11,LIB,Wacey Alpha Cody,2,1,1,0
Ector,104,Railroad Commissioner,,REP,"James ""Jim"" Wright",142,114,28,0
Ector,104,Railroad Commissioner,,REP,Over Votes,0,0,0,0
Ector,104,Railroad Commissioner,,REP,Under Votes,11,7,4,0
Ector,104,Railroad Commissioner,,DEM,Chrysta Castañeda,28,24,4,0
Ector,104,Railroad Commissioner,,LIB,Matt Sterett,3,2,1,0
Ector,104,Railroad Commissioner,,GRN,"Katija ""Kat"" Gruene",5,3,2,0
Ector,104,"Chief Justice, Supreme Court",,REP,Nathan Hecht,136,110,26,0
Ector,104,"Chief Justice, Supreme Court",,REP,Over Votes,0,0,0,0
Ector,104,"Chief Justice, Supreme Court",,REP,Under Votes,13,8,5,0
Ector,104,"Chief Justice, Supreme Court",,DEM,Amy Clark Meachum,34,28,6,0
Ector,104,"Chief Justice, Supreme Court",,LIB,Mark Ash,6,4,2,0
Ector,104,"Justice, Supreme Court, Place 6, (Unexpired Term)",,REP,Jane Bland,144,117,27,0
Ector,104,"Justice, Supreme Court, Place 6, (Unexpired Term)",,REP,Over Votes,0,0,0,0
Ector,104,"Justice, Supreme Court, Place 6, (Unexpired Term)",,REP,Under Votes,14,8,6,0
Ector,104,"Justice, Supreme Court, Place 6, (Unexpired Term)",,DEM,Kathy Cheng,31,25,6,0
Ector,104,"Justice, Supreme Court, Place 7",,REP,Jeff Boyd,140,112,28,0
Ector,104,"Justice, Supreme Court, Place 7",,REP,Over Votes,0,0,0,0
Ector,104,"Justice, Supreme Court, Place 7",,REP,Under Votes,13,9,4,0
Ector,104,"Justice, Supreme Court, Place 7",,DEM,Staci Williams,33,27,6,0
Ector,104,"Justice, Supreme Court, Place 7",,LIB,William Bryan Strange III,3,2,1,0
Ector,104,"Justice, Supreme Court, Place 8",,REP,Brett Busby,140,114,26,0
Ector,104,"Justice, Supreme Court, Place 8",,REP,Over Votes,0,0,0,0
Ector,104,"Justice, Supreme Court, Place 8",,REP,Under Votes,16,9,7,0
Ector,104,"Justice, Supreme Court, Place 8",,DEM,Gisela D. Triana,29,25,4,0
Ector,104,"Justice, Supreme Court, Place 8",,LIB,Tom Oxford,4,2,2,0
Ector,104,"Judge, Court of Criminal Appeals, Place 3",,REP,Bert Richardson,141,114,27,0
Ector,104,"Judge, Court of Criminal Appeals, Place 3",,REP,Over Votes,0,0,0,0
Ector,104,"Judge, Court of Criminal Appeals, Place 3",,REP,Under Votes,15,9,6,0
Ector,104,"Judge, Court of Criminal Appeals, Place 3",,DEM,Elizabeth Davis Frizell,33,27,6,0
Ector,104,"Judge, Court of Criminal Appeals, Place 4",,REP,Kevin Patrick Yeary,139,112,27,0
Ector,104,"Judge, Court of Criminal Appeals, Place 4",,REP,Over Votes,0,0,0,0
Ector,104,"Judge, Court of Criminal Appeals, Place 4",,REP,Under Votes,14,9,5,0
Ector,104,"Judge, Court of Criminal Appeals, Place 4",,DEM,Tina Clinton,36,29,7,0
Ector,104,"Judge, Court of Criminal Appeals, Place 9",,REP,David Newell,140,115,25,0
Ector,104,"Judge, Court of Criminal Appeals, Place 9",,REP,Over Votes,0,0,0,0
Ector,104,"Judge, Court of Criminal Appeals, Place 9",,REP,Under Votes,15,9,6,0
Ector,104,"Judge, Court of Criminal Appeals, Place 9",,DEM,Brandon Birmingham,34,26,8,0
Ector,104,"Member, State Board of Education, District 1",,REP,Jennifer Ivey,145,115,30,0
Ector,104,"Member, State Board of Education, District 1",,REP,Over Votes,0,0,0,0
Ector,104,"Member, State Board of Education, District 1",,REP,Under Votes,14,9,5,0
Ector,104,"Member, State Board of Education, District 1",,DEM,Georgina Perez,30,26,4,0
Ector,104,State Representative,81,REP,Brooks Landgraf,160,129,31,0
Ector,104,State Representative,81,REP,Over Votes,0,0,0,0
Ector,104,State Representative,81,REP,Under Votes,29,21,8,0
Ector,104,"Justice, 11th Court of Appeals District, Place 2",,REP,Bruce Williams,162,131,31,0
Ector,104,"Justice, 11th Court of Appeals District, Place 2",,REP,Over Votes,0,0,0,0
Ector,104,"Justice, 11th Court of Appeals District, Place 2",,REP,Under Votes,27,19,8,0
Ector,104,"Justice, 11th Court of Appeals District, Place 3 (Unexpired Term)",,REP,W. Stacy Trotter,158,128,30,0
Ector,104,"Justice, 11th Court of Appeals District, Place 3 (Unexpired Term)",,REP,Over Votes,0,0,0,0
Ector,104,"Justice, 11th Court of Appeals District, Place 3 (Unexpired Term)",,REP,Under Votes,31,22,9,0
Ector,104,"District Judge, 161st Judicial District",,REP,Justin Low,161,130,31,0
Ector,104,"District Judge, 161st Judicial District",,REP,Over Votes,0,0,0,0
Ector,104,"District Judge, 161st Judicial District",,REP,Under Votes,28,20,8,0
Ector,104,"District Judge, 446th Judicial District",,REP,Sara Kate Billingsley,156,126,30,0
Ector,104,"District Judge, 446th Judicial District",,REP,Over Votes,0,0,0,0
Ector,104,"District Judge, 446th Judicial District",,REP,Under Votes,33,24,9,0
Ector,104,"District Attorney, 70th Judicial District",,REP,Dusty Gallivan,159,128,31,0
Ector,104,"District Attorney, 70th Judicial District",,REP,Over Votes,0,0,0,0
Ector,104,"District Attorney, 70th Judicial District",,REP,Under Votes,30,22,8,0
Ector,106,President,,REP,Donald J. Trump / Michael R. Pence,674,513,161,0
Ector,106,President,,REP,Over Votes,0,0,0,0
Ector,106,President,,REP,Under Votes,4,3,1,0
Ector,106,President,,DEM,Joseph R. Biden / Kamala D. Harris,200,155,45,0
Ector,106,President,,LIB,"Jo Jorgensen / Jeremy ""Spike"" Cohen",5,3,2,0
Ector,106,President,,GRN,Howie Hawkins / Angela Walker,1,1,0,0
Ector,106,President,,,President R. Boddie/Eric C. Stoneham,0,0,0,0
Ector,106,President,,,Brian Carroll/Amar Patel,0,0,0,0
Ector,106,President,,,Todd Cella/Tim Cella,0,0,0,0
Ector,106,President,,,Jesse Cuellar/Jimmy Monreal,0,0,0,0
Ector,106,President,,,Tom Hoefling/Andy Prior,0,0,0,0
Ector,106,President,,,Gloria La Riva/Leonard Peltier,0,0,0,0
Ector,106,President,,,Abram Loeb/Jennifer Jairala,0,0,0,0
Ector,106,President,,,Robert Morrow/Anne Beckett,0,0,0,0
Ector,106,President,,,Kasey Wells/Rachel Wells,0,0,0,0
Ector,106,U.S. Senate,,REP,John Cornyn,664,511,153,0
Ector,106,U.S. Senate,,REP,Over Votes,0,0,0,0
Ector,106,U.S. Senate,,REP,Under Votes,21,13,8,0
Ector,106,U.S. Senate,,DEM,"Mary ""MJ"" Hegar",183,142,41,0
Ector,106,U.S. Senate,,LIB,Kerry Douglas McKennon,11,6,5,0
Ector,106,U.S. Senate,,GRN,David B. Collins,5,3,2,0
Ector,106,U.S. Senate,,,Ricardo Turullols-Bonilla,0,0,0,0
Ector,106,U.S. House,11,REP,August Pfluger,670,514,156,0
Ector,106,U.S. House,11,REP,Over Votes,0,0,0,0
Ector,106,U.S. House,11,REP,Under Votes,20,12,8,0
Ector,106,U.S. House,11,DEM,Jon Mark Hogg,183,142,41,0
Ector,106,U.S. House,11,LIB,Wacey Alpha Cody,11,7,4,0
Ector,106,Railroad Commissioner,,REP,"James ""Jim"" Wright",666,516,150,0
Ector,106,Railroad Commissioner,,REP,Over Votes,0,0,0,0
Ector,106,Railroad Commissioner,,REP,Under Votes,23,14,9,0
Ector,106,Railroad Commissioner,,DEM,Chrysta Castañeda,179,137,42,0
Ector,106,Railroad Commissioner,,LIB,Matt Sterett,14,7,7,0
Ector,106,Railroad Commissioner,,GRN,"Katija ""Kat"" Gruene",2,1,1,0
Ector,106,"Chief Justice, Supreme Court",,REP,Nathan Hecht,651,500,151,0
Ector,106,"Chief Justice, Supreme Court",,REP,Over Votes,0,0,0,0
Ector,106,"Chief Justice, Supreme Court",,REP,Under Votes,24,17,7,0
Ector,106,"Chief Justice, Supreme Court",,DEM,Amy Clark Meachum,190,144,46,0
Ector,106,"Chief Justice, Supreme Court",,LIB,Mark Ash,19,14,5,0
Ector,106,"Justice, Supreme Court, Place 6, (Unexpired Term)",,REP,Jane Bland,677,518,159,0
Ector,106,"Justice, Supreme Court, Place 6, (Unexpired Term)",,REP,Over Votes,0,0,0,0
Ector,106,"Justice, Supreme Court, Place 6, (Unexpired Term)",,REP,Under Votes,22,15,7,0
Ector,106,"Justice, Supreme Court, Place 6, (Unexpired Term)",,DEM,Kathy Cheng,185,142,43,0
Ector,106,"Justice, Supreme Court, Place 7",,REP,Jeff Boyd,656,506,150,0
Ector,106,"Justice, Supreme Court, Place 7",,REP,Over Votes,0,0,0,0
Ector,106,"Justice, Supreme Court, Place 7",,REP,Under Votes,25,16,9,0
Ector,106,"Justice, Supreme Court, Place 7",,DEM,Staci Williams,187,141,46,0
Ector,106,"Justice, Supreme Court, Place 7",,LIB,William Bryan Strange III,16,12,4,0
Ector,106,"Justice, Supreme Court, Place 8",,REP,Brett Busby,655,506,149,0
Ector,106,"Justice, Supreme Court, Place 8",,REP,Over Votes,0,0,0,0
Ector,106,"Justice, Supreme Court, Place 8",,REP,Under Votes,27,18,9,0
Ector,106,"Justice, Supreme Court, Place 8",,DEM,Gisela D. Triana,183,138,45,0
Ector,106,"Justice, Supreme Court, Place 8",,LIB,Tom Oxford,19,13,6,0
Ector,106,"Judge, Court of Criminal Appeals, Place 3",,REP,Bert Richardson,668,511,157,0
Ector,106,"Judge, Court of Criminal Appeals, Place 3",,REP,Over Votes,0,0,0,0
Ector,106,"Judge, Court of Criminal Appeals, Place 3",,REP,Under Votes,27,18,9,0
Ector,106,"Judge, Court of Criminal Appeals, Place 3",,DEM,Elizabeth Davis Frizell,189,146,43,0
Ector,106,"Judge, Court of Criminal Appeals, Place 4",,REP,Kevin Patrick Yeary,678,521,157,0
Ector,106,"Judge, Court of Criminal Appeals, Place 4",,REP,Over Votes,0,0,0,0
Ector,106,"Judge, Court of Criminal Appeals, Place 4",,REP,Under Votes,25,17,8,0
Ector,106,"Judge, Court of Criminal Appeals, Place 4",,DEM,Tina Clinton,181,137,44,0
Ector,106,"Judge, Court of Criminal Appeals, Place 9",,REP,David Newell,673,517,156,0
Ector,106,"Judge, Court of Criminal Appeals, Place 9",,REP,Over Votes,0,0,0,0
Ector,106,"Judge, Court of Criminal Appeals, Place 9",,REP,Under Votes,27,18,9,0
Ector,106,"Judge, Court of Criminal Appeals, Place 9",,DEM,Brandon Birmingham,184,140,44,0
Ector,106,"Member, State Board of Education, District 1",,REP,Jennifer Ivey,662,510,152,0
Ector,106,"Member, State Board of Education, District 1",,REP,Over Votes,0,0,0,0
Ector,106,"Member, State Board of Education, District 1",,REP,Under Votes,28,20,8,0
Ector,106,"Member, State Board of Education, District 1",,DEM,Georgina Perez,194,145,49,0
Ector,106,State Representative,81,REP,Brooks Landgraf,778,595,183,0
Ector,106,State Representative,81,REP,Over Votes,0,0,0,0
Ector,106,State Representative,81,REP,Under Votes,106,80,26,0
Ector,106,"Justice, 11th Court of Appeals District, Place 2",,REP,Bruce Williams,749,569,180,0
Ector,106,"Justice, 11th Court of Appeals District, Place 2",,REP,Over Votes,0,0,0,0
Ector,106,"Justice, 11th Court of Appeals District, Place 2",,REP,Under Votes,135,106,29,0
Ector,106,"Justice, 11th Court of Appeals District, Place 3 (Unexpired Term)",,REP,W. Stacy Trotter,754,572,182,0
Ector,106,"Justice, 11th Court of Appeals District, Place 3 (Unexpired Term)",,REP,Over Votes,0,0,0,0
Ector,106,"Justice, 11th Court of Appeals District, Place 3 (Unexpired Term)",,REP,Under Votes,130,103,27,0
Ector,106,"District Judge, 161st Judicial District",,REP,Justin Low,744,569,175,0
Ector,106,"District Judge, 161st Judicial District",,REP,Over Votes,0,0,0,0
Ector,106,"District Judge, 161st Judicial District",,REP,Under Votes,140,106,34,0
Ector,106,"District Judge, 446th Judicial District",,REP,Sara Kate Billingsley,755,575,180,0
Ector,106,"District Judge, 446th Judicial District",,REP,Over Votes,0,0,0,0
Ector,106,"District Judge, 446th Judicial District",,REP,Under Votes,129,100,29,0
Ector,106,"District Attorney, 70th Judicial District",,REP,Dusty Gallivan,756,573,183,0
Ector,106,"District Attorney, 70th Judicial District",,REP,Over Votes,0,0,0,0
Ector,106,"District Attorney, 70th Judicial District",,REP,Under Votes,128,102,26,0
Ector,106,Mayor,,,Dewey Bryant,355,290,65,0
Ector,106,Mayor,,,Over Votes,0,0,0,0
Ector,106,Mayor,,,Under Votes,88,64,24,0
Ector,106,Mayor,,,Javier Joven,321,237,84,0
Ector,106,Mayor,,,Gloria G. Apolinario,120,84,36,0
Ector,106,"Council Member, At-Large",,,David R. Turner,391,300,91,0
Ector,106,"Council Member, At-Large",,,Over Votes,0,0,0,0
Ector,106,"Council Member, At-Large",,,Under Votes,88,63,25,0
Ector,106,"Council Member, At-Large",,,La-Tasha Gentry,92,69,23,0
Ector,106,"Council Member, At-Large",,,Jo Ann Davenport Littleton,88,69,19,0
Ector,106,"Council Member, At-Large",,,Denise Swanner,225,174,51,0
Ector,107,President,,REP,Donald J. Trump / Michael R. Pence,496,381,115,0
Ector,107,President,,REP,Over Votes,0,0,0,0
Ector,107,President,,REP,Under Votes,3,2,1,0
Ector,107,President,,DEM,Joseph R. Biden / Kamala D. Harris,109,81,28,0
Ector,107,President,,LIB,"Jo Jorgensen / Jeremy ""Spike"" Cohen",8,4,4,0
Ector,107,President,,GRN,Howie Hawkins / Angela Walker,1,0,1,0
Ector,107,President,,,President R. Boddie/Eric C. Stoneham,0,0,0,0
Ector,107,President,,,Brian Carroll/Amar Patel,0,0,0,0
Ector,107,President,,,Todd Cella/Tim Cella,0,0,0,0
Ector,107,President,,,Jesse Cuellar/Jimmy Monreal,0,0,0,0
Ector,107,President,,,Tom Hoefling/Andy Prior,0,0,0,0
Ector,107,President,,,Gloria La Riva/Leonard Peltier,0,0,0,0
Ector,107,President,,,Abram Loeb/Jennifer Jairala,0,0,0,0
Ector,107,President,,,Robert Morrow/Anne Beckett,0,0,0,0
Ector,107,President,,,Kasey Wells/Rachel Wells,0,0,0,0
Ector,107,U.S. Senate,,REP,John Cornyn,485,371,114,0
Ector,107,U.S. Senate,,REP,Over Votes,0,0,0,0
Ector,107,U.S. Senate,,REP,Under Votes,14,12,2,0
Ector,107,U.S. Senate,,DEM,"Mary ""MJ"" Hegar",98,71,27,0
Ector,107,U.S. Senate,,LIB,Kerry Douglas McKennon,17,11,6,0
Ector,107,U.S. Senate,,GRN,David B. Collins,3,3,0,0
Ector,107,U.S. Senate,,,Ricardo Turullols-Bonilla,0,0,0,0
Ector,107,U.S. House,11,REP,August Pfluger,487,374,113,0
Ector,107,U.S. House,11,REP,Over Votes,0,0,0,0
Ector,107,U.S. House,11,REP,Under Votes,17,13,4,0
Ector,107,U.S. House,11,DEM,Jon Mark Hogg,95,69,26,0
Ector,107,U.S. House,11,LIB,Wacey Alpha Cody,18,12,6,0
Ector,107,Railroad Commissioner,,REP,"James ""Jim"" Wright",481,368,113,0
Ector,107,Railroad Commissioner,,REP,Over Votes,0,0,0,0
Ector,107,Railroad Commissioner,,REP,Under Votes,17,14,3,0
Ector,107,Railroad Commissioner,,DEM,Chrysta Castañeda,99,71,28,0
Ector,107,Railroad Commissioner,,LIB,Matt Sterett,19,14,5,0
Ector,107,Railroad Commissioner,,GRN,"Katija ""Kat"" Gruene",1,1,0,0
Ector,107,"Chief Justice, Supreme Court",,REP,Nathan Hecht,481,371,110,0
Ector,107,"Chief Justice, Supreme Court",,REP,Over Votes,0,0,0,0
Ector,107,"Chief Justice, Supreme Court",,REP,Under Votes,14,10,4,0
Ector,107,"Chief Justice, Supreme Court",,DEM,Amy Clark Meachum,104,75,29,0
Ector,107,"Chief Justice, Supreme Court",,LIB,Mark Ash,18,12,6,0
Ector,107,"Justice, Supreme Court, Place 6, (Unexpired Term)",,REP,Jane Bland,494,378,116,0
Ector,107,"Justice, Supreme Court, Place 6, (Unexpired Term)",,REP,Over Votes,0,0,0,0
Ector,107,"Justice, Supreme Court, Place 6, (Unexpired Term)",,REP,Under Votes,17,13,4,0
Ector,107,"Justice, Supreme Court, Place 6, (Unexpired Term)",,DEM,Kathy Cheng,106,77,29,0
Ector,107,"Justice, Supreme Court, Place 7",,REP,Jeff Boyd,483,368,115,0
Ector,107,"Justice, Supreme Court, Place 7",,REP,Over Votes,0,0,0,0
Ector,107,"Justice, Supreme Court, Place 7",,REP,Under Votes,16,13,3,0
Ector,107,"Justice, Supreme Court, Place 7",,DEM,Staci Williams,100,75,25,0
Ector,107,"Justice, Supreme Court, Place 7",,LIB,William Bryan Strange III,18,12,6,0
Ector,107,"Justice, Supreme Court, Place 8",,REP,Brett Busby,481,373,108,0
Ector,107,"Justice, Supreme Court, Place 8",,REP,Over Votes,0,0,0,0
Ector,107,"Justice, Supreme Court, Place 8",,REP,Under Votes,15,12,3,0
Ector,107,"Justice, Supreme Court, Place 8",,DEM,Gisela D. Triana,104,73,31,0
Ector,107,"Justice, Supreme Court, Place 8",,LIB,Tom Oxford,17,10,7,0
Ector,107,"Judge, Court of Criminal Appeals, Place 3",,REP,Bert Richardson,490,377,113,0
Ector,107,"Judge, Court of Criminal Appeals, Place 3",,REP,Over Votes,0,0,0,0
Ector,107,"Judge, Court of Criminal Appeals, Place 3",,REP,Under Votes,17,13,4,0
Ector,107,"Judge, Court of Criminal Appeals, Place 3",,DEM,Elizabeth Davis Frizell,110,78,32,0
Ector,107,"Judge, Court of Criminal Appeals, Place 4",,REP,Kevin Patrick Yeary,492,378,114,0
Ector,107,"Judge, Court of Criminal Appeals, Place 4",,REP,Over Votes,0,0,0,0
Ector,107,"Judge, Court of Criminal Appeals, Place 4",,REP,Under Votes,15,13,2,0
Ector,107,"Judge, Court of Criminal Appeals, Place 4",,DEM,Tina Clinton,110,77,33,0
Ector,107,"Judge, Court of Criminal Appeals, Place 9",,REP,David Newell,488,376,112,0
Ector,107,"Judge, Court of Criminal Appeals, Place 9",,REP,Over Votes,0,0,0,0
Ector,107,"Judge, Court of Criminal Appeals, Place 9",,REP,Under Votes,16,13,3,0
Ector,107,"Judge, Court of Criminal Appeals, Place 9",,DEM,Brandon Birmingham,113,79,34,0
Ector,107,"Member, State Board of Education, District 1",,REP,Jennifer Ivey,491,375,116,0
Ector,107,"Member, State Board of Education, District 1",,REP,Over Votes,0,0,0,0
Ector,107,"Member, State Board of Education, District 1",,REP,Under Votes,17,14,3,0
Ector,107,"Member, State Board of Education, District 1",,DEM,Georgina Perez,109,79,30,0
Ector,107,State Representative,81,REP,Brooks Landgraf,549,415,134,0
Ector,107,State Representative,81,REP,Over Votes,0,0,0,0
Ector,107,State Representative,81,REP,Under Votes,68,53,15,0
Ector,107,"Justice, 11th Court of Appeals District, Place 2",,REP,Bruce Williams,539,404,135,0
Ector,107,"Justice, 11th Court of Appeals District, Place 2",,REP,Over Votes,0,0,0,0
Ector,107,"Justice, 11th Court of Appeals District, Place 2",,REP,Under Votes,78,64,14,0
Ector,107,"Justice, 11th Court of Appeals District, Place 3 (Unexpired Term)",,REP,W. Stacy Trotter,537,402,135,0
Ector,107,"Justice, 11th Court of Appeals District, Place 3 (Unexpired Term)",,REP,Over Votes,0,0,0,0
Ector,107,"Justice, 11th Court of Appeals District, Place 3 (Unexpired Term)",,REP,Under Votes,80,66,14,0
Ector,107,"District Judge, 161st Judicial District",,REP,Justin Low,534,400,134,0
Ector,107,"District Judge, 161st Judicial District",,REP,Over Votes,0,0,0,0
Ector,107,"District Judge, 161st Judicial District",,REP,Under Votes,83,68,15,0
Ector,107,"District Judge, 446th Judicial District",,REP,Sara Kate Billingsley,535,402,133,0
Ector,107,"District Judge, 446th Judicial District",,REP,Over Votes,0,0,0,0
Ector,107,"District Judge, 446th Judicial District",,REP,Under Votes,82,66,16,0
Ector,107,"District Attorney, 70th Judicial District",,REP,Dusty Gallivan,539,405,134,0
Ector,107,"District Attorney, 70th Judicial District",,REP,Over Votes,0,0,0,0
Ector,107,"District Attorney, 70th Judicial District",,REP,Under Votes,78,63,15,0
Ector,108,President,,REP,Donald J. Trump / Michael R. Pence,1449,1180,269,0
Ector,108,President,,REP,Over Votes,1,1,0,0
Ector,108,President,,REP,Under Votes,12,10,2,0
Ector,108,President,,DEM,Joseph R. Biden / Kamala D. Harris,283,232,51,0
Ector,108,President,,LIB,"Jo Jorgensen / Jeremy ""Spike"" Cohen",11,9,2,0
Ector,108,President,,GRN,Howie Hawkins / Angela Walker,4,3,1,0
Ector,108,President,,,President R. Boddie/Eric C. Stoneham,0,0,0,0
Ector,108,President,,,Brian Carroll/Amar Patel,0,0,0,0
Ector,108,President,,,Todd Cella/Tim Cella,0,0,0,0
Ector,108,President,,,Jesse Cuellar/Jimmy Monreal,0,0,0,0
Ector,108,President,,,Tom Hoefling/Andy Prior,0,0,0,0
Ector,108,President,,,Gloria La Riva/Leonard Peltier,0,0,0,0
Ector,108,President,,,Abram Loeb/Jennifer Jairala,0,0,0,0
Ector,108,President,,,Robert Morrow/Anne Beckett,0,0,0,0
Ector,108,President,,,Kasey Wells/Rachel Wells,0,0,0,0
Ector,108,U.S. Senate,,REP,John Cornyn,1391,1151,240,0
Ector,108,U.S. Senate,,REP,Over Votes,1,1,0,0
Ector,108,U.S. Senate,,REP,Under Votes,52,35,17,0
Ector,108,U.S. Senate,,DEM,"Mary ""MJ"" Hegar",271,225,46,0
Ector,108,U.S. Senate,,LIB,Kerry Douglas McKennon,31,18,13,0
Ector,108,U.S. Senate,,GRN,David B. Collins,14,5,9,0
Ector,108,U.S. Senate,,,Ricardo Turullols-Bonilla,0,0,0,0
Ector,108,U.S. House,11,REP,August Pfluger,1400,1148,252,0
Ector,108,U.S. House,11,REP,Over Votes,0,0,0,0
Ector,108,U.S. House,11,REP,Under Votes,61,42,19,0
Ector,108,U.S. House,11,DEM,Jon Mark Hogg,262,220,42,0
Ector,108,U.S. House,11,LIB,Wacey Alpha Cody,37,25,12,0
Ector,108,Railroad Commissioner,,REP,"James ""Jim"" Wright",1386,1146,240,0
Ector,108,Railroad Commissioner,,REP,Over Votes,0,0,0,0
Ector,108,Railroad Commissioner,,REP,Under Votes,59,39,20,0
Ector,108,Railroad Commissioner,,DEM,Chrysta Castañeda,270,224,46,0
Ector,108,Railroad Commissioner,,LIB,Matt Sterett,33,19,14,0
Ector,108,Railroad Commissioner,,GRN,"Katija ""Kat"" Gruene",12,7,5,0
Ector,108,"Chief Justice, Supreme Court",,REP,Nathan Hecht,1376,1138,238,0
Ector,108,"Chief Justice, Supreme Court",,REP,Over Votes,0,0,0,0
Ector,108,"Chief Justice, Supreme Court",,REP,Under Votes,67,45,22,0
Ector,108,"Chief Justice, Supreme Court",,DEM,Amy Clark Meachum,274,228,46,0
Ector,108,"Chief Justice, Supreme Court",,LIB,Mark Ash,43,24,19,0
Ector,108,"Justice, Supreme Court, Place 6, (Unexpired Term)",,REP,Jane Bland,1414,1163,251,0
Ector,108,"Justice, Supreme Court, Place 6, (Unexpired Term)",,REP,Over Votes,0,0,0,0
Ector,108,"Justice, Supreme Court, Place 6, (Unexpired Term)",,REP,Under Votes,67,46,21,0
Ector,108,"Justice, Supreme Court, Place 6, (Unexpired Term)",,DEM,Kathy Cheng,279,226,53,0
Ector,108,"Justice, Supreme Court, Place 7",,REP,Jeff Boyd,1386,1145,241,0
Ector,108,"Justice, Supreme Court, Place 7",,REP,Over Votes,0,0,0,0
Ector,108,"Justice, Supreme Court, Place 7",,REP,Under Votes,58,39,19,0
Ector,108,"Justice, Supreme Court, Place 7",,DEM,Staci Williams,287,234,53,0
Ector,108,"Justice, Supreme Court, Place 7",,LIB,William Bryan Strange III,29,17,12,0
Ector,108,"Justice, Supreme Court, Place 8",,REP,Brett Busby,1385,1143,242,0
Ector,108,"Justice, Supreme Court, Place 8",,REP,Over Votes,0,0,0,0
Ector,108,"Justice, Supreme Court, Place 8",,REP,Under Votes,60,39,21,0
Ector,108,"Justice, Supreme Court, Place 8",,DEM,Gisela D. Triana,279,230,49,0
Ector,108,"Justice, Supreme Court, Place 8",,LIB,Tom Oxford,36,23,13,0
Ector,108,"Judge, Court of Criminal Appeals, Place 3",,REP,Bert Richardson,1406,1158,248,0
Ector,108,"Judge, Court of Criminal Appeals, Place 3",,REP,Over Votes,0,0,0,0
Ector,108,"Judge, Court of Criminal Appeals, Place 3",,REP,Under Votes,65,43,22,0
Ector,108,"Judge, Court of Criminal Appeals, Place 3",,DEM,Elizabeth Davis Frizell,289,234,55,0
Ector,108,"Judge, Court of Criminal Appeals, Place 4",,REP,Kevin Patrick Yeary,1412,1167,245,0
Ector,108,"Judge, Court of Criminal Appeals, Place 4",,REP,Over Votes,0,0,0,0
Ector,108,"Judge, Court of Criminal Appeals, Place 4",,REP,Under Votes,61,40,21,0
Ector,108,"Judge, Court of Criminal Appeals, Place 4",,DEM,Tina Clinton,287,228,59,0
Ector,108,"Judge, Court of Criminal Appeals, Place 9",,REP,David Newell,1419,1167,252,0
Ector,108,"Judge, Court of Criminal Appeals, Place 9",,REP,Over Votes,0,0,0,0
Ector,108,"Judge, Court of Criminal Appeals, Place 9",,REP,Under Votes,75,51,24,0
Ector,108,"Judge, Court of Criminal Appeals, Place 9",,DEM,Brandon Birmingham,266,217,49,0
Ector,108,"Member, State Board of Education, District 1",,REP,Jennifer Ivey,1410,1160,250,0
Ector,108,"Member, State Board of Education, District 1",,REP,Over Votes,0,0,0,0
Ector,108,"Member, State Board of Education, District 1",,REP,Under Votes,68,45,23,0
Ector,108,"Member, State Board of Education, District 1",,DEM,Georgina Perez,282,230,52,0
Ector,108,State Representative,81,REP,Brooks Landgraf,1538,1256,282,0
Ector,108,State Representative,81,REP,Over Votes,0,0,0,0
Ector,108,State Representative,81,REP,Under Votes,222,179,43,0
Ector,108,"Justice, 11th Court of Appeals District, Place 2",,REP,Bruce Williams,1519,1237,282,0
Ector,108,"Justice, 11th Court of Appeals District, Place 2",,REP,Over Votes,0,0,0,0
Ector,108,"Justice, 11th Court of Appeals District, Place 2",,REP,Under Votes,241,198,43,0
Ector,108,"Justice, 11th Court of Appeals District, Place 3 (Unexpired Term)",,REP,W. Stacy Trotter,1526,1245,281,0
Ector,108,"Justice, 11th Court of Appeals District, Place 3 (Unexpired Term)",,REP,Over Votes,0,0,0,0
Ector,108,"Justice, 11th Court of Appeals District, Place 3 (Unexpired Term)",,REP,Under Votes,234,190,44,0
Ector,108,"District Judge, 161st Judicial District",,REP,Justin Low,1517,1234,283,0
Ector,108,"District Judge, 161st Judicial District",,REP,Over Votes,0,0,0,0
Ector,108,"District Judge, 161st Judicial District",,REP,Under Votes,243,201,42,0
Ector,108,"District Judge, 446th Judicial District",,REP,Sara Kate Billingsley,1516,1235,281,0
Ector,108,"District Judge, 446th Judicial District",,REP,Over Votes,0,0,0,0
Ector,108,"District Judge, 446th Judicial District",,REP,Under Votes,244,200,44,0
Ector,108,"District Attorney, 70th Judicial District",,REP,Dusty Gallivan,1530,1246,284,0
Ector,108,"District Attorney, 70th Judicial District",,REP,Over Votes,0,0,0,0
Ector,108,"District Attorney, 70th Judicial District",,REP,Under Votes,230,189,41,0
Ector,109,President,,REP,Donald J. Trump / Michael R. Pence,134,56,78,0
Ector,109,President,,REP,Over Votes,0,0,0,0
Ector,109,President,,REP,Under Votes,2,1,1,0
Ector,109,President,,DEM,Joseph R. Biden / Kamala D. Harris,17,8,9,0
Ector,109,President,,LIB,"Jo Jorgensen / Jeremy ""Spike"" Cohen",0,0,0,0
Ector,109,President,,GRN,Howie Hawkins / Angela Walker,0,0,0,0
Ector,109,President,,,President R. Boddie/Eric C. Stoneham,0,0,0,0
Ector,109,President,,,Brian Carroll/Amar Patel,0,0,0,0
Ector,109,President,,,Todd Cella/Tim Cella,0,0,0,0
Ector,109,President,,,Jesse Cuellar/Jimmy Monreal,0,0,0,0
Ector,109,President,,,Tom Hoefling/Andy Prior,0,0,0,0
Ector,109,President,,,Gloria La Riva/Leonard Peltier,0,0,0,0
Ector,109,President,,,Abram Loeb/Jennifer Jairala,0,0,0,0
Ector,109,President,,,Robert Morrow/Anne Beckett,0,0,0,0
Ector,109,President,,,Kasey Wells/Rachel Wells,0,0,0,0
Ector,109,U.S. Senate,,REP,John Cornyn,130,56,74,0
Ector,109,U.S. Senate,,REP,Over Votes,0,0,0,0
Ector,109,U.S. Senate,,REP,Under Votes,3,0,3,0
Ector,109,U.S. Senate,,DEM,"Mary ""MJ"" Hegar",18,7,11,0
Ector,109,U.S. Senate,,LIB,Kerry Douglas McKennon,2,2,0,0
Ector,109,U.S. Senate,,GRN,David B. Collins,0,0,0,0
Ector,109,U.S. Senate,,,Ricardo Turullols-Bonilla,0,0,0,0
Ector,109,U.S. House,11,REP,August Pfluger,131,56,75,0
Ector,109,U.S. House,11,REP,Over Votes,0,0,0,0
Ector,109,U.S. House,11,REP,Under Votes,3,0,3,0
Ector,109,U.S. House,11,DEM,Jon Mark Hogg,16,7,9,0
Ector,109,U.S. House,11,LIB,Wacey Alpha Cody,3,2,1,0
Ector,109,Railroad Commissioner,,REP,"James ""Jim"" Wright",129,57,72,0
Ector,109,Railroad Commissioner,,REP,Over Votes,0,0,0,0
Ector,109,Railroad Commissioner,,REP,Under Votes,4,0,4,0
Ector,109,Railroad Commissioner,,DEM,Chrysta Castañeda,17,7,10,0
Ector,109,Railroad Commissioner,,LIB,Matt Sterett,3,1,2,0
Ector,109,Railroad Commissioner,,GRN,"Katija ""Kat"" Gruene",0,0,0,0
Ector,109,"Chief Justice, Supreme Court",,REP,Nathan Hecht,129,57,72,0
Ector,109,"Chief Justice, Supreme Court",,REP,Over Votes,0,0,0,0
Ector,109,"Chief Justice, Supreme Court",,REP,Under Votes,5,0,5,0
Ector,109,"Chief Justice, Supreme Court",,DEM,Amy Clark Meachum,18,7,11,0
Ector,109,"Chief Justice, Supreme Court",,LIB,Mark Ash,1,1,0,0
Ector,109,"Justice, Supreme Court, Place 6, (Unexpired Term)",,REP,Jane Bland,129,57,72,0
Ector,109,"Justice, Supreme Court, Place 6, (Unexpired Term)",,REP,Over Votes,0,0,0,0
Ector,109,"Justice, Supreme Court, Place 6, (Unexpired Term)",,REP,Under Votes,4,0,4,0
Ector,109,"Justice, Supreme Court, Place 6, (Unexpired Term)",,DEM,Kathy Cheng,20,8,12,0
Ector,109,"Justice, Supreme Court, Place 7",,REP,Jeff Boyd,131,57,74,0
Ector,109,"Justice, Supreme Court, Place 7",,REP,Over Votes,0,0,0,0
Ector,109,"Justice, Supreme Court, Place 7",,REP,Under Votes,4,0,4,0
Ector,109,"Justice, Supreme Court, Place 7",,DEM,Staci Williams,17,7,10,0
Ector,109,"Justice, Supreme Court, Place 7",,LIB,William Bryan Strange III,1,1,0,0
Ector,109,"Justice, Supreme Court, Place 8",,REP,Brett Busby,130,57,73,0
Ector,109,"Justice, Supreme Court, Place 8",,REP,Over Votes,0,0,0,0
Ector,109,"Justice, Supreme Court, Place 8",,REP,Under Votes,4,0,4,0
Ector,109,"Justice, Supreme Court, Place 8",,DEM,Gisela D. Triana,18,7,11,0
Ector,109,"Justice, Supreme Court, Place 8",,LIB,Tom Oxford,1,1,0,0
Ector,109,"Judge, Court of Criminal Appeals, Place 3",,REP,Bert Richardson,130,57,73,0
Ector,109,"Judge, Court of Criminal Appeals, Place 3",,REP,Over Votes,0,0,0,0
Ector,109,"Judge, Court of Criminal Appeals, Place 3",,REP,Under Votes,4,0,4,0
Ector,109,"Judge, Court of Criminal Appeals, Place 3",,DEM,Elizabeth Davis Frizell,19,8,11,0
Ector,109,"Judge, Court of Criminal Appeals, Place 4",,REP,Kevin Patrick Yeary,131,57,74,0
Ector,109,"Judge, Court of Criminal Appeals, Place 4",,REP,Over Votes,0,0,0,0
Ector,109,"Judge, Court of Criminal Appeals, Place 4",,REP,Under Votes,5,0,5,0
Ector,109,"Judge, Court of Criminal Appeals, Place 4",,DEM,Tina Clinton,17,8,9,0
Ector,109,"Judge, Court of Criminal Appeals, Place 9",,REP,David Newell,131,57,74,0
Ector,109,"Judge, Court of Criminal Appeals, Place 9",,REP,Over Votes,0,0,0,0
Ector,109,"Judge, Court of Criminal Appeals, Place 9",,REP,Under Votes,5,1,4,0
Ector,109,"Judge, Court of Criminal Appeals, Place 9",,DEM,Brandon Birmingham,17,7,10,0
Ector,109,"Member, State Board of Education, District 1",,REP,Jennifer Ivey,128,57,71,0
Ector,109,"Member, State Board of Education, District 1",,REP,Over Votes,0,0,0,0
Ector,109,"Member, State Board of Education, District 1",,REP,Under Votes,4,0,4,0
Ector,109,"Member, State Board of Education, District 1",,DEM,Georgina Perez,21,8,13,0
Ector,109,State Representative,81,REP,Brooks Landgraf,140,62,78,0
Ector,109,State Representative,81,REP,Over Votes,0,0,0,0
Ector,109,State Representative,81,REP,Under Votes,13,3,10,0
Ector,109,"Justice, 11th Court of Appeals District, Place 2",,REP,Bruce Williams,139,60,79,0
Ector,109,"Justice, 11th Court of Appeals District, Place 2",,REP,Over Votes,0,0,0,0
Ector,109,"Justice, 11th Court of Appeals District, Place 2",,REP,Under Votes,14,5,9,0
Ector,109,"Justice, 11th Court of Appeals District, Place 3 (Unexpired Term)",,REP,W. Stacy Trotter,138,60,78,0
Ector,109,"Justice, 11th Court of Appeals District, Place 3 (Unexpired Term)",,REP,Over Votes,0,0,0,0
Ector,109,"Justice, 11th Court of Appeals District, Place 3 (Unexpired Term)",,REP,Under Votes,15,5,10,0
Ector,109,"District Judge, 161st Judicial District",,REP,Justin Low,138,60,78,0
Ector,109,"District Judge, 161st Judicial District",,REP,Over Votes,0,0,0,0
Ector,109,"District Judge, 161st Judicial District",,REP,Under Votes,15,5,10,0
Ector,109,"District Judge, 446th Judicial District",,REP,Sara Kate Billingsley,137,60,77,0
Ector,109,"District Judge, 446th Judicial District",,REP,Over Votes,0,0,0,0
Ector,109,"District Judge, 446th Judicial District",,REP,Under Votes,16,5,11,0
Ector,109,"District Attorney, 70th Judicial District",,REP,Dusty Gallivan,138,60,78,0
Ector,109,"District Attorney, 70th Judicial District",,REP,Over Votes,0,0,0,0
Ector,109,"District Attorney, 70th Judicial District",,REP,Under Votes,15,5,10,0
Ector,110 City,President,,REP,Donald J. Trump / Michael R. Pence,2403,1872,531,0
Ector,110 City,President,,REP,Over Votes,0,0,0,0
Ector,110 City,President,,REP,Under Votes,23,19,4,0
Ector,110 City,President,,DEM,Joseph R. Biden / Kamala D. Harris,694,583,111,0
Ector,110 City,President,,LIB,"Jo Jorgensen / Jeremy ""Spike"" Cohen",35,22,13,0
Ector,110 City,President,,GRN,Howie Hawkins / Angela Walker,5,4,1,0
Ector,110 City,President,,,President R. Boddie/Eric C. Stoneham,0,0,0,0
Ector,110 City,President,,,Brian Carroll/Amar Patel,0,0,0,0
Ector,110 City,President,,,Todd Cella/Tim Cella,0,0,0,0
Ector,110 City,President,,,Jesse Cuellar/Jimmy Monreal,0,0,0,0
Ector,110 City,President,,,Tom Hoefling/Andy Prior,0,0,0,0
Ector,110 City,President,,,Gloria La Riva/Leonard Peltier,0,0,0,0
Ector,110 City,President,,,Abram Loeb/Jennifer Jairala,0,0,0,0
Ector,110 City,President,,,Robert Morrow/Anne Beckett,0,0,0,0
Ector,110 City,President,,,Kasey Wells/Rachel Wells,0,0,0,0
Ector,110 City,U.S. Senate,,REP,John Cornyn,2346,1848,498,0
Ector,110 City,U.S. Senate,,REP,Over Votes,0,0,0,0
Ector,110 City,U.S. Senate,,REP,Under Votes,41,34,7,0
Ector,110 City,U.S. Senate,,DEM,"Mary ""MJ"" Hegar",687,560,127,0
Ector,110 City,U.S. Senate,,LIB,Kerry Douglas McKennon,77,54,23,0
Ector,110 City,U.S. Senate,,GRN,David B. Collins,9,4,5,0
Ector,110 City,U.S. Senate,,,Ricardo Turullols-Bonilla,0,0,0,0
Ector,110 City,U.S. House,11,REP,August Pfluger,2358,1852,506,0
Ector,110 City,U.S. House,11,REP,Over Votes,0,0,0,0
Ector,110 City,U.S. House,11,REP,Under Votes,61,50,11,0
Ector,110 City,U.S. House,11,DEM,Jon Mark Hogg,656,543,113,0
Ector,110 City,U.S. House,11,LIB,Wacey Alpha Cody,85,55,30,0
Ector,110 City,Railroad Commissioner,,REP,"James ""Jim"" Wright",2339,1834,505,0
Ector,110 City,Railroad Commissioner,,REP,Over Votes,0,0,0,0
Ector,110 City,Railroad Commissioner,,REP,Under Votes,60,47,13,0
Ector,110 City,Railroad Commissioner,,DEM,Chrysta Castañeda,663,546,117,0
Ector,110 City,Railroad Commissioner,,LIB,Matt Sterett,81,60,21,0
Ector,110 City,Railroad Commissioner,,GRN,"Katija ""Kat"" Gruene",17,13,4,0
Ector,110 City,"Chief Justice, Supreme Court",,REP,Nathan Hecht,2305,1815,490,0
Ector,110 City,"Chief Justice, Supreme Court",,REP,Over Votes,0,0,0,0
Ector,110 City,"Chief Justice, Supreme Court",,REP,Under Votes,58,46,12,0
Ector,110 City,"Chief Justice, Supreme Court",,DEM,Amy Clark Meachum,702,570,132,0
Ector,110 City,"Chief Justice, Supreme Court",,LIB,Mark Ash,95,69,26,0
Ector,110 City,"Justice, Supreme Court, Place 6, (Unexpired Term)",,REP,Jane Bland,2393,1879,514,0
Ector,110 City,"Justice, Supreme Court, Place 6, (Unexpired Term)",,REP,Over Votes,0,0,0,0
Ector,110 City,"Justice, Supreme Court, Place 6, (Unexpired Term)",,REP,Under Votes,68,54,14,0
Ector,110 City,"Justice, Supreme Court, Place 6, (Unexpired Term)",,DEM,Kathy Cheng,699,567,132,0
Ector,110 City,"Justice, Supreme Court, Place 7",,REP,Jeff Boyd,2334,1835,499,0
Ector,110 City,"Justice, Supreme Court, Place 7",,REP,Over Votes,0,0,0,0
Ector,110 City,"Justice, Supreme Court, Place 7",,REP,Under Votes,61,46,15,0
Ector,110 City,"Justice, Supreme Court, Place 7",,DEM,Staci Williams,685,566,119,0
Ector,110 City,"Justice, Supreme Court, Place 7",,LIB,William Bryan Strange III,80,53,27,0
Ector,110 City,"Justice, Supreme Court, Place 8",,REP,Brett Busby,2316,1827,489,0
Ector,110 City,"Justice, Supreme Court, Place 8",,REP,Over Votes,0,0,0,0
Ector,110 City,"Justice, Supreme Court, Place 8",,REP,Under Votes,65,50,15,0
Ector,110 City,"Justice, Supreme Court, Place 8",,DEM,Gisela D. Triana,699,570,129,0
Ector,110 City,"Justice, Supreme Court, Place 8",,LIB,Tom Oxford,80,53,27,0
Ector,110 City,"Judge, Court of Criminal Appeals, Place 3",,REP,Bert Richardson,2376,1871,505,0
Ector,110 City,"Judge, Court of Criminal Appeals, Place 3",,REP,Over Votes,0,0,0,0
Ector,110 City,"Judge, Court of Criminal Appeals, Place 3",,REP,Under Votes,72,55,17,0
Ector,110 City,"Judge, Court of Criminal Appeals, Place 3",,DEM,Elizabeth Davis Frizell,712,574,138,0
Ector,110 City,"Judge, Court of Criminal Appeals, Place 4",,REP,Kevin Patrick Yeary,2384,1872,512,0
Ector,110 City,"Judge, Court of Criminal Appeals, Place 4",,REP,Over Votes,0,0,0,0
Ector,110 City,"Judge, Court of Criminal Appeals, Place 4",,REP,Under Votes,71,54,17,0
Ector,110 City,"Judge, Court of Criminal Appeals, Place 4",,DEM,Tina Clinton,705,574,131,0
Ector,110 City,"Judge, Court of Criminal Appeals, Place 9",,REP,David Newell,2385,1873,512,0
Ector,110 City,"Judge, Court of Criminal Appeals, Place 9",,REP,Over Votes,0,0,0,0
Ector,110 City,"Judge, Court of Criminal Appeals, Place 9",,REP,Under Votes,76,59,17,0
Ector,110 City,"Judge, Court of Criminal Appeals, Place 9",,DEM,Brandon Birmingham,699,568,131,0
Ector,110 City,"Member, State Board of Education, District 1",,REP,Jennifer Ivey,2366,1859,507,0
Ector,110 City,"Member, State Board of Education, District 1",,REP,Over Votes,0,0,0,0
Ector,110 City,"Member, State Board of Education, District 1",,REP,Under Votes,89,73,16,0
Ector,110 City,"Member, State Board of Education, District 1",,DEM,Georgina Perez,705,568,137,0
Ector,110 City,State Representative,81,REP,Brooks Landgraf,2785,2182,603,0
Ector,110 City,State Representative,81,REP,Over Votes,0,0,0,0
Ector,110 City,State Representative,81,REP,Under Votes,375,318,57,0
Ector,110 City,"Justice, 11th Court of Appeals District, Place 2",,REP,Bruce Williams,2726,2136,590,0
Ector,110 City,"Justice, 11th Court of Appeals District, Place 2",,REP,Over Votes,0,0,0,0
Ector,110 City,"Justice, 11th Court of Appeals District, Place 2",,REP,Under Votes,434,364,70,0
Ector,110 City,"Justice, 11th Court of Appeals District, Place 3 (Unexpired Term)",,REP,W. Stacy Trotter,2733,2135,598,0
Ector,110 City,"Justice, 11th Court of Appeals District, Place 3 (Unexpired Term)",,REP,Over Votes,0,0,0,0
Ector,110 City,"Justice, 11th Court of Appeals District, Place 3 (Unexpired Term)",,REP,Under Votes,427,365,62,0
Ector,110 City,"District Judge, 161st Judicial District",,REP,Justin Low,2700,2113,587,0
Ector,110 City,"District Judge, 161st Judicial District",,REP,Over Votes,0,0,0,0
Ector,110 City,"District Judge, 161st Judicial District",,REP,Under Votes,460,387,73,0
Ector,110 City,"District Judge, 446th Judicial District",,REP,Sara Kate Billingsley,2726,2135,591,0
Ector,110 City,"District Judge, 446th Judicial District",,REP,Over Votes,0,0,0,0
Ector,110 City,"District Judge, 446th Judicial District",,REP,Under Votes,434,365,69,0
Ector,110 City,"District Attorney, 70th Judicial District",,REP,Dusty Gallivan,2730,2136,594,0
Ector,110 City,"District Attorney, 70th Judicial District",,REP,Over Votes,0,0,0,0
Ector,110 City,"District Attorney, 70th Judicial District",,REP,Under Votes,430,364,66,0
Ector,110 City,Mayor,,,Dewey Bryant,1154,921,233,0
Ector,110 City,Mayor,,,Over Votes,0,0,0,0
Ector,110 City,Mayor,,,Under Votes,286,233,53,0
Ector,110 City,Mayor,,,Javier Joven,1251,988,263,0
Ector,110 City,Mayor,,,Gloria G. Apolinario,469,358,111,0
Ector,110 City,"Council Member, At-Large",,,David R. Turner,1337,1024,313,0
Ector,110 City,"Council Member, At-Large",,,Over Votes,0,0,0,0
Ector,110 City,"Council Member, At-Large",,,Under Votes,318,260,58,0
Ector,110 City,"Council Member, At-Large",,,La-Tasha Gentry,347,278,69,0
Ector,110 City,"Council Member, At-Large",,,Jo Ann Davenport Littleton,246,199,47,0
Ector,110 City,"Council Member, At-Large",,,Denise Swanner,912,739,173,0
Ector,110 County,President,,REP,Donald J. Trump / Michael R. Pence,70,45,25,0
Ector,110 County,President,,REP,Over Votes,0,0,0,0
Ector,110 County,President,,REP,Under Votes,1,1,0,0
Ector,110 County,President,,DEM,Joseph R. Biden / Kamala D. Harris,42,36,6,0
Ector,110 County,President,,LIB,"Jo Jorgensen / Jeremy ""Spike"" Cohen",2,2,0,0
Ector,110 County,President,,GRN,Howie Hawkins / Angela Walker,0,0,0,0
Ector,110 County,President,,,President R. Boddie/Eric C. Stoneham,0,0,0,0
Ector,110 County,President,,,Brian Carroll/Amar Patel,0,0,0,0
Ector,110 County,President,,,Todd Cella/Tim Cella,0,0,0,0
Ector,110 County,President,,,Jesse Cuellar/Jimmy Monreal,0,0,0,0
Ector,110 County,President,,,Tom Hoefling/Andy Prior,0,0,0,0
Ector,110 County,President,,,Gloria La Riva/Leonard Peltier,0,0,0,0
Ector,110 County,President,,,Abram Loeb/Jennifer Jairala,0,0,0,0
Ector,110 County,President,,,Robert Morrow/Anne Beckett,0,0,0,0
Ector,110 County,President,,,Kasey Wells/Rachel Wells,0,0,0,0
Ector,110 County,U.S. Senate,,REP,John Cornyn,69,46,23,0
Ector,110 County,U.S. Senate,,REP,Over Votes,0,0,0,0
Ector,110 County,U.S. Senate,,REP,Under Votes,8,5,3,0
Ector,110 County,U.S. Senate,,DEM,"Mary ""MJ"" Hegar",33,29,4,0
Ector,110 County,U.S. Senate,,LIB,Kerry Douglas McKennon,0,0,0,0
Ector,110 County,U.S. Senate,,GRN,David B. Collins,5,4,1,0
Ector,110 County,U.S. Senate,,,Ricardo Turullols-Bonilla,0,0,0,0
Ector,110 County,U.S. House,11,REP,August Pfluger,68,43,25,0
Ector,110 County,U.S. House,11,REP,Over Votes,0,0,0,0
Ector,110 County,U.S. House,11,REP,Under Votes,6,3,3,0
Ector,110 County,U.S. House,11,DEM,Jon Mark Hogg,35,34,1,0
Ector,110 County,U.S. House,11,LIB,Wacey Alpha Cody,6,4,2,0
Ector,110 County,Railroad Commissioner,,REP,"James ""Jim"" Wright",67,44,23,0
Ector,110 County,Railroad Commissioner,,REP,Over Votes,0,0,0,0
Ector,110 County,Railroad Commissioner,,REP,Under Votes,5,2,3,0
Ector,110 County,Railroad Commissioner,,DEM,Chrysta Castañeda,37,32,5,0
Ector,110 County,Railroad Commissioner,,LIB,Matt Sterett,2,2,0,0
Ector,110 County,Railroad Commissioner,,GRN,"Katija ""Kat"" Gruene",4,4,0,0
Ector,110 County,"Chief Justice, Supreme Court",,REP,Nathan Hecht,64,42,22,0
Ector,110 County,"Chief Justice, Supreme Court",,REP,Over Votes,0,0,0,0
Ector,110 County,"Chief Justice, Supreme Court",,REP,Under Votes,5,2,3,0
Ector,110 County,"Chief Justice, Supreme Court",,DEM,Amy Clark Meachum,40,36,4,0
Ector,110 County,"Chief Justice, Supreme Court",,LIB,Mark Ash,6,4,2,0
Ector,110 County,"Justice, Supreme Court, Place 6, (Unexpired Term)",,REP,Jane Bland,68,43,25,0
Ector,110 County,"Justice, Supreme Court, Place 6, (Unexpired Term)",,REP,Over Votes,0,0,0,0
Ector,110 County,"Justice, Supreme Court, Place 6, (Unexpired Term)",,REP,Under Votes,6,3,3,0
Ector,110 County,"Justice, Supreme Court, Place 6, (Unexpired Term)",,DEM,Kathy Cheng,41,38,3,0
Ector,110 County,"Justice, Supreme Court, Place 7",,REP,Jeff Boyd,66,44,22,0
Ector,110 County,"Justice, Supreme Court, Place 7",,REP,Over Votes,0,0,0,0
Ector,110 County,"Justice, Supreme Court, Place 7",,REP,Under Votes,6,3,3,0
Ector,110 County,"Justice, Supreme Court, Place 7",,DEM,Staci Williams,38,34,4,0
Ector,110 County,"Justice, Supreme Court, Place 7",,LIB,William Bryan Strange III,5,3,2,0
Ector,110 County,"Justice, Supreme Court, Place 8",,REP,Brett Busby,64,41,23,0
Ector,110 County,"Justice, Supreme Court, Place 8",,REP,Over Votes,0,0,0,0
Ector,110 County,"Justice, Supreme Court, Place 8",,REP,Under Votes,7,4,3,0
Ector,110 County,"Justice, Supreme Court, Place 8",,DEM,Gisela D. Triana,39,35,4,0
Ector,110 County,"Justice, Supreme Court, Place 8",,LIB,Tom Oxford,5,4,1,0
Ector,110 County,"Judge, Court of Criminal Appeals, Place 3",,REP,Bert Richardson,64,42,22,0
Ector,110 County,"Judge, Court of Criminal Appeals, Place 3",,REP,Over Votes,0,0,0,0
Ector,110 County,"Judge, Court of Criminal Appeals, Place 3",,REP,Under Votes,7,4,3,0
Ector,110 County,"Judge, Court of Criminal Appeals, Place 3",,DEM,Elizabeth Davis Frizell,44,38,6,0
Ector,110 County,"Judge, Court of Criminal Appeals, Place 4",,REP,Kevin Patrick Yeary,65,42,23,0
Ector,110 County,"Judge, Court of Criminal Appeals, Place 4",,REP,Over Votes,0,0,0,0
Ector,110 County,"Judge, Court of Criminal Appeals, Place 4",,REP,Under Votes,7,4,3,0
Ector,110 County,"Judge, Court of Criminal Appeals, Place 4",,DEM,Tina Clinton,43,38,5,0
Ector,110 County,"Judge, Court of Criminal Appeals, Place 9",,REP,David Newell,67,43,24,0
Ector,110 County,"Judge, Court of Criminal Appeals, Place 9",,REP,Over Votes,0,0,0,0
Ector,110 County,"Judge, Court of Criminal Appeals, Place 9",,REP,Under Votes,8,5,3,0
Ector,110 County,"Judge, Court of Criminal Appeals, Place 9",,DEM,Brandon Birmingham,40,36,4,0
Ector,110 County,"Member, State Board of Education, District 1",,REP,Jennifer Ivey,65,43,22,0
Ector,110 County,"Member, State Board of Education, District 1",,REP,Over Votes,0,0,0,0
Ector,110 County,"Member, State Board of Education, District 1",,REP,Under Votes,7,4,3,0
Ector,110 County,"Member, State Board of Education, District 1",,DEM,Georgina Perez,43,37,6,0
Ector,110 County,State Representative,81,REP,Brooks Landgraf,94,67,27,0
Ector,110 County,State Representative,81,REP,Over Votes,0,0,0,0
Ector,110 County,State Representative,81,REP,Under Votes,21,17,4,0
Ector,110 County,"Justice, 11th Court of Appeals District, Place 2",,REP,Bruce Williams,88,62,26,0
Ector,110 County,"Justice, 11th Court of Appeals District, Place 2",,REP,Over Votes,0,0,0,0
Ector,110 County,"Justice, 11th Court of Appeals District, Place 2",,REP,Under Votes,27,22,5,0
Ector,110 County,"Justice, 11th Court of Appeals District, Place 3 (Unexpired Term)",,REP,W. Stacy Trotter,91,65,26,0
Ector,110 County,"Justice, 11th Court of Appeals District, Place 3 (Unexpired Term)",,REP,Over Votes,0,0,0,0
Ector,110 County,"Justice, 11th Court of Appeals District, Place 3 (Unexpired Term)",,REP,Under Votes,24,19,5,0
Ector,110 County,"District Judge, 161st Judicial District",,REP,Justin Low,88,62,26,0
Ector,110 County,"District Judge, 161st Judicial District",,REP,Over Votes,0,0,0,0
Ector,110 County,"District Judge, 161st Judicial District",,REP,Under Votes,27,22,5,0
Ector,110 County,"District Judge, 446th Judicial District",,REP,Sara Kate Billingsley,88,63,25,0
Ector,110 County,"District Judge, 446th Judicial District",,REP,Over Votes,0,0,0,0
Ector,110 County,"District Judge, 446th Judicial District",,REP,Under Votes,27,21,6,0
Ector,110 County,"District Attorney, 70th Judicial District",,REP,Dusty Gallivan,89,63,26,0
Ector,110 County,"District Attorney, 70th Judicial District",,REP,Over Votes,0,0,0,0
Ector,110 County,"District Attorney, 70th Judicial District",,REP,Under Votes,26,21,5,0
Ector,111,President,,REP,Donald J. Trump / Michael R. Pence,247,184,63,0
Ector,111,President,,REP,Over Votes,0,0,0,0
Ector,111,President,,REP,Under Votes,5,5,0,0
Ector,111,President,,DEM,Joseph R. Biden / Kamala D. Harris,101,79,22,0
Ector,111,President,,LIB,"Jo Jorgensen / Jeremy ""Spike"" Cohen",5,3,2,0
Ector,111,President,,GRN,Howie Hawkins / Angela Walker,3,1,2,0
Ector,111,President,,,President R. Boddie/Eric C. Stoneham,0,0,0,0
Ector,111,President,,,Brian Carroll/Amar Patel,0,0,0,0
Ector,111,President,,,Todd Cella/Tim Cella,0,0,0,0
Ector,111,President,,,Jesse Cuellar/Jimmy Monreal,0,0,0,0
Ector,111,President,,,Tom Hoefling/Andy Prior,0,0,0,0
Ector,111,President,,,Gloria La Riva/Leonard Peltier,0,0,0,0
Ector,111,President,,,Abram Loeb/Jennifer Jairala,0,0,0,0
Ector,111,President,,,Robert Morrow/Anne Beckett,0,0,0,0
Ector,111,President,,,Kasey Wells/Rachel Wells,0,0,0,0
Ector,111,U.S. Senate,,REP,John Cornyn,240,189,51,0
Ector,111,U.S. Senate,,REP,Over Votes,0,0,0,0
Ector,111,U.S. Senate,,REP,Under Votes,18,12,6,0
Ector,111,U.S. Senate,,DEM,"Mary ""MJ"" Hegar",92,65,27,0
Ector,111,U.S. Senate,,LIB,Kerry Douglas McKennon,8,4,4,0
Ector,111,U.S. Senate,,GRN,David B. Collins,3,2,1,0
Ector,111,U.S. Senate,,,Ricardo Turullols-Bonilla,0,0,0,0
Ector,111,U.S. House,11,REP,August Pfluger,240,186,54,0
Ector,111,U.S. House,11,REP,Over Votes,0,0,0,0
Ector,111,U.S. House,11,REP,Under Votes,22,14,8,0
Ector,111,U.S. House,11,DEM,Jon Mark Hogg,85,63,22,0
Ector,111,U.S. House,11,LIB,Wacey Alpha Cody,14,9,5,0
Ector,111,Railroad Commissioner,,REP,"James ""Jim"" Wright",236,185,51,0
Ector,111,Railroad Commissioner,,REP,Over Votes,0,0,0,0
Ector,111,Railroad Commissioner,,REP,Under Votes,18,12,6,0
Ector,111,Railroad Commissioner,,DEM,Chrysta Castañeda,97,69,28,0
Ector,111,Railroad Commissioner,,LIB,Matt Sterett,8,4,4,0
Ector,111,Railroad Commissioner,,GRN,"Katija ""Kat"" Gruene",2,2,0,0
Ector,111,"Chief Justice, Supreme Court",,REP,Nathan Hecht,221,175,46,0
Ector,111,"Chief Justice, Supreme Court",,REP,Over Votes,0,0,0,0
Ector,111,"Chief Justice, Supreme Court",,REP,Under Votes,17,10,7,0
Ector,111,"Chief Justice, Supreme Court",,DEM,Amy Clark Meachum,109,80,29,0
Ector,111,"Chief Justice, Supreme Court",,LIB,Mark Ash,14,7,7,0
Ector,111,"Justice, Supreme Court, Place 6, (Unexpired Term)",,REP,Jane Bland,236,180,56,0
Ector,111,"Justice, Supreme Court, Place 6, (Unexpired Term)",,REP,Over Votes,0,0,0,0
Ector,111,"Justice, Supreme Court, Place 6, (Unexpired Term)",,REP,Under Votes,19,12,7,0
Ector,111,"Justice, Supreme Court, Place 6, (Unexpired Term)",,DEM,Kathy Cheng,106,80,26,0
Ector,111,"Justice, Supreme Court, Place 7",,REP,Jeff Boyd,229,177,52,0
Ector,111,"Justice, Supreme Court, Place 7",,REP,Over Votes,0,0,0,0
Ector,111,"Justice, Supreme Court, Place 7",,REP,Under Votes,22,15,7,0
Ector,111,"Justice, Supreme Court, Place 7",,DEM,Staci Williams,98,73,25,0
Ector,111,"Justice, Supreme Court, Place 7",,LIB,William Bryan Strange III,12,7,5,0
Ector,111,"Justice, Supreme Court, Place 8",,REP,Brett Busby,227,178,49,0
Ector,111,"Justice, Supreme Court, Place 8",,REP,Over Votes,0,0,0,0
Ector,111,"Justice, Supreme Court, Place 8",,REP,Under Votes,21,14,7,0
Ector,111,"Justice, Supreme Court, Place 8",,DEM,Gisela D. Triana,102,74,28,0
Ector,111,"Justice, Supreme Court, Place 8",,LIB,Tom Oxford,11,6,5,0
Ector,111,"Judge, Court of Criminal Appeals, Place 3",,REP,Bert Richardson,231,181,50,0
Ector,111,"Judge, Court of Criminal Appeals, Place 3",,REP,Over Votes,0,0,0,0
Ector,111,"Judge, Court of Criminal Appeals, Place 3",,REP,Under Votes,26,16,10,0
Ector,111,"Judge, Court of Criminal Appeals, Place 3",,DEM,Elizabeth Davis Frizell,104,75,29,0
Ector,111,"Judge, Court of Criminal Appeals, Place 4",,REP,Kevin Patrick Yeary,243,185,58,0
Ector,111,"Judge, Court of Criminal Appeals, Place 4",,REP,Over Votes,0,0,0,0
Ector,111,"Judge, Court of Criminal Appeals, Place 4",,REP,Under Votes,25,17,8,0
Ector,111,"Judge, Court of Criminal Appeals, Place 4",,DEM,Tina Clinton,93,70,23,0
Ector,111,"Judge, Court of Criminal Appeals, Place 9",,REP,David Newell,238,183,55,0
Ector,111,"Judge, Court of Criminal Appeals, Place 9",,REP,Over Votes,0,0,0,0
Ector,111,"Judge, Court of Criminal Appeals, Place 9",,REP,Under Votes,25,17,8,0
Ector,111,"Judge, Court of Criminal Appeals, Place 9",,DEM,Brandon Birmingham,98,72,26,0
Ector,111,"Member, State Board of Education, District 1",,REP,Jennifer Ivey,234,182,52,0
Ector,111,"Member, State Board of Education, District 1",,REP,Over Votes,0,0,0,0
Ector,111,"Member, State Board of Education, District 1",,REP,Under Votes,21,13,8,0
Ector,111,"Member, State Board of Education, District 1",,DEM,Georgina Perez,106,77,29,0
Ector,111,State Representative,81,REP,Brooks Landgraf,281,211,70,0
Ector,111,State Representative,81,REP,Over Votes,0,0,0,0
Ector,111,State Representative,81,REP,Under Votes,80,61,19,0
Ector,111,"Justice, 11th Court of Appeals District, Place 2",,REP,Bruce Williams,271,205,66,0
Ector,111,"Justice, 11th Court of Appeals District, Place 2",,REP,Over Votes,0,0,0,0
Ector,111,"Justice, 11th Court of Appeals District, Place 2",,REP,Under Votes,90,67,23,0
Ector,111,"Justice, 11th Court of Appeals District, Place 3 (Unexpired Term)",,REP,W. Stacy Trotter,274,207,67,0
Ector,111,"Justice, 11th Court of Appeals District, Place 3 (Unexpired Term)",,REP,Over Votes,0,0,0,0
Ector,111,"Justice, 11th Court of Appeals District, Place 3 (Unexpired Term)",,REP,Under Votes,87,65,22,0
Ector,111,"District Judge, 161st Judicial District",,REP,Justin Low,272,206,66,0
Ector,111,"District Judge, 161st Judicial District",,REP,Over Votes,0,0,0,0
Ector,111,"District Judge, 161st Judicial District",,REP,Under Votes,89,66,23,0
Ector,111,"District Judge, 446th Judicial District",,REP,Sara Kate Billingsley,276,211,65,0
Ector,111,"District Judge, 446th Judicial District",,REP,Over Votes,0,0,0,0
Ector,111,"District Judge, 446th Judicial District",,REP,Under Votes,85,61,24,0
Ector,111,"District Attorney, 70th Judicial District",,REP,Dusty Gallivan,274,209,65,0
Ector,111,"District Attorney, 70th Judicial District",,REP,Over Votes,0,0,0,0
Ector,111,"District Attorney, 70th Judicial District",,REP,Under Votes,87,63,24,0
Ector,111,Mayor,,,Dewey Bryant,123,99,24,0
Ector,111,Mayor,,,Over Votes,0,0,0,0
Ector,111,Mayor,,,Under Votes,42,30,12,0
Ector,111,Mayor,,,Javier Joven,136,96,40,0
Ector,111,Mayor,,,Gloria G. Apolinario,60,47,13,0
Ector,111,"Council Member, At-Large",,,David R. Turner,131,97,34,0
Ector,111,"Council Member, At-Large",,,Over Votes,0,0,0,0
Ector,111,"Council Member, At-Large",,,Under Votes,46,33,13,0
Ector,111,"Council Member, At-Large",,,La-Tasha Gentry,43,28,15,0
Ector,111,"Council Member, At-Large",,,Jo Ann Davenport Littleton,54,44,10,0
Ector,111,"Council Member, At-Large",,,Denise Swanner,87,70,17,0
Ector,201,President,,REP,Donald J. Trump / Michael R. Pence,3753,3291,462,0
Ector,201,President,,REP,Over Votes,1,1,0,0
Ector,201,President,,REP,Under Votes,23,20,3,0
Ector,201,President,,DEM,Joseph R. Biden / Kamala D. Harris,872,758,114,0
Ector,201,President,,LIB,"Jo Jorgensen / Jeremy ""Spike"" Cohen",34,24,10,0
Ector,201,President,,GRN,Howie Hawkins / Angela Walker,4,4,0,0
Ector,201,President,,,President R. Boddie/Eric C. Stoneham,0,0,0,0
Ector,201,President,,,Brian Carroll/Amar Patel,0,0,0,0
Ector,201,President,,,Todd Cella/Tim Cella,0,0,0,0
Ector,201,President,,,Jesse Cuellar/Jimmy Monreal,0,0,0,0
Ector,201,President,,,Tom Hoefling/Andy Prior,0,0,0,0
Ector,201,President,,,Gloria La Riva/Leonard Peltier,0,0,0,0
Ector,201,President,,,Abram Loeb/Jennifer Jairala,0,0,0,0
Ector,201,President,,,Robert Morrow/Anne Beckett,0,0,0,0
Ector,201,President,,,Kasey Wells/Rachel Wells,0,0,0,0
Ector,201,U.S. Senate,,REP,John Cornyn,3749,3305,444,0
Ector,201,U.S. Senate,,REP,Over Votes,0,0,0,0
Ector,201,U.S. Senate,,REP,Under Votes,59,48,11,0
Ector,201,U.S. Senate,,DEM,"Mary ""MJ"" Hegar",796,685,111,0
Ector,201,U.S. Senate,,LIB,Kerry Douglas McKennon,76,55,21,0
Ector,201,U.S. Senate,,GRN,David B. Collins,7,5,2,0
Ector,201,U.S. Senate,,,Ricardo Turullols-Bonilla,0,0,0,0
Ector,201,U.S. House,11,REP,August Pfluger,3767,3321,446,0
Ector,201,U.S. House,11,REP,Over Votes,0,0,0,0
Ector,201,U.S. House,11,REP,Under Votes,85,68,17,0
Ector,201,U.S. House,11,DEM,Jon Mark Hogg,763,656,107,0
Ector,201,U.S. House,11,LIB,Wacey Alpha Cody,72,53,19,0
Ector,201,Railroad Commissioner,,REP,"James ""Jim"" Wright",3738,3291,447,0
Ector,201,Railroad Commissioner,,REP,Over Votes,0,0,0,0
Ector,201,Railroad Commissioner,,REP,Under Votes,82,66,16,0
Ector,201,Railroad Commissioner,,DEM,Chrysta Castañeda,762,656,106,0
Ector,201,Railroad Commissioner,,LIB,Matt Sterett,84,66,18,0
Ector,201,Railroad Commissioner,,GRN,"Katija ""Kat"" Gruene",21,19,2,0
Ector,201,"Chief Justice, Supreme Court",,REP,Nathan Hecht,3690,3255,435,0
Ector,201,"Chief Justice, Supreme Court",,REP,Over Votes,0,0,0,0
Ector,201,"Chief Justice, Supreme Court",,REP,Under Votes,81,65,16,0
Ector,201,"Chief Justice, Supreme Court",,DEM,Amy Clark Meachum,826,710,116,0
Ector,201,"Chief Justice, Supreme Court",,LIB,Mark Ash,90,68,22,0
Ector,201,"Justice, Supreme Court, Place 6, (Unexpired Term)",,REP,Jane Bland,3785,3330,455,0
Ector,201,"Justice, Supreme Court, Place 6, (Unexpired Term)",,REP,Over Votes,0,0,0,0
Ector,201,"Justice, Supreme Court, Place 6, (Unexpired Term)",,REP,Under Votes,77,61,16,0
Ector,201,"Justice, Supreme Court, Place 6, (Unexpired Term)",,DEM,Kathy Cheng,825,707,118,0
Ector,201,"Justice, Supreme Court, Place 7",,REP,Jeff Boyd,3703,3268,435,0
Ector,201,"Justice, Supreme Court, Place 7",,REP,Over Votes,0,0,0,0
Ector,201,"Justice, Supreme Court, Place 7",,REP,Under Votes,91,70,21,0
Ector,201,"Justice, Supreme Court, Place 7",,DEM,Staci Williams,807,696,111,0
Ector,201,"Justice, Supreme Court, Place 7",,LIB,William Bryan Strange III,86,64,22,0
Ector,201,"Justice, Supreme Court, Place 8",,REP,Brett Busby,3702,3266,436,0
Ector,201,"Justice, Supreme Court, Place 8",,REP,Over Votes,0,0,0,0
Ector,201,"Justice, Supreme Court, Place 8",,REP,Under Votes,101,79,22,0
Ector,201,"Justice, Supreme Court, Place 8",,DEM,Gisela D. Triana,791,682,109,0
Ector,201,"Justice, Supreme Court, Place 8",,LIB,Tom Oxford,93,71,22,0
Ector,201,"Judge, Court of Criminal Appeals, Place 3",,REP,Bert Richardson,3738,3294,444,0
Ector,201,"Judge, Court of Criminal Appeals, Place 3",,REP,Over Votes,0,0,0,0
Ector,201,"Judge, Court of Criminal Appeals, Place 3",,REP,Under Votes,103,81,22,0
Ector,201,"Judge, Court of Criminal Appeals, Place 3",,DEM,Elizabeth Davis Frizell,846,723,123,0
Ector,201,"Judge, Court of Criminal Appeals, Place 4",,REP,Kevin Patrick Yeary,3762,3312,450,0
Ector,201,"Judge, Court of Criminal Appeals, Place 4",,REP,Over Votes,0,0,0,0
Ector,201,"Judge, Court of Criminal Appeals, Place 4",,REP,Under Votes,105,83,22,0
Ector,201,"Judge, Court of Criminal Appeals, Place 4",,DEM,Tina Clinton,820,703,117,0
Ector,201,"Judge, Court of Criminal Appeals, Place 9",,REP,David Newell,3777,3319,458,0
Ector,201,"Judge, Court of Criminal Appeals, Place 9",,REP,Over Votes,0,0,0,0
Ector,201,"Judge, Court of Criminal Appeals, Place 9",,REP,Under Votes,109,87,22,0
Ector,201,"Judge, Court of Criminal Appeals, Place 9",,DEM,Brandon Birmingham,801,692,109,0
Ector,201,"Member, State Board of Education, District 1",,REP,Jennifer Ivey,3728,3281,447,0
Ector,201,"Member, State Board of Education, District 1",,REP,Over Votes,0,0,0,0
Ector,201,"Member, State Board of Education, District 1",,REP,Under Votes,140,118,22,0
Ector,201,"Member, State Board of Education, District 1",,DEM,Georgina Perez,819,699,120,0
Ector,201,State Representative,81,REP,Brooks Landgraf,4188,3664,524,0
Ector,201,State Representative,81,REP,Over Votes,0,0,0,0
Ector,201,State Representative,81,REP,Under Votes,499,434,65,0
Ector,201,"Justice, 11th Court of Appeals District, Place 2",,REP,Bruce Williams,4080,3565,515,0
Ector,201,"Justice, 11th Court of Appeals District, Place 2",,REP,Over Votes,0,0,0,0
Ector,201,"Justice, 11th Court of Appeals District, Place 2",,REP,Under Votes,607,533,74,0
Ector,201,"Justice, 11th Court of Appeals District, Place 3 (Unexpired Term)",,REP,W. Stacy Trotter,4069,3560,509,0
Ector,201,"Justice, 11th Court of Appeals District, Place 3 (Unexpired Term)",,REP,Over Votes,0,0,0,0
Ector,201,"Justice, 11th Court of Appeals District, Place 3 (Unexpired Term)",,REP,Under Votes,618,538,80,0
Ector,201,"District Judge, 161st Judicial District",,REP,Justin Low,4021,3515,506,0
Ector,201,"District Judge, 161st Judicial District",,REP,Over Votes,0,0,0,0
Ector,201,"District Judge, 161st Judicial District",,REP,Under Votes,666,583,83,0
Ector,201,"District Judge, 446th Judicial District",,REP,Sara Kate Billingsley,4055,3545,510,0
Ector,201,"District Judge, 446th Judicial District",,REP,Over Votes,0,0,0,0
Ector,201,"District Judge, 446th Judicial District",,REP,Under Votes,632,553,79,0
Ector,201,"District Attorney, 70th Judicial District",,REP,Dusty Gallivan,4059,3547,512,0
Ector,201,"District Attorney, 70th Judicial District",,REP,Over Votes,0,0,0,0
Ector,201,"District Attorney, 70th Judicial District",,REP,Under Votes,628,551,77,0
Ector,201,Mayor,,,Dewey Bryant,2177,1940,237,0
Ector,201,Mayor,,,Over Votes,0,0,0,0
Ector,201,Mayor,,,Under Votes,449,372,77,0
Ector,201,Mayor,,,Javier Joven,1452,1263,189,0
Ector,201,Mayor,,,Gloria G. Apolinario,609,523,86,0
Ector,201,"Council Member, District 2",,,Steven P. Thompson,2214,1919,295,0
Ector,201,"Council Member, District 2",,,Over Votes,0,0,0,0
Ector,201,"Council Member, District 2",,,Under Votes,653,552,101,0
Ector,201,"Council Member, District 2",,,Rachel D. Minor,1820,1627,193,0
Ector,201,"Council Member, At-Large",,,David R. Turner,1881,1641,240,0
Ector,201,"Council Member, At-Large",,,Over Votes,0,0,0,0
Ector,201,"Council Member, At-Large",,,Under Votes,534,453,81,0
Ector,201,"Council Member, At-Large",,,La-Tasha Gentry,353,284,69,0
Ector,201,"Council Member, At-Large",,,Jo Ann Davenport Littleton,369,304,65,0
Ector,201,"Council Member, At-Large",,,Denise Swanner,1550,1416,134,0
Ector,202,President,,REP,Donald J. Trump / Michael R. Pence,1532,1352,180,0
Ector,202,President,,REP,Over Votes,0,0,0,0
Ector,202,President,,REP,Under Votes,15,14,1,0
Ector,202,President,,DEM,Joseph R. Biden / Kamala D. Harris,374,325,49,0
Ector,202,President,,LIB,"Jo Jorgensen / Jeremy ""Spike"" Cohen",25,17,8,0
Ector,202,President,,GRN,Howie Hawkins / Angela Walker,3,3,0,0
Ector,202,President,,,President R. Boddie/Eric C. Stoneham,0,0,0,0
Ector,202,President,,,Brian Carroll/Amar Patel,1,1,0,0
Ector,202,President,,,Todd Cella/Tim Cella,1,1,0,0
Ector,202,President,,,Jesse Cuellar/Jimmy Monreal,0,0,0,0
Ector,202,President,,,Tom Hoefling/Andy Prior,0,0,0,0
Ector,202,President,,,Gloria La Riva/Leonard Peltier,0,0,0,0
Ector,202,President,,,Abram Loeb/Jennifer Jairala,0,0,0,0
Ector,202,President,,,Robert Morrow/Anne Beckett,0,0,0,0
Ector,202,President,,,Kasey Wells/Rachel Wells,0,0,0,0
Ector,202,U.S. Senate,,REP,John Cornyn,1524,1351,173,0
Ector,202,U.S. Senate,,REP,Over Votes,0,0,0,0
Ector,202,U.S. Senate,,REP,Under Votes,25,23,2,0
Ector,202,U.S. Senate,,DEM,"Mary ""MJ"" Hegar",348,303,45,0
Ector,202,U.S. Senate,,LIB,Kerry Douglas McKennon,48,31,17,0
Ector,202,U.S. Senate,,GRN,David B. Collins,6,5,1,0
Ector,202,U.S. Senate,,,Ricardo Turullols-Bonilla,0,0,0,0
Ector,202,U.S. House,11,REP,August Pfluger,1545,1360,185,0
Ector,202,U.S. House,11,REP,Over Votes,0,0,0,0
Ector,202,U.S. House,11,REP,Under Votes,36,34,2,0
Ector,202,U.S. House,11,DEM,Jon Mark Hogg,332,289,43,0
Ector,202,U.S. House,11,LIB,Wacey Alpha Cody,38,30,8,0
Ector,202,Railroad Commissioner,,REP,"James ""Jim"" Wright",1532,1358,174,0
Ector,202,Railroad Commissioner,,REP,Over Votes,0,0,0,0
Ector,202,Railroad Commissioner,,REP,Under Votes,37,34,3,0
Ector,202,Railroad Commissioner,,DEM,Chrysta Castañeda,332,284,48,0
Ector,202,Railroad Commissioner,,LIB,Matt Sterett,41,30,11,0
Ector,202,Railroad Commissioner,,GRN,"Katija ""Kat"" Gruene",9,7,2,0
Ector,202,"Chief Justice, Supreme Court",,REP,Nathan Hecht,1511,1337,174,0
Ector,202,"Chief Justice, Supreme Court",,REP,Over Votes,0,0,0,0
Ector,202,"Chief Justice, Supreme Court",,REP,Under Votes,35,33,2,0
Ector,202,"Chief Justice, Supreme Court",,DEM,Amy Clark Meachum,364,312,52,0
Ector,202,"Chief Justice, Supreme Court",,LIB,Mark Ash,41,31,10,0
Ector,202,"Justice, Supreme Court, Place 6, (Unexpired Term)",,REP,Jane Bland,1561,1369,192,0
Ector,202,"Justice, Supreme Court, Place 6, (Unexpired Term)",,REP,Over Votes,0,0,0,0
Ector,202,"Justice, Supreme Court, Place 6, (Unexpired Term)",,REP,Under Votes,46,42,4,0
Ector,202,"Justice, Supreme Court, Place 6, (Unexpired Term)",,DEM,Kathy Cheng,344,302,42,0
Ector,202,"Justice, Supreme Court, Place 7",,REP,Jeff Boyd,1524,1343,181,0
Ector,202,"Justice, Supreme Court, Place 7",,REP,Over Votes,1,1,0,0
Ector,202,"Justice, Supreme Court, Place 7",,REP,Under Votes,38,36,2,0
Ector,202,"Justice, Supreme Court, Place 7",,DEM,Staci Williams,351,304,47,0
Ector,202,"Justice, Supreme Court, Place 7",,LIB,William Bryan Strange III,37,29,8,0
Ector,202,"Justice, Supreme Court, Place 8",,REP,Brett Busby,1516,1338,178,0
Ector,202,"Justice, Supreme Court, Place 8",,REP,Over Votes,0,0,0,0
Ector,202,"Justice, Supreme Court, Place 8",,REP,Under Votes,43,41,2,0
Ector,202,"Justice, Supreme Court, Place 8",,DEM,Gisela D. Triana,348,299,49,0
Ector,202,"Justice, Supreme Court, Place 8",,LIB,Tom Oxford,44,35,9,0
Ector,202,"Judge, Court of Criminal Appeals, Place 3",,REP,Bert Richardson,1538,1358,180,0
Ector,202,"Judge, Court of Criminal Appeals, Place 3",,REP,Over Votes,0,0,0,0
Ector,202,"Judge, Court of Criminal Appeals, Place 3",,REP,Under Votes,45,42,3,0
Ector,202,"Judge, Court of Criminal Appeals, Place 3",,DEM,Elizabeth Davis Frizell,368,313,55,0
Ector,202,"Judge, Court of Criminal Appeals, Place 4",,REP,Kevin Patrick Yeary,1548,1362,186,0
Ector,202,"Judge, Court of Criminal Appeals, Place 4",,REP,Over Votes,0,0,0,0
Ector,202,"Judge, Court of Criminal Appeals, Place 4",,REP,Under Votes,44,40,4,0
Ector,202,"Judge, Court of Criminal Appeals, Place 4",,DEM,Tina Clinton,359,311,48,0
Ector,202,"Judge, Court of Criminal Appeals, Place 9",,REP,David Newell,1546,1361,185,0
Ector,202,"Judge, Court of Criminal Appeals, Place 9",,REP,Over Votes,0,0,0,0
Ector,202,"Judge, Court of Criminal Appeals, Place 9",,REP,Under Votes,51,46,5,0
Ector,202,"Judge, Court of Criminal Appeals, Place 9",,DEM,Brandon Birmingham,354,306,48,0
Ector,202,"Member, State Board of Education, District 1",,REP,Jennifer Ivey,1534,1354,180,0
Ector,202,"Member, State Board of Education, District 1",,REP,Over Votes,0,0,0,0
Ector,202,"Member, State Board of Education, District 1",,REP,Under Votes,53,49,4,0
Ector,202,"Member, State Board of Education, District 1",,DEM,Georgina Perez,364,310,54,0
Ector,202,State Representative,81,REP,Brooks Landgraf,1746,1521,225,0
Ector,202,State Representative,81,REP,Over Votes,0,0,0,0
Ector,202,State Representative,81,REP,Under Votes,205,192,13,0
Ector,202,"Justice, 11th Court of Appeals District, Place 2",,REP,Bruce Williams,1687,1472,215,0
Ector,202,"Justice, 11th Court of Appeals District, Place 2",,REP,Over Votes,0,0,0,0
Ector,202,"Justice, 11th Court of Appeals District, Place 2",,REP,Under Votes,264,241,23,0
Ector,202,"Justice, 11th Court of Appeals District, Place 3 (Unexpired Term)",,REP,W. Stacy Trotter,1694,1482,212,0
Ector,202,"Justice, 11th Court of Appeals District, Place 3 (Unexpired Term)",,REP,Over Votes,0,0,0,0
Ector,202,"Justice, 11th Court of Appeals District, Place 3 (Unexpired Term)",,REP,Under Votes,257,231,26,0
Ector,202,"District Judge, 161st Judicial District",,REP,Justin Low,1661,1446,215,0
Ector,202,"District Judge, 161st Judicial District",,REP,Over Votes,0,0,0,0
Ector,202,"District Judge, 161st Judicial District",,REP,Under Votes,290,267,23,0
Ector,202,"District Judge, 446th Judicial District",,REP,Sara Kate Billingsley,1690,1477,213,0
Ector,202,"District Judge, 446th Judicial District",,REP,Over Votes,0,0,0,0
Ector,202,"District Judge, 446th Judicial District",,REP,Under Votes,261,236,25,0
Ector,202,"District Attorney, 70th Judicial District",,REP,Dusty Gallivan,1696,1481,215,0
Ector,202,"District Attorney, 70th Judicial District",,REP,Over Votes,0,0,0,0
Ector,202,"District Attorney, 70th Judicial District",,REP,Under Votes,255,232,23,0
Ector,202,Mayor,,,Dewey Bryant,823,729,94,0
Ector,202,Mayor,,,Over Votes,0,0,0,0
Ector,202,Mayor,,,Under Votes,173,147,26,0
Ector,202,Mayor,,,Javier Joven,702,616,86,0
Ector,202,Mayor,,,Gloria G. Apolinario,253,221,32,0
Ector,202,"Council Member, District 2",,,Steven P. Thompson,938,811,127,0
Ector,202,"Council Member, District 2",,,Over Votes,0,0,0,0
Ector,202,"Council Member, District 2",,,Under Votes,249,216,33,0
Ector,202,"Council Member, District 2",,,Rachel D. Minor,764,686,78,0
Ector,202,"Council Member, At-Large",,,David R. Turner,768,668,100,0
Ector,202,"Council Member, At-Large",,,Over Votes,1,1,0,0
Ector,202,"Council Member, At-Large",,,Under Votes,194,163,31,0
Ector,202,"Council Member, At-Large",,,La-Tasha Gentry,162,127,35,0
Ector,202,"Council Member, At-Large",,,Jo Ann Davenport Littleton,167,149,18,0
Ector,202,"Council Member, At-Large",,,Denise Swanner,659,605,54,0
Ector,203,President,,REP,Donald J. Trump / Michael R. Pence,1513,1302,211,0
Ector,203,President,,REP,Over Votes,0,0,0,0
Ector,203,President,,REP,Under Votes,11,9,2,0
Ector,203,President,,DEM,Joseph R. Biden / Kamala D. Harris,400,346,54,0
Ector,203,President,,LIB,"Jo Jorgensen / Jeremy ""Spike"" Cohen",19,14,5,0
Ector,203,President,,GRN,Howie Hawkins / Angela Walker,4,3,1,0
Ector,203,President,,,President R. Boddie/Eric C. Stoneham,0,0,0,0
Ector,203,President,,,Brian Carroll/Amar Patel,0,0,0,0
Ector,203,President,,,Todd Cella/Tim Cella,0,0,0,0
Ector,203,President,,,Jesse Cuellar/Jimmy Monreal,0,0,0,0
Ector,203,President,,,Tom Hoefling/Andy Prior,0,0,0,0
Ector,203,President,,,Gloria La Riva/Leonard Peltier,0,0,0,0
Ector,203,President,,,Abram Loeb/Jennifer Jairala,0,0,0,0
Ector,203,President,,,Robert Morrow/Anne Beckett,0,0,0,0
Ector,203,President,,,Kasey Wells/Rachel Wells,0,0,0,0
Ector,203,U.S. Senate,,REP,John Cornyn,1496,1292,204,0
Ector,203,U.S. Senate,,REP,Over Votes,0,0,0,0
Ector,203,U.S. Senate,,REP,Under Votes,29,24,5,0
Ector,203,U.S. Senate,,DEM,"Mary ""MJ"" Hegar",379,328,51,0
Ector,203,U.S. Senate,,LIB,Kerry Douglas McKennon,35,24,11,0
Ector,203,U.S. Senate,,GRN,David B. Collins,8,6,2,0
Ector,203,U.S. Senate,,,Ricardo Turullols-Bonilla,0,0,0,0
Ector,203,U.S. House,11,REP,August Pfluger,1502,1296,206,0
Ector,203,U.S. House,11,REP,Over Votes,0,0,0,0
Ector,203,U.S. House,11,REP,Under Votes,37,32,5,0
Ector,203,U.S. House,11,DEM,Jon Mark Hogg,373,319,54,0
Ector,203,U.S. House,11,LIB,Wacey Alpha Cody,35,27,8,0
Ector,203,Railroad Commissioner,,REP,"James ""Jim"" Wright",1478,1276,202,0
Ector,203,Railroad Commissioner,,REP,Over Votes,0,0,0,0
Ector,203,Railroad Commissioner,,REP,Under Votes,40,35,5,0
Ector,203,Railroad Commissioner,,DEM,Chrysta Castañeda,373,318,55,0
Ector,203,Railroad Commissioner,,LIB,Matt Sterett,34,29,5,0
Ector,203,Railroad Commissioner,,GRN,"Katija ""Kat"" Gruene",22,16,6,0
Ector,203,"Chief Justice, Supreme Court",,REP,Nathan Hecht,1459,1258,201,0
Ector,203,"Chief Justice, Supreme Court",,REP,Over Votes,0,0,0,0
Ector,203,"Chief Justice, Supreme Court",,REP,Under Votes,40,36,4,0
Ector,203,"Chief Justice, Supreme Court",,DEM,Amy Clark Meachum,398,342,56,0
Ector,203,"Chief Justice, Supreme Court",,LIB,Mark Ash,50,38,12,0
Ector,203,"Justice, Supreme Court, Place 6, (Unexpired Term)",,REP,Jane Bland,1509,1300,209,0
Ector,203,"Justice, Supreme Court, Place 6, (Unexpired Term)",,REP,Over Votes,0,0,0,0
Ector,203,"Justice, Supreme Court, Place 6, (Unexpired Term)",,REP,Under Votes,44,40,4,0
Ector,203,"Justice, Supreme Court, Place 6, (Unexpired Term)",,DEM,Kathy Cheng,394,334,60,0
Ector,203,"Justice, Supreme Court, Place 7",,REP,Jeff Boyd,1483,1276,207,0
Ector,203,"Justice, Supreme Court, Place 7",,REP,Over Votes,0,0,0,0
Ector,203,"Justice, Supreme Court, Place 7",,REP,Under Votes,43,39,4,0
Ector,203,"Justice, Supreme Court, Place 7",,DEM,Staci Williams,389,335,54,0
Ector,203,"Justice, Supreme Court, Place 7",,LIB,William Bryan Strange III,32,24,8,0
Ector,203,"Justice, Supreme Court, Place 8",,REP,Brett Busby,1468,1266,202,0
Ector,203,"Justice, Supreme Court, Place 8",,REP,Over Votes,0,0,0,0
Ector,203,"Justice, Supreme Court, Place 8",,REP,Under Votes,43,39,4,0
Ector,203,"Justice, Supreme Court, Place 8",,DEM,Gisela D. Triana,394,339,55,0
Ector,203,"Justice, Supreme Court, Place 8",,LIB,Tom Oxford,42,30,12,0
Ector,203,"Judge, Court of Criminal Appeals, Place 3",,REP,Bert Richardson,1490,1283,207,0
Ector,203,"Judge, Court of Criminal Appeals, Place 3",,REP,Over Votes,0,0,0,0
Ector,203,"Judge, Court of Criminal Appeals, Place 3",,REP,Under Votes,48,42,6,0
Ector,203,"Judge, Court of Criminal Appeals, Place 3",,DEM,Elizabeth Davis Frizell,409,349,60,0
Ector,203,"Judge, Court of Criminal Appeals, Place 4",,REP,Kevin Patrick Yeary,1507,1295,212,0
Ector,203,"Judge, Court of Criminal Appeals, Place 4",,REP,Over Votes,0,0,0,0
Ector,203,"Judge, Court of Criminal Appeals, Place 4",,REP,Under Votes,50,45,5,0
Ector,203,"Judge, Court of Criminal Appeals, Place 4",,DEM,Tina Clinton,390,334,56,0
Ector,203,"Judge, Court of Criminal Appeals, Place 9",,REP,David Newell,1509,1298,211,0
Ector,203,"Judge, Court of Criminal Appeals, Place 9",,REP,Over Votes,0,0,0,0
Ector,203,"Judge, Court of Criminal Appeals, Place 9",,REP,Under Votes,51,46,5,0
Ector,203,"Judge, Court of Criminal Appeals, Place 9",,DEM,Brandon Birmingham,387,330,57,0
Ector,203,"Member, State Board of Education, District 1",,REP,Jennifer Ivey,1495,1288,207,0
Ector,203,"Member, State Board of Education, District 1",,REP,Over Votes,0,0,0,0
Ector,203,"Member, State Board of Education, District 1",,REP,Under Votes,54,50,4,0
Ector,203,"Member, State Board of Education, District 1",,DEM,Georgina Perez,398,336,62,0
Ector,203,State Representative,81,REP,Brooks Landgraf,1715,1470,245,0
Ector,203,State Representative,81,REP,Over Votes,0,0,0,0
Ector,203,State Representative,81,REP,Under Votes,232,204,28,0
Ector,203,"Justice, 11th Court of Appeals District, Place 2",,REP,Bruce Williams,1670,1427,243,0
Ector,203,"Justice, 11th Court of Appeals District, Place 2",,REP,Over Votes,0,0,0,0
Ector,203,"Justice, 11th Court of Appeals District, Place 2",,REP,Under Votes,277,247,30,0
Ector,203,"Justice, 11th Court of Appeals District, Place 3 (Unexpired Term)",,REP,W. Stacy Trotter,1668,1426,242,0
Ector,203,"Justice, 11th Court of Appeals District, Place 3 (Unexpired Term)",,REP,Over Votes,0,0,0,0
Ector,203,"Justice, 11th Court of Appeals District, Place 3 (Unexpired Term)",,REP,Under Votes,279,248,31,0
Ector,203,"District Judge, 161st Judicial District",,REP,Justin Low,1647,1409,238,0
Ector,203,"District Judge, 161st Judicial District",,REP,Over Votes,0,0,0,0
Ector,203,"District Judge, 161st Judicial District",,REP,Under Votes,300,265,35,0
Ector,203,"District Judge, 446th Judicial District",,REP,Sara Kate Billingsley,1654,1409,245,0
Ector,203,"District Judge, 446th Judicial District",,REP,Over Votes,0,0,0,0
Ector,203,"District Judge, 446th Judicial District",,REP,Under Votes,293,265,28,0
Ector,203,"District Attorney, 70th Judicial District",,REP,Dusty Gallivan,1664,1424,240,0
Ector,203,"District Attorney, 70th Judicial District",,REP,Over Votes,0,0,0,0
Ector,203,"District Attorney, 70th Judicial District",,REP,Under Votes,283,250,33,0
Ector,203,Mayor,,,Dewey Bryant,895,784,111,0
Ector,203,Mayor,,,Over Votes,0,0,0,0
Ector,203,Mayor,,,Under Votes,169,140,29,0
Ector,203,Mayor,,,Javier Joven,648,549,99,0
Ector,203,Mayor,,,Gloria G. Apolinario,235,201,34,0
Ector,203,"Council Member, District 2",,,Steven P. Thompson,926,793,133,0
Ector,203,"Council Member, District 2",,,Over Votes,0,0,0,0
Ector,203,"Council Member, District 2",,,Under Votes,255,216,39,0
Ector,203,"Council Member, District 2",,,Rachel D. Minor,766,665,101,0
Ector,203,"Council Member, At-Large",,,David R. Turner,819,697,122,0
Ector,203,"Council Member, At-Large",,,Over Votes,0,0,0,0
Ector,203,"Council Member, At-Large",,,Under Votes,191,159,32,0
Ector,203,"Council Member, At-Large",,,La-Tasha Gentry,169,136,33,0
Ector,203,"Council Member, At-Large",,,Jo Ann Davenport Littleton,166,146,20,0
Ector,203,"Council Member, At-Large",,,Denise Swanner,602,536,66,0
Ector,204,President,,REP,Donald J. Trump / Michael R. Pence,840,697,143,0
Ector,204,President,,REP,Over Votes,0,0,0,0
Ector,204,President,,REP,Under Votes,3,2,1,0
Ector,204,President,,DEM,Joseph R. Biden / Kamala D. Harris,193,177,16,0
Ector,204,President,,LIB,"Jo Jorgensen / Jeremy ""Spike"" Cohen",12,9,3,0
Ector,204,President,,GRN,Howie Hawkins / Angela Walker,2,2,0,0
Ector,204,President,,,President R. Boddie/Eric C. Stoneham,0,0,0,0
Ector,204,President,,,Brian Carroll/Amar Patel,1,1,0,0
Ector,204,President,,,Todd Cella/Tim Cella,0,0,0,0
Ector,204,President,,,Jesse Cuellar/Jimmy Monreal,0,0,0,0
Ector,204,President,,,Tom Hoefling/Andy Prior,0,0,0,0
Ector,204,President,,,Gloria La Riva/Leonard Peltier,0,0,0,0
Ector,204,President,,,Abram Loeb/Jennifer Jairala,0,0,0,0
Ector,204,President,,,Robert Morrow/Anne Beckett,0,0,0,0
Ector,204,President,,,Kasey Wells/Rachel Wells,0,0,0,0
Ector,204,U.S. Senate,,REP,John Cornyn,832,692,140,0
Ector,204,U.S. Senate,,REP,Over Votes,0,0,0,0
Ector,204,U.S. Senate,,REP,Under Votes,16,12,4,0
Ector,204,U.S. Senate,,DEM,"Mary ""MJ"" Hegar",171,157,14,0
Ector,204,U.S. Senate,,LIB,Kerry Douglas McKennon,23,19,4,0
Ector,204,U.S. Senate,,GRN,David B. Collins,9,8,1,0
Ector,204,U.S. Senate,,,Ricardo Turullols-Bonilla,0,0,0,0
Ector,204,U.S. House,11,REP,August Pfluger,829,690,139,0
Ector,204,U.S. House,11,REP,Over Votes,0,0,0,0
Ector,204,U.S. House,11,REP,Under Votes,22,17,5,0
Ector,204,U.S. House,11,DEM,Jon Mark Hogg,174,162,12,0
Ector,204,U.S. House,11,LIB,Wacey Alpha Cody,26,19,7,0
Ector,204,Railroad Commissioner,,REP,"James ""Jim"" Wright",822,685,137,0
Ector,204,Railroad Commissioner,,REP,Over Votes,0,0,0,0
Ector,204,Railroad Commissioner,,REP,Under Votes,22,17,5,0
Ector,204,Railroad Commissioner,,DEM,Chrysta Castañeda,173,158,15,0
Ector,204,Railroad Commissioner,,LIB,Matt Sterett,25,21,4,0
Ector,204,Railroad Commissioner,,GRN,"Katija ""Kat"" Gruene",9,7,2,0
Ector,204,"Chief Justice, Supreme Court",,REP,Nathan Hecht,816,683,133,0
Ector,204,"Chief Justice, Supreme Court",,REP,Over Votes,0,0,0,0
Ector,204,"Chief Justice, Supreme Court",,REP,Under Votes,19,14,5,0
Ector,204,"Chief Justice, Supreme Court",,DEM,Amy Clark Meachum,193,175,18,0
Ector,204,"Chief Justice, Supreme Court",,LIB,Mark Ash,23,16,7,0
Ector,204,"Justice, Supreme Court, Place 6, (Unexpired Term)",,REP,Jane Bland,831,695,136,0
Ector,204,"Justice, Supreme Court, Place 6, (Unexpired Term)",,REP,Over Votes,0,0,0,0
Ector,204,"Justice, Supreme Court, Place 6, (Unexpired Term)",,REP,Under Votes,25,19,6,0
Ector,204,"Justice, Supreme Court, Place 6, (Unexpired Term)",,DEM,Kathy Cheng,195,174,21,0
Ector,204,"Justice, Supreme Court, Place 7",,REP,Jeff Boyd,813,679,134,0
Ector,204,"Justice, Supreme Court, Place 7",,REP,Over Votes,0,0,0,0
Ector,204,"Justice, Supreme Court, Place 7",,REP,Under Votes,22,17,5,0
Ector,204,"Justice, Supreme Court, Place 7",,DEM,Staci Williams,187,172,15,0
Ector,204,"Justice, Supreme Court, Place 7",,LIB,William Bryan Strange III,29,20,9,0
Ector,204,"Justice, Supreme Court, Place 8",,REP,Brett Busby,810,678,132,0
Ector,204,"Justice, Supreme Court, Place 8",,REP,Over Votes,0,0,0,0
Ector,204,"Justice, Supreme Court, Place 8",,REP,Under Votes,22,17,5,0
Ector,204,"Justice, Supreme Court, Place 8",,DEM,Gisela D. Triana,188,171,17,0
Ector,204,"Justice, Supreme Court, Place 8",,LIB,Tom Oxford,31,22,9,0
Ector,204,"Judge, Court of Criminal Appeals, Place 3",,REP,Bert Richardson,834,696,138,0
Ector,204,"Judge, Court of Criminal Appeals, Place 3",,REP,Over Votes,0,0,0,0
Ector,204,"Judge, Court of Criminal Appeals, Place 3",,REP,Under Votes,23,18,5,0
Ector,204,"Judge, Court of Criminal Appeals, Place 3",,DEM,Elizabeth Davis Frizell,194,174,20,0
Ector,204,"Judge, Court of Criminal Appeals, Place 4",,REP,Kevin Patrick Yeary,839,695,144,0
Ector,204,"Judge, Court of Criminal Appeals, Place 4",,REP,Over Votes,0,0,0,0
Ector,204,"Judge, Court of Criminal Appeals, Place 4",,REP,Under Votes,24,19,5,0
Ector,204,"Judge, Court of Criminal Appeals, Place 4",,DEM,Tina Clinton,188,174,14,0
Ector,204,"Judge, Court of Criminal Appeals, Place 9",,REP,David Newell,838,698,140,0
Ector,204,"Judge, Court of Criminal Appeals, Place 9",,REP,Over Votes,0,0,0,0
Ector,204,"Judge, Court of Criminal Appeals, Place 9",,REP,Under Votes,24,19,5,0
Ector,204,"Judge, Court of Criminal Appeals, Place 9",,DEM,Brandon Birmingham,189,171,18,0
Ector,204,"Member, State Board of Education, District 1",,REP,Jennifer Ivey,832,694,138,0
Ector,204,"Member, State Board of Education, District 1",,REP,Over Votes,0,0,0,0
Ector,204,"Member, State Board of Education, District 1",,REP,Under Votes,27,21,6,0
Ector,204,"Member, State Board of Education, District 1",,DEM,Georgina Perez,192,173,19,0
Ector,204,State Representative,81,REP,Brooks Landgraf,947,793,154,0
Ector,204,State Representative,81,REP,Over Votes,0,0,0,0
Ector,204,State Representative,81,REP,Under Votes,104,95,9,0
Ector,204,"Justice, 11th Court of Appeals District, Place 2",,REP,Bruce Williams,920,771,149,0
Ector,204,"Justice, 11th Court of Appeals District, Place 2",,REP,Over Votes,0,0,0,0
Ector,204,"Justice, 11th Court of Appeals District, Place 2",,REP,Under Votes,131,117,14,0
Ector,204,"Justice, 11th Court of Appeals District, Place 3 (Unexpired Term)",,REP,W. Stacy Trotter,921,772,149,0
Ector,204,"Justice, 11th Court of Appeals District, Place 3 (Unexpired Term)",,REP,Over Votes,0,0,0,0
Ector,204,"Justice, 11th Court of Appeals District, Place 3 (Unexpired Term)",,REP,Under Votes,130,116,14,0
Ector,204,"District Judge, 161st Judicial District",,REP,Justin Low,911,764,147,0
Ector,204,"District Judge, 161st Judicial District",,REP,Over Votes,0,0,0,0
Ector,204,"District Judge, 161st Judicial District",,REP,Under Votes,140,124,16,0
Ector,204,"District Judge, 446th Judicial District",,REP,Sara Kate Billingsley,919,768,151,0
Ector,204,"District Judge, 446th Judicial District",,REP,Over Votes,0,0,0,0
Ector,204,"District Judge, 446th Judicial District",,REP,Under Votes,132,120,12,0
Ector,204,"District Attorney, 70th Judicial District",,REP,Dusty Gallivan,915,765,150,0
Ector,204,"District Attorney, 70th Judicial District",,REP,Over Votes,0,0,0,0
Ector,204,"District Attorney, 70th Judicial District",,REP,Under Votes,136,123,13,0
Ector,204,Mayor,,,Dewey Bryant,425,373,52,0
Ector,204,Mayor,,,Over Votes,0,0,0,0
Ector,204,Mayor,,,Under Votes,89,73,16,0
Ector,204,Mayor,,,Javier Joven,409,335,74,0
Ector,204,Mayor,,,Gloria G. Apolinario,128,107,21,0
Ector,204,"Council Member, At-Large",,,David R. Turner,436,368,68,0
Ector,204,"Council Member, At-Large",,,Over Votes,0,0,0,0
Ector,204,"Council Member, At-Large",,,Under Votes,97,75,22,0
Ector,204,"Council Member, At-Large",,,La-Tasha Gentry,89,73,16,0
Ector,204,"Council Member, At-Large",,,Jo Ann Davenport Littleton,94,78,16,0
Ector,204,"Council Member, At-Large",,,Denise Swanner,335,294,41,0
Ector,205,President,,REP,Donald J. Trump / Michael R. Pence,1045,858,187,0
Ector,205,President,,REP,Over Votes,0,0,0,0
Ector,205,President,,REP,Under Votes,9,8,1,0
Ector,205,President,,DEM,Joseph R. Biden / Kamala D. Harris,298,238,60,0
Ector,205,President,,LIB,"Jo Jorgensen / Jeremy ""Spike"" Cohen",21,11,10,0
Ector,205,President,,GRN,Howie Hawkins / Angela Walker,6,3,3,0
Ector,205,President,,,President R. Boddie/Eric C. Stoneham,0,0,0,0
Ector,205,President,,,Brian Carroll/Amar Patel,0,0,0,0
Ector,205,President,,,Todd Cella/Tim Cella,0,0,0,0
Ector,205,President,,,Jesse Cuellar/Jimmy Monreal,0,0,0,0
Ector,205,President,,,Tom Hoefling/Andy Prior,0,0,0,0
Ector,205,President,,,Gloria La Riva/Leonard Peltier,0,0,0,0
Ector,205,President,,,Abram Loeb/Jennifer Jairala,0,0,0,0
Ector,205,President,,,Robert Morrow/Anne Beckett,0,0,0,0
Ector,205,President,,,Kasey Wells/Rachel Wells,0,0,0,0
Ector,205,U.S. Senate,,REP,John Cornyn,1039,857,182,0
Ector,205,U.S. Senate,,REP,Over Votes,0,0,0,0
Ector,205,U.S. Senate,,REP,Under Votes,21,14,7,0
Ector,205,U.S. Senate,,DEM,"Mary ""MJ"" Hegar",274,218,56,0
Ector,205,U.S. Senate,,LIB,Kerry Douglas McKennon,35,22,13,0
Ector,205,U.S. Senate,,GRN,David B. Collins,10,7,3,0
Ector,205,U.S. Senate,,,Ricardo Turullols-Bonilla,0,0,0,0
Ector,205,U.S. House,11,REP,August Pfluger,1048,862,186,0
Ector,205,U.S. House,11,REP,Over Votes,0,0,0,0
Ector,205,U.S. House,11,REP,Under Votes,23,16,7,0
Ector,205,U.S. House,11,DEM,Jon Mark Hogg,270,219,51,0
Ector,205,U.S. House,11,LIB,Wacey Alpha Cody,38,21,17,0
Ector,205,Railroad Commissioner,,REP,"James ""Jim"" Wright",1035,856,179,0
Ector,205,Railroad Commissioner,,REP,Over Votes,0,0,0,0
Ector,205,Railroad Commissioner,,REP,Under Votes,25,17,8,0
Ector,205,Railroad Commissioner,,DEM,Chrysta Castañeda,275,217,58,0
Ector,205,Railroad Commissioner,,LIB,Matt Sterett,31,22,9,0
Ector,205,Railroad Commissioner,,GRN,"Katija ""Kat"" Gruene",13,6,7,0
Ector,205,"Chief Justice, Supreme Court",,REP,Nathan Hecht,1020,841,179,0
Ector,205,"Chief Justice, Supreme Court",,REP,Over Votes,0,0,0,0
Ector,205,"Chief Justice, Supreme Court",,REP,Under Votes,28,20,8,0
Ector,205,"Chief Justice, Supreme Court",,DEM,Amy Clark Meachum,291,232,59,0
Ector,205,"Chief Justice, Supreme Court",,LIB,Mark Ash,40,25,15,0
Ector,205,"Justice, Supreme Court, Place 6, (Unexpired Term)",,REP,Jane Bland,1056,860,196,0
Ector,205,"Justice, Supreme Court, Place 6, (Unexpired Term)",,REP,Over Votes,0,0,0,0
Ector,205,"Justice, Supreme Court, Place 6, (Unexpired Term)",,REP,Under Votes,31,22,9,0
Ector,205,"Justice, Supreme Court, Place 6, (Unexpired Term)",,DEM,Kathy Cheng,292,236,56,0
Ector,205,"Justice, Supreme Court, Place 7",,REP,Jeff Boyd,1031,848,183,0
Ector,205,"Justice, Supreme Court, Place 7",,REP,Over Votes,0,0,0,0
Ector,205,"Justice, Supreme Court, Place 7",,REP,Under Votes,30,21,9,0
Ector,205,"Justice, Supreme Court, Place 7",,DEM,Staci Williams,284,227,57,0
Ector,205,"Justice, Supreme Court, Place 7",,LIB,William Bryan Strange III,34,22,12,0
Ector,205,"Justice, Supreme Court, Place 8",,REP,Brett Busby,1032,849,183,0
Ector,205,"Justice, Supreme Court, Place 8",,REP,Over Votes,0,0,0,0
Ector,205,"Justice, Supreme Court, Place 8",,REP,Under Votes,30,22,8,0
Ector,205,"Justice, Supreme Court, Place 8",,DEM,Gisela D. Triana,282,223,59,0
Ector,205,"Justice, Supreme Court, Place 8",,LIB,Tom Oxford,35,24,11,0
Ector,205,"Judge, Court of Criminal Appeals, Place 3",,REP,Bert Richardson,1043,853,190,0
Ector,205,"Judge, Court of Criminal Appeals, Place 3",,REP,Over Votes,1,1,0,0
Ector,205,"Judge, Court of Criminal Appeals, Place 3",,REP,Under Votes,34,24,10,0
Ector,205,"Judge, Court of Criminal Appeals, Place 3",,DEM,Elizabeth Davis Frizell,301,240,61,0
Ector,205,"Judge, Court of Criminal Appeals, Place 4",,REP,Kevin Patrick Yeary,1053,862,191,0
Ector,205,"Judge, Court of Criminal Appeals, Place 4",,REP,Over Votes,0,0,0,0
Ector,205,"Judge, Court of Criminal Appeals, Place 4",,REP,Under Votes,34,23,11,0
Ector,205,"Judge, Court of Criminal Appeals, Place 4",,DEM,Tina Clinton,292,233,59,0
Ector,205,"Judge, Court of Criminal Appeals, Place 9",,REP,David Newell,1051,861,190,0
Ector,205,"Judge, Court of Criminal Appeals, Place 9",,REP,Over Votes,0,0,0,0
Ector,205,"Judge, Court of Criminal Appeals, Place 9",,REP,Under Votes,36,26,10,0
Ector,205,"Judge, Court of Criminal Appeals, Place 9",,DEM,Brandon Birmingham,292,231,61,0
Ector,205,"Member, State Board of Education, District 1",,REP,Jennifer Ivey,1039,852,187,0
Ector,205,"Member, State Board of Education, District 1",,REP,Over Votes,0,0,0,0
Ector,205,"Member, State Board of Education, District 1",,REP,Under Votes,37,26,11,0
Ector,205,"Member, State Board of Education, District 1",,DEM,Georgina Perez,303,240,63,0
Ector,205,State Representative,81,REP,Brooks Landgraf,1219,989,230,0
Ector,205,State Representative,81,REP,Over Votes,0,0,0,0
Ector,205,State Representative,81,REP,Under Votes,160,129,31,0
Ector,205,"Justice, 11th Court of Appeals District, Place 2",,REP,Bruce Williams,1188,961,227,0
Ector,205,"Justice, 11th Court of Appeals District, Place 2",,REP,Over Votes,0,0,0,0
Ector,205,"Justice, 11th Court of Appeals District, Place 2",,REP,Under Votes,191,157,34,0
Ector,205,"Justice, 11th Court of Appeals District, Place 3 (Unexpired Term)",,REP,W. Stacy Trotter,1194,968,226,0
Ector,205,"Justice, 11th Court of Appeals District, Place 3 (Unexpired Term)",,REP,Over Votes,0,0,0,0
Ector,205,"Justice, 11th Court of Appeals District, Place 3 (Unexpired Term)",,REP,Under Votes,185,150,35,0
Ector,205,"District Judge, 161st Judicial District",,REP,Justin Low,1181,958,223,0
Ector,205,"District Judge, 161st Judicial District",,REP,Over Votes,0,0,0,0
Ector,205,"District Judge, 161st Judicial District",,REP,Under Votes,198,160,38,0
Ector,205,"District Judge, 446th Judicial District",,REP,Sara Kate Billingsley,1197,971,226,0
Ector,205,"District Judge, 446th Judicial District",,REP,Over Votes,0,0,0,0
Ector,205,"District Judge, 446th Judicial District",,REP,Under Votes,182,147,35,0
Ector,205,"District Attorney, 70th Judicial District",,REP,Dusty Gallivan,1194,970,224,0
Ector,205,"District Attorney, 70th Judicial District",,REP,Over Votes,0,0,0,0
Ector,205,"District Attorney, 70th Judicial District",,REP,Under Votes,185,148,37,0
Ector,205,Mayor,,,Dewey Bryant,619,528,91,0
Ector,205,Mayor,,,Over Votes,0,0,0,0
Ector,205,Mayor,,,Under Votes,110,81,29,0
Ector,205,Mayor,,,Javier Joven,472,378,94,0
Ector,205,Mayor,,,Gloria G. Apolinario,178,131,47,0
Ector,205,"Council Member, At-Large",,,David R. Turner,622,505,117,0
Ector,205,"Council Member, At-Large",,,Over Votes,0,0,0,0
Ector,205,"Council Member, At-Large",,,Under Votes,121,88,33,0
Ector,205,"Council Member, At-Large",,,La-Tasha Gentry,130,106,24,0
Ector,205,"Council Member, At-Large",,,Jo Ann Davenport Littleton,144,115,29,0
Ector,205,"Council Member, At-Large",,,Denise Swanner,362,304,58,0
Ector,206 City,President,,REP,Donald J. Trump / Michael R. Pence,39,25,14,0
Ector,206 City,President,,REP,Over Votes,0,0,0,0
Ector,206 City,President,,REP,Under Votes,0,0,0,0
Ector,206 City,President,,DEM,Joseph R. Biden / Kamala D. Harris,11,9,2,0
Ector,206 City,President,,LIB,"Jo Jorgensen / Jeremy ""Spike"" Cohen",0,0,0,0
Ector,206 City,President,,GRN,Howie Hawkins / Angela Walker,0,0,0,0
Ector,206 City,President,,,President R. Boddie/Eric C. Stoneham,0,0,0,0
Ector,206 City,President,,,Brian Carroll/Amar Patel,0,0,0,0
Ector,206 City,President,,,Todd Cella/Tim Cella,0,0,0,0
Ector,206 City,President,,,Jesse Cuellar/Jimmy Monreal,0,0,0,0
Ector,206 City,President,,,Tom Hoefling/Andy Prior,0,0,0,0
Ector,206 City,President,,,Gloria La Riva/Leonard Peltier,0,0,0,0
Ector,206 City,President,,,Abram Loeb/Jennifer Jairala,0,0,0,0
Ector,206 City,President,,,Robert Morrow/Anne Beckett,0,0,0,0
Ector,206 City,President,,,Kasey Wells/Rachel Wells,0,0,0,0
Ector,206 City,U.S. Senate,,REP,John Cornyn,39,25,14,0
Ector,206 City,U.S. Senate,,REP,Over Votes,0,0,0,0
Ector,206 City,U.S. Senate,,REP,Under Votes,2,2,0,0
Ector,206 City,U.S. Senate,,DEM,"Mary ""MJ"" Hegar",8,6,2,0
Ector,206 City,U.S. Senate,,LIB,Kerry Douglas McKennon,0,0,0,0
Ector,206 City,U.S. Senate,,GRN,David B. Collins,1,1,0,0
Ector,206 City,U.S. Senate,,,Ricardo Turullols-Bonilla,0,0,0,0
Ector,206 City,U.S. House,11,REP,August Pfluger,34,21,13,0
Ector,206 City,U.S. House,11,REP,Over Votes,0,0,0,0
Ector,206 City,U.S. House,11,REP,Under Votes,5,4,1,0
Ector,206 City,U.S. House,11,DEM,Jon Mark Hogg,11,9,2,0
Ector,206 City,U.S. House,11,LIB,Wacey Alpha Cody,0,0,0,0
Ector,206 City,Railroad Commissioner,,REP,"James ""Jim"" Wright",38,24,14,0
Ector,206 City,Railroad Commissioner,,REP,Over Votes,0,0,0,0
Ector,206 City,Railroad Commissioner,,REP,Under Votes,2,2,0,0
Ector,206 City,Railroad Commissioner,,DEM,Chrysta Castañeda,10,8,2,0
Ector,206 City,Railroad Commissioner,,LIB,Matt Sterett,0,0,0,0
Ector,206 City,Railroad Commissioner,,GRN,"Katija ""Kat"" Gruene",0,0,0,0
Ector,206 City,"Chief Justice, Supreme Court",,REP,Nathan Hecht,37,25,12,0
Ector,206 City,"Chief Justice, Supreme Court",,REP,Over Votes,0,0,0,0
Ector,206 City,"Chief Justice, Supreme Court",,REP,Under Votes,2,1,1,0
Ector,206 City,"Chief Justice, Supreme Court",,DEM,Amy Clark Meachum,9,7,2,0
Ector,206 City,"Chief Justice, Supreme Court",,LIB,Mark Ash,2,1,1,0
Ector,206 City,"Justice, Supreme Court, Place 6, (Unexpired Term)",,REP,Jane Bland,38,24,14,0
Ector,206 City,"Justice, Supreme Court, Place 6, (Unexpired Term)",,REP,Over Votes,0,0,0,0
Ector,206 City,"Justice, Supreme Court, Place 6, (Unexpired Term)",,REP,Under Votes,2,2,0,0
Ector,206 City,"Justice, Supreme Court, Place 6, (Unexpired Term)",,DEM,Kathy Cheng,10,8,2,0
Ector,206 City,"Justice, Supreme Court, Place 7",,REP,Jeff Boyd,38,25,13,0
Ector,206 City,"Justice, Supreme Court, Place 7",,REP,Over Votes,0,0,0,0
Ector,206 City,"Justice, Supreme Court, Place 7",,REP,Under Votes,1,1,0,0
Ector,206 City,"Justice, Supreme Court, Place 7",,DEM,Staci Williams,10,8,2,0
Ector,206 City,"Justice, Supreme Court, Place 7",,LIB,William Bryan Strange III,1,0,1,0
Ector,206 City,"Justice, Supreme Court, Place 8",,REP,Brett Busby,38,25,13,0
Ector,206 City,"Justice, Supreme Court, Place 8",,REP,Over Votes,0,0,0,0
Ector,206 City,"Justice, Supreme Court, Place 8",,REP,Under Votes,1,1,0,0
Ector,206 City,"Justice, Supreme Court, Place 8",,DEM,Gisela D. Triana,10,8,2,0
Ector,206 City,"Justice, Supreme Court, Place 8",,LIB,Tom Oxford,1,0,1,0
Ector,206 City,"Judge, Court of Criminal Appeals, Place 3",,REP,Bert Richardson,37,24,13,0
Ector,206 City,"Judge, Court of Criminal Appeals, Place 3",,REP,Over Votes,0,0,0,0
Ector,206 City,"Judge, Court of Criminal Appeals, Place 3",,REP,Under Votes,2,1,1,0
Ector,206 City,"Judge, Court of Criminal Appeals, Place 3",,DEM,Elizabeth Davis Frizell,11,9,2,0
Ector,206 City,"Judge, Court of Criminal Appeals, Place 4",,REP,Kevin Patrick Yeary,37,23,14,0
Ector,206 City,"Judge, Court of Criminal Appeals, Place 4",,REP,Over Votes,0,0,0,0
Ector,206 City,"Judge, Court of Criminal Appeals, Place 4",,REP,Under Votes,1,1,0,0
Ector,206 City,"Judge, Court of Criminal Appeals, Place 4",,DEM,Tina Clinton,12,10,2,0
Ector,206 City,"Judge, Court of Criminal Appeals, Place 9",,REP,David Newell,38,24,14,0
Ector,206 City,"Judge, Court of Criminal Appeals, Place 9",,REP,Over Votes,0,0,0,0
Ector,206 City,"Judge, Court of Criminal Appeals, Place 9",,REP,Under Votes,2,2,0,0
Ector,206 City,"Judge, Court of Criminal Appeals, Place 9",,DEM,Brandon Birmingham,10,8,2,0
Ector,206 City,"Member, State Board of Education, District 1",,REP,Jennifer Ivey,35,21,14,0
Ector,206 City,"Member, State Board of Education, District 1",,REP,Over Votes,0,0,0,0
Ector,206 City,"Member, State Board of Education, District 1",,REP,Under Votes,5,5,0,0
Ector,206 City,"Member, State Board of Education, District 1",,DEM,Georgina Perez,10,8,2,0
Ector,206 City,State Representative,81,REP,Brooks Landgraf,41,26,15,0
Ector,206 City,State Representative,81,REP,Over Votes,0,0,0,0
Ector,206 City,State Representative,81,REP,Under Votes,9,8,1,0
Ector,206 City,"Justice, 11th Court of Appeals District, Place 2",,REP,Bruce Williams,39,24,15,0
Ector,206 City,"Justice, 11th Court of Appeals District, Place 2",,REP,Over Votes,0,0,0,0
Ector,206 City,"Justice, 11th Court of Appeals District, Place 2",,REP,Under Votes,11,10,1,0
Ector,206 City,"Justice, 11th Court of Appeals District, Place 3 (Unexpired Term)",,REP,W. Stacy Trotter,39,24,15,0
Ector,206 City,"Justice, 11th Court of Appeals District, Place 3 (Unexpired Term)",,REP,Over Votes,0,0,0,0
Ector,206 City,"Justice, 11th Court of Appeals District, Place 3 (Unexpired Term)",,REP,Under Votes,11,10,1,0
Ector,206 City,"District Judge, 161st Judicial District",,REP,Justin Low,39,24,15,0
Ector,206 City,"District Judge, 161st Judicial District",,REP,Over Votes,0,0,0,0
Ector,206 City,"District Judge, 161st Judicial District",,REP,Under Votes,11,10,1,0
Ector,206 City,"District Judge, 446th Judicial District",,REP,Sara Kate Billingsley,39,24,15,0
Ector,206 City,"District Judge, 446th Judicial District",,REP,Over Votes,0,0,0,0
Ector,206 City,"District Judge, 446th Judicial District",,REP,Under Votes,11,10,1,0
Ector,206 City,"District Attorney, 70th Judicial District",,REP,Dusty Gallivan,38,24,14,0
Ector,206 City,"District Attorney, 70th Judicial District",,REP,Over Votes,0,0,0,0
Ector,206 City,"District Attorney, 70th Judicial District",,REP,Under Votes,12,10,2,0
Ector,206 City,Mayor,,,Dewey Bryant,23,13,10,0
Ector,206 City,Mayor,,,Over Votes,0,0,0,0
Ector,206 City,Mayor,,,Under Votes,7,7,0,0
Ector,206 City,Mayor,,,Javier Joven,14,9,5,0
Ector,206 City,Mayor,,,Gloria G. Apolinario,6,5,1,0
Ector,206 City,"Council Member, District 2",,,Steven P. Thompson,26,14,12,0
Ector,206 City,"Council Member, District 2",,,Over Votes,0,0,0,0
Ector,206 City,"Council Member, District 2",,,Under Votes,9,8,1,0
Ector,206 City,"Council Member, District 2",,,Rachel D. Minor,15,12,3,0
Ector,206 City,"Council Member, At-Large",,,David R. Turner,20,11,9,0
Ector,206 City,"Council Member, At-Large",,,Over Votes,0,0,0,0
Ector,206 City,"Council Member, At-Large",,,Under Votes,9,8,1,0
Ector,206 City,"Council Member, At-Large",,,La-Tasha Gentry,6,3,3,0
Ector,206 City,"Council Member, At-Large",,,Jo Ann Davenport Littleton,5,3,2,0
Ector,206 City,"Council Member, At-Large",,,Denise Swanner,10,9,1,0
Ector,206 County,President,,REP,Donald J. Trump / Michael R. Pence,352,317,35,0
Ector,206 County,President,,REP,Over Votes,0,0,0,0
Ector,206 County,President,,REP,Under Votes,1,0,1,0
Ector,206 County,President,,DEM,Joseph R. Biden / Kamala D. Harris,41,35,6,0
Ector,206 County,President,,LIB,"Jo Jorgensen / Jeremy ""Spike"" Cohen",5,2,3,0
Ector,206 County,President,,GRN,Howie Hawkins / Angela Walker,1,0,1,0
Ector,206 County,President,,,President R. Boddie/Eric C. Stoneham,0,0,0,0
Ector,206 County,President,,,Brian Carroll/Amar Patel,0,0,0,0
Ector,206 County,President,,,Todd Cella/Tim Cella,0,0,0,0
Ector,206 County,President,,,Jesse Cuellar/Jimmy Monreal,0,0,0,0
Ector,206 County,President,,,Tom Hoefling/Andy Prior,0,0,0,0
Ector,206 County,President,,,Gloria La Riva/Leonard Peltier,0,0,0,0
Ector,206 County,President,,,Abram Loeb/Jennifer Jairala,0,0,0,0
Ector,206 County,President,,,Robert Morrow/Anne Beckett,0,0,0,0
Ector,206 County,President,,,Kasey Wells/Rachel Wells,0,0,0,0
Ector,206 County,U.S. Senate,,REP,John Cornyn,353,316,37,0
Ector,206 County,U.S. Senate,,REP,Over Votes,0,0,0,0
Ector,206 County,U.S. Senate,,REP,Under Votes,2,2,0,0
Ector,206 County,U.S. Senate,,DEM,"Mary ""MJ"" Hegar",39,33,6,0
Ector,206 County,U.S. Senate,,LIB,Kerry Douglas McKennon,6,3,3,0
Ector,206 County,U.S. Senate,,GRN,David B. Collins,0,0,0,0
Ector,206 County,U.S. Senate,,,Ricardo Turullols-Bonilla,0,0,0,0
Ector,206 County,U.S. House,11,REP,August Pfluger,355,318,37,0
Ector,206 County,U.S. House,11,REP,Over Votes,0,0,0,0
Ector,206 County,U.S. House,11,REP,Under Votes,3,3,0,0
Ector,206 County,U.S. House,11,DEM,Jon Mark Hogg,35,29,6,0
Ector,206 County,U.S. House,11,LIB,Wacey Alpha Cody,7,4,3,0
Ector,206 County,Railroad Commissioner,,REP,"James ""Jim"" Wright",351,314,37,0
Ector,206 County,Railroad Commissioner,,REP,Over Votes,0,0,0,0
Ector,206 County,Railroad Commissioner,,REP,Under Votes,5,5,0,0
Ector,206 County,Railroad Commissioner,,DEM,Chrysta Castañeda,37,30,7,0
Ector,206 County,Railroad Commissioner,,LIB,Matt Sterett,6,4,2,0
Ector,206 County,Railroad Commissioner,,GRN,"Katija ""Kat"" Gruene",1,1,0,0
Ector,206 County,"Chief Justice, Supreme Court",,REP,Nathan Hecht,348,313,35,0
Ector,206 County,"Chief Justice, Supreme Court",,REP,Over Votes,0,0,0,0
Ector,206 County,"Chief Justice, Supreme Court",,REP,Under Votes,2,2,0,0
Ector,206 County,"Chief Justice, Supreme Court",,DEM,Amy Clark Meachum,40,33,7,0
Ector,206 County,"Chief Justice, Supreme Court",,LIB,Mark Ash,10,6,4,0
Ector,206 County,"Justice, Supreme Court, Place 6, (Unexpired Term)",,REP,Jane Bland,356,318,38,0
Ector,206 County,"Justice, Supreme Court, Place 6, (Unexpired Term)",,REP,Over Votes,0,0,0,0
Ector,206 County,"Justice, Supreme Court, Place 6, (Unexpired Term)",,REP,Under Votes,3,3,0,0
Ector,206 County,"Justice, Supreme Court, Place 6, (Unexpired Term)",,DEM,Kathy Cheng,41,33,8,0
Ector,206 County,"Justice, Supreme Court, Place 7",,REP,Jeff Boyd,346,311,35,0
Ector,206 County,"Justice, Supreme Court, Place 7",,REP,Over Votes,0,0,0,0
Ector,206 County,"Justice, Supreme Court, Place 7",,REP,Under Votes,6,6,0,0
Ector,206 County,"Justice, Supreme Court, Place 7",,DEM,Staci Williams,40,33,7,0
Ector,206 County,"Justice, Supreme Court, Place 7",,LIB,William Bryan Strange III,8,4,4,0
Ector,206 County,"Justice, Supreme Court, Place 8",,REP,Brett Busby,349,314,35,0
Ector,206 County,"Justice, Supreme Court, Place 8",,REP,Over Votes,0,0,0,0
Ector,206 County,"Justice, Supreme Court, Place 8",,REP,Under Votes,5,5,0,0
Ector,206 County,"Justice, Supreme Court, Place 8",,DEM,Gisela D. Triana,38,31,7,0
Ector,206 County,"Justice, Supreme Court, Place 8",,LIB,Tom Oxford,8,4,4,0
Ector,206 County,"Judge, Court of Criminal Appeals, Place 3",,REP,Bert Richardson,352,313,39,0
Ector,206 County,"Judge, Court of Criminal Appeals, Place 3",,REP,Over Votes,0,0,0,0
Ector,206 County,"Judge, Court of Criminal Appeals, Place 3",,REP,Under Votes,5,5,0,0
Ector,206 County,"Judge, Court of Criminal Appeals, Place 3",,DEM,Elizabeth Davis Frizell,43,36,7,0
Ector,206 County,"Judge, Court of Criminal Appeals, Place 4",,REP,Kevin Patrick Yeary,356,317,39,0
Ector,206 County,"Judge, Court of Criminal Appeals, Place 4",,REP,Over Votes,0,0,0,0
Ector,206 County,"Judge, Court of Criminal Appeals, Place 4",,REP,Under Votes,5,5,0,0
Ector,206 County,"Judge, Court of Criminal Appeals, Place 4",,DEM,Tina Clinton,39,32,7,0
Ector,206 County,"Judge, Court of Criminal Appeals, Place 9",,REP,David Newell,352,313,39,0
Ector,206 County,"Judge, Court of Criminal Appeals, Place 9",,REP,Over Votes,0,0,0,0
Ector,206 County,"Judge, Court of Criminal Appeals, Place 9",,REP,Under Votes,5,5,0,0
Ector,206 County,"Judge, Court of Criminal Appeals, Place 9",,DEM,Brandon Birmingham,43,36,7,0
Ector,206 County,"Member, State Board of Education, District 1",,REP,Jennifer Ivey,354,315,39,0
Ector,206 County,"Member, State Board of Education, District 1",,REP,Over Votes,0,0,0,0
Ector,206 County,"Member, State Board of Education, District 1",,REP,Under Votes,6,6,0,0
Ector,206 County,"Member, State Board of Education, District 1",,DEM,Georgina Perez,40,33,7,0
Ector,206 County,State Representative,81,REP,Brooks Landgraf,381,338,43,0
Ector,206 County,State Representative,81,REP,Over Votes,0,0,0,0
Ector,206 County,State Representative,81,REP,Under Votes,19,16,3,0
Ector,206 County,"Justice, 11th Court of Appeals District, Place 2",,REP,Bruce Williams,373,331,42,0
Ector,206 County,"Justice, 11th Court of Appeals District, Place 2",,REP,Over Votes,0,0,0,0
Ector,206 County,"Justice, 11th Court of Appeals District, Place 2",,REP,Under Votes,27,23,4,0
Ector,206 County,"Justice, 11th Court of Appeals District, Place 3 (Unexpired Term)",,REP,W. Stacy Trotter,376,335,41,0
Ector,206 County,"Justice, 11th Court of Appeals District, Place 3 (Unexpired Term)",,REP,Over Votes,0,0,0,0
Ector,206 County,"Justice, 11th Court of Appeals District, Place 3 (Unexpired Term)",,REP,Under Votes,24,19,5,0
Ector,206 County,"District Judge, 161st Judicial District",,REP,Justin Low,365,326,39,0
Ector,206 County,"District Judge, 161st Judicial District",,REP,Over Votes,0,0,0,0
Ector,206 County,"District Judge, 161st Judicial District",,REP,Under Votes,35,28,7,0
Ector,206 County,"District Judge, 446th Judicial District",,REP,Sara Kate Billingsley,374,333,41,0
Ector,206 County,"District Judge, 446th Judicial District",,REP,Over Votes,0,0,0,0
Ector,206 County,"District Judge, 446th Judicial District",,REP,Under Votes,26,21,5,0
Ector,206 County,"District Attorney, 70th Judicial District",,REP,Dusty Gallivan,374,332,42,0
Ector,206 County,"District Attorney, 70th Judicial District",,REP,Over Votes,0,0,0,0
Ector,206 County,"District Attorney, 70th Judicial District",,REP,Under Votes,26,22,4,0
Ector,207,President,,REP,Donald J. Trump / Michael R. Pence,1261,858,403,0
Ector,207,President,,REP,Over Votes,0,0,0,0
Ector,207,President,,REP,Under Votes,11,10,1,0
Ector,207,President,,DEM,Joseph R. Biden / Kamala D. Harris,99,78,21,0
Ector,207,President,,LIB,"Jo Jorgensen / Jeremy ""Spike"" Cohen",12,5,7,0
Ector,207,President,,GRN,Howie Hawkins / Angela Walker,1,1,0,0
Ector,207,President,,,President R. Boddie/Eric C. Stoneham,0,0,0,0
Ector,207,President,,,Brian Carroll/Amar Patel,0,0,0,0
Ector,207,President,,,Todd Cella/Tim Cella,0,0,0,0
Ector,207,President,,,Jesse Cuellar/Jimmy Monreal,0,0,0,0
Ector,207,President,,,Tom Hoefling/Andy Prior,0,0,0,0
Ector,207,President,,,Gloria La Riva/Leonard Peltier,0,0,0,0
Ector,207,President,,,Abram Loeb/Jennifer Jairala,0,0,0,0
Ector,207,President,,,Robert Morrow/Anne Beckett,0,0,0,0
Ector,207,President,,,Kasey Wells/Rachel Wells,0,0,0,0
Ector,207,U.S. Senate,,REP,John Cornyn,1236,848,388,0
Ector,207,U.S. Senate,,REP,Over Votes,0,0,0,0
Ector,207,U.S. Senate,,REP,Under Votes,17,12,5,0
Ector,207,U.S. Senate,,DEM,"Mary ""MJ"" Hegar",103,81,22,0
Ector,207,U.S. Senate,,LIB,Kerry Douglas McKennon,25,10,15,0
Ector,207,U.S. Senate,,GRN,David B. Collins,3,1,2,0
Ector,207,U.S. Senate,,,Ricardo Turullols-Bonilla,0,0,0,0
Ector,207,U.S. House,11,REP,August Pfluger,1237,845,392,0
Ector,207,U.S. House,11,REP,Over Votes,0,0,0,0
Ector,207,U.S. House,11,REP,Under Votes,25,20,5,0
Ector,207,U.S. House,11,DEM,Jon Mark Hogg,101,79,22,0
Ector,207,U.S. House,11,LIB,Wacey Alpha Cody,21,8,13,0
Ector,207,Railroad Commissioner,,REP,"James ""Jim"" Wright",1244,857,387,0
Ector,207,Railroad Commissioner,,REP,Over Votes,0,0,0,0
Ector,207,Railroad Commissioner,,REP,Under Votes,18,13,5,0
Ector,207,Railroad Commissioner,,DEM,Chrysta Castañeda,90,70,20,0
Ector,207,Railroad Commissioner,,LIB,Matt Sterett,24,6,18,0
Ector,207,Railroad Commissioner,,GRN,"Katija ""Kat"" Gruene",8,6,2,0
Ector,207,"Chief Justice, Supreme Court",,REP,Nathan Hecht,1229,844,385,0
Ector,207,"Chief Justice, Supreme Court",,REP,Over Votes,0,0,0,0
Ector,207,"Chief Justice, Supreme Court",,REP,Under Votes,21,16,5,0
Ector,207,"Chief Justice, Supreme Court",,DEM,Amy Clark Meachum,108,81,27,0
Ector,207,"Chief Justice, Supreme Court",,LIB,Mark Ash,26,11,15,0
Ector,207,"Justice, Supreme Court, Place 6, (Unexpired Term)",,REP,Jane Bland,1264,859,405,0
Ector,207,"Justice, Supreme Court, Place 6, (Unexpired Term)",,REP,Over Votes,0,0,0,0
Ector,207,"Justice, Supreme Court, Place 6, (Unexpired Term)",,REP,Under Votes,19,15,4,0
Ector,207,"Justice, Supreme Court, Place 6, (Unexpired Term)",,DEM,Kathy Cheng,101,78,23,0
Ector,207,"Justice, Supreme Court, Place 7",,REP,Jeff Boyd,1238,849,389,0
Ector,207,"Justice, Supreme Court, Place 7",,REP,Over Votes,0,0,0,0
Ector,207,"Justice, Supreme Court, Place 7",,REP,Under Votes,21,15,6,0
Ector,207,"Justice, Supreme Court, Place 7",,DEM,Staci Williams,100,78,22,0
Ector,207,"Justice, Supreme Court, Place 7",,LIB,William Bryan Strange III,25,10,15,0
Ector,207,"Justice, Supreme Court, Place 8",,REP,Brett Busby,1235,851,384,0
Ector,207,"Justice, Supreme Court, Place 8",,REP,Over Votes,0,0,0,0
Ector,207,"Justice, Supreme Court, Place 8",,REP,Under Votes,21,15,6,0
Ector,207,"Justice, Supreme Court, Place 8",,DEM,Gisela D. Triana,99,76,23,0
Ector,207,"Justice, Supreme Court, Place 8",,LIB,Tom Oxford,29,10,19,0
Ector,207,"Judge, Court of Criminal Appeals, Place 3",,REP,Bert Richardson,1257,854,403,0
Ector,207,"Judge, Court of Criminal Appeals, Place 3",,REP,Over Votes,0,0,0,0
Ector,207,"Judge, Court of Criminal Appeals, Place 3",,REP,Under Votes,21,15,6,0
Ector,207,"Judge, Court of Criminal Appeals, Place 3",,DEM,Elizabeth Davis Frizell,106,83,23,0
Ector,207,"Judge, Court of Criminal Appeals, Place 4",,REP,Kevin Patrick Yeary,1262,862,400,0
Ector,207,"Judge, Court of Criminal Appeals, Place 4",,REP,Over Votes,0,0,0,0
Ector,207,"Judge, Court of Criminal Appeals, Place 4",,REP,Under Votes,23,16,7,0
Ector,207,"Judge, Court of Criminal Appeals, Place 4",,DEM,Tina Clinton,99,74,25,0
Ector,207,"Judge, Court of Criminal Appeals, Place 9",,REP,David Newell,1262,859,403,0
Ector,207,"Judge, Court of Criminal Appeals, Place 9",,REP,Over Votes,0,0,0,0
Ector,207,"Judge, Court of Criminal Appeals, Place 9",,REP,Under Votes,23,16,7,0
Ector,207,"Judge, Court of Criminal Appeals, Place 9",,DEM,Brandon Birmingham,99,77,22,0
Ector,207,"Member, State Board of Education, District 1",,REP,Jennifer Ivey,1253,855,398,0
Ector,207,"Member, State Board of Education, District 1",,REP,Over Votes,0,0,0,0
Ector,207,"Member, State Board of Education, District 1",,REP,Under Votes,25,19,6,0
Ector,207,"Member, State Board of Education, District 1",,DEM,Georgina Perez,106,78,28,0
Ector,207,State Representative,81,REP,Brooks Landgraf,1298,884,414,0
Ector,207,State Representative,81,REP,Over Votes,0,0,0,0
Ector,207,State Representative,81,REP,Under Votes,86,68,18,0
Ector,207,"Justice, 11th Court of Appeals District, Place 2",,REP,Bruce Williams,1285,873,412,0
Ector,207,"Justice, 11th Court of Appeals District, Place 2",,REP,Over Votes,0,0,0,0
Ector,207,"Justice, 11th Court of Appeals District, Place 2",,REP,Under Votes,99,79,20,0
Ector,207,"Justice, 11th Court of Appeals District, Place 3 (Unexpired Term)",,REP,W. Stacy Trotter,1283,873,410,0
Ector,207,"Justice, 11th Court of Appeals District, Place 3 (Unexpired Term)",,REP,Over Votes,0,0,0,0
Ector,207,"Justice, 11th Court of Appeals District, Place 3 (Unexpired Term)",,REP,Under Votes,101,79,22,0
Ector,207,"District Judge, 161st Judicial District",,REP,Justin Low,1277,867,410,0
Ector,207,"District Judge, 161st Judicial District",,REP,Over Votes,0,0,0,0
Ector,207,"District Judge, 161st Judicial District",,REP,Under Votes,107,85,22,0
Ector,207,"District Judge, 446th Judicial District",,REP,Sara Kate Billingsley,1281,871,410,0
Ector,207,"District Judge, 446th Judicial District",,REP,Over Votes,0,0,0,0
Ector,207,"District Judge, 446th Judicial District",,REP,Under Votes,103,81,22,0
Ector,207,"District Attorney, 70th Judicial District",,REP,Dusty Gallivan,1286,876,410,0
Ector,207,"District Attorney, 70th Judicial District",,REP,Over Votes,0,0,0,0
Ector,207,"District Attorney, 70th Judicial District",,REP,Under Votes,98,76,22,0
Ector,208,President,,REP,Donald J. Trump / Michael R. Pence,1989,1650,339,0
Ector,208,President,,REP,Over Votes,0,0,0,0
Ector,208,President,,REP,Under Votes,18,11,7,0
Ector,208,President,,DEM,Joseph R. Biden / Kamala D. Harris,593,493,100,0
Ector,208,President,,LIB,"Jo Jorgensen / Jeremy ""Spike"" Cohen",33,22,11,0
Ector,208,President,,GRN,Howie Hawkins / Angela Walker,4,2,2,0
Ector,208,President,,,President R. Boddie/Eric C. Stoneham,0,0,0,0
Ector,208,President,,,Brian Carroll/Amar Patel,1,0,1,0
Ector,208,President,,,Todd Cella/Tim Cella,0,0,0,0
Ector,208,President,,,Jesse Cuellar/Jimmy Monreal,0,0,0,0
Ector,208,President,,,Tom Hoefling/Andy Prior,0,0,0,0
Ector,208,President,,,Gloria La Riva/Leonard Peltier,0,0,0,0
Ector,208,President,,,Abram Loeb/Jennifer Jairala,0,0,0,0
Ector,208,President,,,Robert Morrow/Anne Beckett,0,0,0,0
Ector,208,President,,,Kasey Wells/Rachel Wells,0,0,0,0
Ector,208,U.S. Senate,,REP,John Cornyn,1958,1630,328,0
Ector,208,U.S. Senate,,REP,Over Votes,0,0,0,0
Ector,208,U.S. Senate,,REP,Under Votes,60,49,11,0
Ector,208,U.S. Senate,,DEM,"Mary ""MJ"" Hegar",544,453,91,0
Ector,208,U.S. Senate,,LIB,Kerry Douglas McKennon,63,40,23,0
Ector,208,U.S. Senate,,GRN,David B. Collins,13,6,7,0
Ector,208,U.S. Senate,,,Ricardo Turullols-Bonilla,0,0,0,0
Ector,208,U.S. House,11,REP,August Pfluger,1978,1641,337,0
Ector,208,U.S. House,11,REP,Over Votes,0,0,0,0
Ector,208,U.S. House,11,REP,Under Votes,72,60,12,0
Ector,208,U.S. House,11,DEM,Jon Mark Hogg,529,439,90,0
Ector,208,U.S. House,11,LIB,Wacey Alpha Cody,59,38,21,0
Ector,208,Railroad Commissioner,,REP,"James ""Jim"" Wright",1970,1642,328,0
Ector,208,Railroad Commissioner,,REP,Over Votes,0,0,0,0
Ector,208,Railroad Commissioner,,REP,Under Votes,76,64,12,0
Ector,208,Railroad Commissioner,,DEM,Chrysta Castañeda,515,420,95,0
Ector,208,Railroad Commissioner,,LIB,Matt Sterett,56,37,19,0
Ector,208,Railroad Commissioner,,GRN,"Katija ""Kat"" Gruene",21,15,6,0
Ector,208,"Chief Justice, Supreme Court",,REP,Nathan Hecht,1935,1607,328,0
Ector,208,"Chief Justice, Supreme Court",,REP,Over Votes,0,0,0,0
Ector,208,"Chief Justice, Supreme Court",,REP,Under Votes,70,58,12,0
Ector,208,"Chief Justice, Supreme Court",,DEM,Amy Clark Meachum,556,458,98,0
Ector,208,"Chief Justice, Supreme Court",,LIB,Mark Ash,77,55,22,0
Ector,208,"Justice, Supreme Court, Place 6, (Unexpired Term)",,REP,Jane Bland,2004,1659,345,0
Ector,208,"Justice, Supreme Court, Place 6, (Unexpired Term)",,REP,Over Votes,0,0,0,0
Ector,208,"Justice, Supreme Court, Place 6, (Unexpired Term)",,REP,Under Votes,80,66,14,0
Ector,208,"Justice, Supreme Court, Place 6, (Unexpired Term)",,DEM,Kathy Cheng,554,453,101,0
Ector,208,"Justice, Supreme Court, Place 7",,REP,Jeff Boyd,1955,1631,324,0
Ector,208,"Justice, Supreme Court, Place 7",,REP,Over Votes,0,0,0,0
Ector,208,"Justice, Supreme Court, Place 7",,REP,Under Votes,78,64,14,0
Ector,208,"Justice, Supreme Court, Place 7",,DEM,Staci Williams,539,442,97,0
Ector,208,"Justice, Supreme Court, Place 7",,LIB,William Bryan Strange III,66,41,25,0
Ector,208,"Justice, Supreme Court, Place 8",,REP,Brett Busby,1946,1621,325,0
Ector,208,"Justice, Supreme Court, Place 8",,REP,Over Votes,0,0,0,0
Ector,208,"Justice, Supreme Court, Place 8",,REP,Under Votes,83,69,14,0
Ector,208,"Justice, Supreme Court, Place 8",,DEM,Gisela D. Triana,546,446,100,0
Ector,208,"Justice, Supreme Court, Place 8",,LIB,Tom Oxford,63,42,21,0
Ector,208,"Judge, Court of Criminal Appeals, Place 3",,REP,Bert Richardson,1985,1642,343,0
Ector,208,"Judge, Court of Criminal Appeals, Place 3",,REP,Over Votes,0,0,0,0
Ector,208,"Judge, Court of Criminal Appeals, Place 3",,REP,Under Votes,87,72,15,0
Ector,208,"Judge, Court of Criminal Appeals, Place 3",,DEM,Elizabeth Davis Frizell,566,464,102,0
Ector,208,"Judge, Court of Criminal Appeals, Place 4",,REP,Kevin Patrick Yeary,1993,1648,345,0
Ector,208,"Judge, Court of Criminal Appeals, Place 4",,REP,Over Votes,0,0,0,0
Ector,208,"Judge, Court of Criminal Appeals, Place 4",,REP,Under Votes,88,74,14,0
Ector,208,"Judge, Court of Criminal Appeals, Place 4",,DEM,Tina Clinton,557,456,101,0
Ector,208,"Judge, Court of Criminal Appeals, Place 9",,REP,David Newell,2001,1653,348,0
Ector,208,"Judge, Court of Criminal Appeals, Place 9",,REP,Over Votes,0,0,0,0
Ector,208,"Judge, Court of Criminal Appeals, Place 9",,REP,Under Votes,88,75,13,0
Ector,208,"Judge, Court of Criminal Appeals, Place 9",,DEM,Brandon Birmingham,549,450,99,0
Ector,208,"Member, State Board of Education, District 1",,REP,Jennifer Ivey,1985,1648,337,0
Ector,208,"Member, State Board of Education, District 1",,REP,Over Votes,0,0,0,0
Ector,208,"Member, State Board of Education, District 1",,REP,Under Votes,98,84,14,0
Ector,208,"Member, State Board of Education, District 1",,DEM,Georgina Perez,555,446,109,0
Ector,208,State Representative,81,REP,Brooks Landgraf,2302,1890,412,0
Ector,208,State Representative,81,REP,Over Votes,0,0,0,0
Ector,208,State Representative,81,REP,Under Votes,336,288,48,0
Ector,208,"Justice, 11th Court of Appeals District, Place 2",,REP,Bruce Williams,2254,1844,410,0
Ector,208,"Justice, 11th Court of Appeals District, Place 2",,REP,Over Votes,0,0,0,0
Ector,208,"Justice, 11th Court of Appeals District, Place 2",,REP,Under Votes,384,334,50,0
Ector,208,"Justice, 11th Court of Appeals District, Place 3 (Unexpired Term)",,REP,W. Stacy Trotter,2253,1850,403,0
Ector,208,"Justice, 11th Court of Appeals District, Place 3 (Unexpired Term)",,REP,Over Votes,0,0,0,0
Ector,208,"Justice, 11th Court of Appeals District, Place 3 (Unexpired Term)",,REP,Under Votes,385,328,57,0
Ector,208,"District Judge, 161st Judicial District",,REP,Justin Low,2228,1823,405,0
Ector,208,"District Judge, 161st Judicial District",,REP,Over Votes,0,0,0,0
Ector,208,"District Judge, 161st Judicial District",,REP,Under Votes,410,355,55,0
Ector,208,"District Judge, 446th Judicial District",,REP,Sara Kate Billingsley,2236,1834,402,0
Ector,208,"District Judge, 446th Judicial District",,REP,Over Votes,0,0,0,0
Ector,208,"District Judge, 446th Judicial District",,REP,Under Votes,402,344,58,0
Ector,208,"District Attorney, 70th Judicial District",,REP,Dusty Gallivan,2250,1846,404,0
Ector,208,"District Attorney, 70th Judicial District",,REP,Over Votes,0,0,0,0
Ector,208,"District Attorney, 70th Judicial District",,REP,Under Votes,388,332,56,0
Ector,208,Mayor,,,Dewey Bryant,1203,1034,169,0
Ector,208,Mayor,,,Over Votes,0,0,0,0
Ector,208,Mayor,,,Under Votes,255,211,44,0
Ector,208,Mayor,,,Javier Joven,813,651,162,0
Ector,208,Mayor,,,Gloria G. Apolinario,367,282,85,0
Ector,208,"Council Member, At-Large",,,David R. Turner,1139,941,198,0
Ector,208,"Council Member, At-Large",,,Over Votes,0,0,0,0
Ector,208,"Council Member, At-Large",,,Under Votes,265,219,46,0
Ector,208,"Council Member, At-Large",,,La-Tasha Gentry,261,206,55,0
Ector,208,"Council Member, At-Large",,,Jo Ann Davenport Littleton,248,199,49,0
Ector,208,"Council Member, At-Large",,,Denise Swanner,725,613,112,0
Ector,209,President,,REP,Donald J. Trump / Michael R. Pence,548,467,81,0
Ector,209,President,,REP,Over Votes,0,0,0,0
Ector,209,President,,REP,Under Votes,4,4,0,0
Ector,209,President,,DEM,Joseph R. Biden / Kamala D. Harris,203,165,38,0
Ector,209,President,,LIB,"Jo Jorgensen / Jeremy ""Spike"" Cohen",7,6,1,0
Ector,209,President,,GRN,Howie Hawkins / Angela Walker,1,1,0,0
Ector,209,President,,,President R. Boddie/Eric C. Stoneham,0,0,0,0
Ector,209,President,,,Brian Carroll/Amar Patel,0,0,0,0
Ector,209,President,,,Todd Cella/Tim Cella,0,0,0,0
Ector,209,President,,,Jesse Cuellar/Jimmy Monreal,0,0,0,0
Ector,209,President,,,Tom Hoefling/Andy Prior,0,0,0,0
Ector,209,President,,,Gloria La Riva/Leonard Peltier,0,0,0,0
Ector,209,President,,,Abram Loeb/Jennifer Jairala,0,0,0,0
Ector,209,President,,,Robert Morrow/Anne Beckett,0,0,0,0
Ector,209,President,,,Kasey Wells/Rachel Wells,0,0,0,0
Ector,209,U.S. Senate,,REP,John Cornyn,549,475,74,0
Ector,209,U.S. Senate,,REP,Over Votes,0,0,0,0
Ector,209,U.S. Senate,,REP,Under Votes,12,11,1,0
Ector,209,U.S. Senate,,DEM,"Mary ""MJ"" Hegar",188,147,41,0
Ector,209,U.S. Senate,,LIB,Kerry Douglas McKennon,13,9,4,0
Ector,209,U.S. Senate,,GRN,David B. Collins,1,1,0,0
Ector,209,U.S. Senate,,,Ricardo Turullols-Bonilla,0,0,0,0
Ector,209,U.S. House,11,REP,August Pfluger,558,473,85,0
Ector,209,U.S. House,11,REP,Over Votes,0,0,0,0
Ector,209,U.S. House,11,REP,Under Votes,16,15,1,0
Ector,209,U.S. House,11,DEM,Jon Mark Hogg,176,143,33,0
Ector,209,U.S. House,11,LIB,Wacey Alpha Cody,13,12,1,0
Ector,209,Railroad Commissioner,,REP,"James ""Jim"" Wright",538,461,77,0
Ector,209,Railroad Commissioner,,REP,Over Votes,0,0,0,0
Ector,209,Railroad Commissioner,,REP,Under Votes,17,15,2,0
Ector,209,Railroad Commissioner,,DEM,Chrysta Castañeda,188,149,39,0
Ector,209,Railroad Commissioner,,LIB,Matt Sterett,14,13,1,0
Ector,209,Railroad Commissioner,,GRN,"Katija ""Kat"" Gruene",6,5,1,0
Ector,209,"Chief Justice, Supreme Court",,REP,Nathan Hecht,536,461,75,0
Ector,209,"Chief Justice, Supreme Court",,REP,Over Votes,0,0,0,0
Ector,209,"Chief Justice, Supreme Court",,REP,Under Votes,15,14,1,0
Ector,209,"Chief Justice, Supreme Court",,DEM,Amy Clark Meachum,197,157,40,0
Ector,209,"Chief Justice, Supreme Court",,LIB,Mark Ash,15,11,4,0
Ector,209,"Justice, Supreme Court, Place 6, (Unexpired Term)",,REP,Jane Bland,550,473,77,0
Ector,209,"Justice, Supreme Court, Place 6, (Unexpired Term)",,REP,Over Votes,0,0,0,0
Ector,209,"Justice, Supreme Court, Place 6, (Unexpired Term)",,REP,Under Votes,19,16,3,0
Ector,209,"Justice, Supreme Court, Place 6, (Unexpired Term)",,DEM,Kathy Cheng,194,154,40,0
Ector,209,"Justice, Supreme Court, Place 7",,REP,Jeff Boyd,535,461,74,0
Ector,209,"Justice, Supreme Court, Place 7",,REP,Over Votes,0,0,0,0
Ector,209,"Justice, Supreme Court, Place 7",,REP,Under Votes,21,19,2,0
Ector,209,"Justice, Supreme Court, Place 7",,DEM,Staci Williams,193,151,42,0
Ector,209,"Justice, Supreme Court, Place 7",,LIB,William Bryan Strange III,14,12,2,0
Ector,209,"Justice, Supreme Court, Place 8",,REP,Brett Busby,537,464,73,0
Ector,209,"Justice, Supreme Court, Place 8",,REP,Over Votes,0,0,0,0
Ector,209,"Justice, Supreme Court, Place 8",,REP,Under Votes,21,20,1,0
Ector,209,"Justice, Supreme Court, Place 8",,DEM,Gisela D. Triana,192,150,42,0
Ector,209,"Justice, Supreme Court, Place 8",,LIB,Tom Oxford,13,9,4,0
Ector,209,"Judge, Court of Criminal Appeals, Place 3",,REP,Bert Richardson,539,462,77,0
Ector,209,"Judge, Court of Criminal Appeals, Place 3",,REP,Over Votes,0,0,0,0
Ector,209,"Judge, Court of Criminal Appeals, Place 3",,REP,Under Votes,21,20,1,0
Ector,209,"Judge, Court of Criminal Appeals, Place 3",,DEM,Elizabeth Davis Frizell,203,161,42,0
Ector,209,"Judge, Court of Criminal Appeals, Place 4",,REP,Kevin Patrick Yeary,540,461,79,0
Ector,209,"Judge, Court of Criminal Appeals, Place 4",,REP,Over Votes,1,1,0,0
Ector,209,"Judge, Court of Criminal Appeals, Place 4",,REP,Under Votes,22,21,1,0
Ector,209,"Judge, Court of Criminal Appeals, Place 4",,DEM,Tina Clinton,200,160,40,0
Ector,209,"Judge, Court of Criminal Appeals, Place 9",,REP,David Newell,550,467,83,0
Ector,209,"Judge, Court of Criminal Appeals, Place 9",,REP,Over Votes,0,0,0,0
Ector,209,"Judge, Court of Criminal Appeals, Place 9",,REP,Under Votes,23,21,2,0
Ector,209,"Judge, Court of Criminal Appeals, Place 9",,DEM,Brandon Birmingham,190,155,35,0
Ector,209,"Member, State Board of Education, District 1",,REP,Jennifer Ivey,547,466,81,0
Ector,209,"Member, State Board of Education, District 1",,REP,Over Votes,0,0,0,0
Ector,209,"Member, State Board of Education, District 1",,REP,Under Votes,26,24,2,0
Ector,209,"Member, State Board of Education, District 1",,DEM,Georgina Perez,190,153,37,0
Ector,209,State Representative,81,REP,Brooks Landgraf,638,538,100,0
Ector,209,State Representative,81,REP,Over Votes,0,0,0,0
Ector,209,State Representative,81,REP,Under Votes,125,105,20,0
Ector,209,"Justice, 11th Court of Appeals District, Place 2",,REP,Bruce Williams,627,527,100,0
Ector,209,"Justice, 11th Court of Appeals District, Place 2",,REP,Over Votes,0,0,0,0
Ector,209,"Justice, 11th Court of Appeals District, Place 2",,REP,Under Votes,136,116,20,0
Ector,209,"Justice, 11th Court of Appeals District, Place 3 (Unexpired Term)",,REP,W. Stacy Trotter,631,530,101,0
Ector,209,"Justice, 11th Court of Appeals District, Place 3 (Unexpired Term)",,REP,Over Votes,0,0,0,0
Ector,209,"Justice, 11th Court of Appeals District, Place 3 (Unexpired Term)",,REP,Under Votes,132,113,19,0
Ector,209,"District Judge, 161st Judicial District",,REP,Justin Low,623,522,101,0
Ector,209,"District Judge, 161st Judicial District",,REP,Over Votes,0,0,0,0
Ector,209,"District Judge, 161st Judicial District",,REP,Under Votes,140,121,19,0
Ector,209,"District Judge, 446th Judicial District",,REP,Sara Kate Billingsley,624,522,102,0
Ector,209,"District Judge, 446th Judicial District",,REP,Over Votes,0,0,0,0
Ector,209,"District Judge, 446th Judicial District",,REP,Under Votes,139,121,18,0
Ector,209,"District Attorney, 70th Judicial District",,REP,Dusty Gallivan,625,527,98,0
Ector,209,"District Attorney, 70th Judicial District",,REP,Over Votes,0,0,0,0
Ector,209,"District Attorney, 70th Judicial District",,REP,Under Votes,138,116,22,0
Ector,209,Mayor,,,Dewey Bryant,353,305,48,0
Ector,209,Mayor,,,Over Votes,0,0,0,0
Ector,209,Mayor,,,Under Votes,69,55,14,0
Ector,209,Mayor,,,Javier Joven,214,185,29,0
Ector,209,Mayor,,,Gloria G. Apolinario,127,98,29,0
Ector,209,"Council Member, District 2",,,Steven P. Thompson,356,307,49,0
Ector,209,"Council Member, District 2",,,Over Votes,0,0,0,0
Ector,209,"Council Member, District 2",,,Under Votes,106,91,15,0
Ector,209,"Council Member, District 2",,,Rachel D. Minor,301,245,56,0
Ector,209,"Council Member, At-Large",,,David R. Turner,314,264,50,0
Ector,209,"Council Member, At-Large",,,Over Votes,0,0,0,0
Ector,209,"Council Member, At-Large",,,Under Votes,78,62,16,0
Ector,209,"Council Member, At-Large",,,La-Tasha Gentry,82,58,24,0
Ector,209,"Council Member, At-Large",,,Jo Ann Davenport Littleton,71,59,12,0
Ector,209,"Council Member, At-Large",,,Denise Swanner,218,200,18,0
Ector,301,President,,REP,Donald J. Trump / Michael R. Pence,915,744,171,0
Ector,301,President,,REP,Over Votes,0,0,0,0
Ector,301,President,,REP,Under Votes,10,7,3,0
Ector,301,President,,DEM,Joseph R. Biden / Kamala D. Harris,504,424,80,0
Ector,301,President,,LIB,"Jo Jorgensen / Jeremy ""Spike"" Cohen",13,9,4,0
Ector,301,President,,GRN,Howie Hawkins / Angela Walker,3,1,2,0
Ector,301,President,,,President R. Boddie/Eric C. Stoneham,0,0,0,0
Ector,301,President,,,Brian Carroll/Amar Patel,0,0,0,0
Ector,301,President,,,Todd Cella/Tim Cella,0,0,0,0
Ector,301,President,,,Jesse Cuellar/Jimmy Monreal,0,0,0,0
Ector,301,President,,,Tom Hoefling/Andy Prior,0,0,0,0
Ector,301,President,,,Gloria La Riva/Leonard Peltier,0,0,0,0
Ector,301,President,,,Abram Loeb/Jennifer Jairala,0,0,0,0
Ector,301,President,,,Robert Morrow/Anne Beckett,0,0,0,0
Ector,301,President,,,Kasey Wells/Rachel Wells,0,0,0,0
Ector,301,U.S. Senate,,REP,John Cornyn,894,726,168,0
Ector,301,U.S. Senate,,REP,Over Votes,0,0,0,0
Ector,301,U.S. Senate,,REP,Under Votes,44,38,6,0
Ector,301,U.S. Senate,,DEM,"Mary ""MJ"" Hegar",473,399,74,0
Ector,301,U.S. Senate,,LIB,Kerry Douglas McKennon,23,15,8,0
Ector,301,U.S. Senate,,GRN,David B. Collins,11,7,4,0
Ector,301,U.S. Senate,,,Ricardo Turullols-Bonilla,0,0,0,0
Ector,301,U.S. House,11,REP,August Pfluger,888,727,161,0
Ector,301,U.S. House,11,REP,Over Votes,0,0,0,0
Ector,301,U.S. House,11,REP,Under Votes,56,43,13,0
Ector,301,U.S. House,11,DEM,Jon Mark Hogg,474,400,74,0
Ector,301,U.S. House,11,LIB,Wacey Alpha Cody,27,15,12,0
Ector,301,Railroad Commissioner,,REP,"James ""Jim"" Wright",865,711,154,0
Ector,301,Railroad Commissioner,,REP,Over Votes,0,0,0,0
Ector,301,Railroad Commissioner,,REP,Under Votes,52,45,7,0
Ector,301,Railroad Commissioner,,DEM,Chrysta Castañeda,490,405,85,0
Ector,301,Railroad Commissioner,,LIB,Matt Sterett,27,16,11,0
Ector,301,Railroad Commissioner,,GRN,"Katija ""Kat"" Gruene",11,8,3,0
Ector,301,"Chief Justice, Supreme Court",,REP,Nathan Hecht,867,703,164,0
Ector,301,"Chief Justice, Supreme Court",,REP,Over Votes,0,0,0,0
Ector,301,"Chief Justice, Supreme Court",,REP,Under Votes,51,44,7,0
Ector,301,"Chief Justice, Supreme Court",,DEM,Amy Clark Meachum,495,422,73,0
Ector,301,"Chief Justice, Supreme Court",,LIB,Mark Ash,32,16,16,0
Ector,301,"Justice, Supreme Court, Place 6, (Unexpired Term)",,REP,Jane Bland,898,725,173,0
Ector,301,"Justice, Supreme Court, Place 6, (Unexpired Term)",,REP,Over Votes,0,0,0,0
Ector,301,"Justice, Supreme Court, Place 6, (Unexpired Term)",,REP,Under Votes,53,46,7,0
Ector,301,"Justice, Supreme Court, Place 6, (Unexpired Term)",,DEM,Kathy Cheng,494,414,80,0
Ector,301,"Justice, Supreme Court, Place 7",,REP,Jeff Boyd,868,711,157,0
Ector,301,"Justice, Supreme Court, Place 7",,REP,Over Votes,0,0,0,0
Ector,301,"Justice, Supreme Court, Place 7",,REP,Under Votes,58,48,10,0
Ector,301,"Justice, Supreme Court, Place 7",,DEM,Staci Williams,487,410,77,0
Ector,301,"Justice, Supreme Court, Place 7",,LIB,William Bryan Strange III,32,16,16,0
Ector,301,"Justice, Supreme Court, Place 8",,REP,Brett Busby,860,702,158,0
Ector,301,"Justice, Supreme Court, Place 8",,REP,Over Votes,0,0,0,0
Ector,301,"Justice, Supreme Court, Place 8",,REP,Under Votes,65,52,13,0
Ector,301,"Justice, Supreme Court, Place 8",,DEM,Gisela D. Triana,485,409,76,0
Ector,301,"Justice, Supreme Court, Place 8",,LIB,Tom Oxford,35,22,13,0
Ector,301,"Judge, Court of Criminal Appeals, Place 3",,REP,Bert Richardson,893,722,171,0
Ector,301,"Judge, Court of Criminal Appeals, Place 3",,REP,Over Votes,0,0,0,0
Ector,301,"Judge, Court of Criminal Appeals, Place 3",,REP,Under Votes,64,52,12,0
Ector,301,"Judge, Court of Criminal Appeals, Place 3",,DEM,Elizabeth Davis Frizell,488,411,77,0
Ector,301,"Judge, Court of Criminal Appeals, Place 4",,REP,Kevin Patrick Yeary,893,721,172,0
Ector,301,"Judge, Court of Criminal Appeals, Place 4",,REP,Over Votes,0,0,0,0
Ector,301,"Judge, Court of Criminal Appeals, Place 4",,REP,Under Votes,61,49,12,0
Ector,301,"Judge, Court of Criminal Appeals, Place 4",,DEM,Tina Clinton,491,415,76,0
Ector,301,"Judge, Court of Criminal Appeals, Place 9",,REP,David Newell,903,725,178,0
Ector,301,"Judge, Court of Criminal Appeals, Place 9",,REP,Over Votes,0,0,0,0
Ector,301,"Judge, Court of Criminal Appeals, Place 9",,REP,Under Votes,64,52,12,0
Ector,301,"Judge, Court of Criminal Appeals, Place 9",,DEM,Brandon Birmingham,478,408,70,0
Ector,301,"Member, State Board of Education, District 1",,REP,Jennifer Ivey,880,712,168,0
Ector,301,"Member, State Board of Education, District 1",,REP,Over Votes,0,0,0,0
Ector,301,"Member, State Board of Education, District 1",,REP,Under Votes,68,55,13,0
Ector,301,"Member, State Board of Education, District 1",,DEM,Georgina Perez,497,418,79,0
Ector,301,State Representative,81,REP,Brooks Landgraf,1128,915,213,0
Ector,301,State Representative,81,REP,Over Votes,0,0,0,0
Ector,301,State Representative,81,REP,Under Votes,317,270,47,0
Ector,301,"Justice, 11th Court of Appeals District, Place 2",,REP,Bruce Williams,1098,886,212,0
Ector,301,"Justice, 11th Court of Appeals District, Place 2",,REP,Over Votes,0,0,0,0
Ector,301,"Justice, 11th Court of Appeals District, Place 2",,REP,Under Votes,347,299,48,0
Ector,301,"Justice, 11th Court of Appeals District, Place 3 (Unexpired Term)",,REP,W. Stacy Trotter,1093,886,207,0
Ector,301,"Justice, 11th Court of Appeals District, Place 3 (Unexpired Term)",,REP,Over Votes,0,0,0,0
Ector,301,"Justice, 11th Court of Appeals District, Place 3 (Unexpired Term)",,REP,Under Votes,352,299,53,0
Ector,301,"District Judge, 161st Judicial District",,REP,Justin Low,1074,868,206,0
Ector,301,"District Judge, 161st Judicial District",,REP,Over Votes,0,0,0,0
Ector,301,"District Judge, 161st Judicial District",,REP,Under Votes,371,317,54,0
Ector,301,"District Judge, 446th Judicial District",,REP,Sara Kate Billingsley,1099,884,215,0
Ector,301,"District Judge, 446th Judicial District",,REP,Over Votes,0,0,0,0
Ector,301,"District Judge, 446th Judicial District",,REP,Under Votes,346,301,45,0
Ector,301,"District Attorney, 70th Judicial District",,REP,Dusty Gallivan,1106,890,216,0
Ector,301,"District Attorney, 70th Judicial District",,REP,Over Votes,0,0,0,0
Ector,301,"District Attorney, 70th Judicial District",,REP,Under Votes,339,295,44,0
Ector,301,Mayor,,,Dewey Bryant,455,380,75,0
Ector,301,Mayor,,,Over Votes,0,0,0,0
Ector,301,Mayor,,,Under Votes,162,133,29,0
Ector,301,Mayor,,,Javier Joven,583,460,123,0
Ector,301,Mayor,,,Gloria G. Apolinario,245,212,33,0
Ector,301,"Council Member, At-Large",,,David R. Turner,571,448,123,0
Ector,301,"Council Member, At-Large",,,Over Votes,0,0,0,0
Ector,301,"Council Member, At-Large",,,Under Votes,170,138,32,0
Ector,301,"Council Member, At-Large",,,La-Tasha Gentry,196,156,40,0
Ector,301,"Council Member, At-Large",,,Jo Ann Davenport Littleton,224,201,23,0
Ector,301,"Council Member, At-Large",,,Denise Swanner,284,242,42,0
Ector,302,President,,REP,Donald J. Trump / Michael R. Pence,452,363,89,0
Ector,302,President,,REP,Over Votes,1,1,0,0
Ector,302,President,,REP,Under Votes,4,3,1,0
Ector,302,President,,DEM,Joseph R. Biden / Kamala D. Harris,183,161,22,0
Ector,302,President,,LIB,"Jo Jorgensen / Jeremy ""Spike"" Cohen",11,8,3,0
Ector,302,President,,GRN,Howie Hawkins / Angela Walker,1,1,0,0
Ector,302,President,,,President R. Boddie/Eric C. Stoneham,0,0,0,0
Ector,302,President,,,Brian Carroll/Amar Patel,0,0,0,0
Ector,302,President,,,Todd Cella/Tim Cella,0,0,0,0
Ector,302,President,,,Jesse Cuellar/Jimmy Monreal,0,0,0,0
Ector,302,President,,,Tom Hoefling/Andy Prior,0,0,0,0
Ector,302,President,,,Gloria La Riva/Leonard Peltier,0,0,0,0
Ector,302,President,,,Abram Loeb/Jennifer Jairala,0,0,0,0
Ector,302,President,,,Robert Morrow/Anne Beckett,0,0,0,0
Ector,302,President,,,Kasey Wells/Rachel Wells,0,0,0,0
Ector,302,U.S. Senate,,REP,John Cornyn,434,354,80,0
Ector,302,U.S. Senate,,REP,Over Votes,0,0,0,0
Ector,302,U.S. Senate,,REP,Under Votes,16,13,3,0
Ector,302,U.S. Senate,,DEM,"Mary ""MJ"" Hegar",178,152,26,0
Ector,302,U.S. Senate,,LIB,Kerry Douglas McKennon,19,14,5,0
Ector,302,U.S. Senate,,GRN,David B. Collins,5,4,1,0
Ector,302,U.S. Senate,,,Ricardo Turullols-Bonilla,0,0,0,0
Ector,302,U.S. House,11,REP,August Pfluger,444,358,86,0
Ector,302,U.S. House,11,REP,Over Votes,0,0,0,0
Ector,302,U.S. House,11,REP,Under Votes,22,18,4,0
Ector,302,U.S. House,11,DEM,Jon Mark Hogg,165,145,20,0
Ector,302,U.S. House,11,LIB,Wacey Alpha Cody,21,16,5,0
Ector,302,Railroad Commissioner,,REP,"James ""Jim"" Wright",430,348,82,0
Ector,302,Railroad Commissioner,,REP,Over Votes,0,0,0,0
Ector,302,Railroad Commissioner,,REP,Under Votes,22,18,4,0
Ector,302,Railroad Commissioner,,DEM,Chrysta Castañeda,177,155,22,0
Ector,302,Railroad Commissioner,,LIB,Matt Sterett,17,14,3,0
Ector,302,Railroad Commissioner,,GRN,"Katija ""Kat"" Gruene",6,2,4,0
Ector,302,"Chief Justice, Supreme Court",,REP,Nathan Hecht,421,343,78,0
Ector,302,"Chief Justice, Supreme Court",,REP,Over Votes,0,0,0,0
Ector,302,"Chief Justice, Supreme Court",,REP,Under Votes,24,19,5,0
Ector,302,"Chief Justice, Supreme Court",,DEM,Amy Clark Meachum,184,156,28,0
Ector,302,"Chief Justice, Supreme Court",,LIB,Mark Ash,23,19,4,0
Ector,302,"Justice, Supreme Court, Place 6, (Unexpired Term)",,REP,Jane Bland,453,366,87,0
Ector,302,"Justice, Supreme Court, Place 6, (Unexpired Term)",,REP,Over Votes,0,0,0,0
Ector,302,"Justice, Supreme Court, Place 6, (Unexpired Term)",,REP,Under Votes,21,18,3,0
Ector,302,"Justice, Supreme Court, Place 6, (Unexpired Term)",,DEM,Kathy Cheng,178,153,25,0
Ector,302,"Justice, Supreme Court, Place 7",,REP,Jeff Boyd,427,345,82,0
Ector,302,"Justice, Supreme Court, Place 7",,REP,Over Votes,0,0,0,0
Ector,302,"Justice, Supreme Court, Place 7",,REP,Under Votes,20,17,3,0
Ector,302,"Justice, Supreme Court, Place 7",,DEM,Staci Williams,185,160,25,0
Ector,302,"Justice, Supreme Court, Place 7",,LIB,William Bryan Strange III,20,15,5,0
Ector,302,"Justice, Supreme Court, Place 8",,REP,Brett Busby,424,344,80,0
Ector,302,"Justice, Supreme Court, Place 8",,REP,Over Votes,0,0,0,0
Ector,302,"Justice, Supreme Court, Place 8",,REP,Under Votes,19,16,3,0
Ector,302,"Justice, Supreme Court, Place 8",,DEM,Gisela D. Triana,182,158,24,0
Ector,302,"Justice, Supreme Court, Place 8",,LIB,Tom Oxford,27,19,8,0
Ector,302,"Judge, Court of Criminal Appeals, Place 3",,REP,Bert Richardson,444,359,85,0
Ector,302,"Judge, Court of Criminal Appeals, Place 3",,REP,Over Votes,0,0,0,0
Ector,302,"Judge, Court of Criminal Appeals, Place 3",,REP,Under Votes,21,18,3,0
Ector,302,"Judge, Court of Criminal Appeals, Place 3",,DEM,Elizabeth Davis Frizell,187,160,27,0
Ector,302,"Judge, Court of Criminal Appeals, Place 4",,REP,Kevin Patrick Yeary,448,360,88,0
Ector,302,"Judge, Court of Criminal Appeals, Place 4",,REP,Over Votes,0,0,0,0
Ector,302,"Judge, Court of Criminal Appeals, Place 4",,REP,Under Votes,21,18,3,0
Ector,302,"Judge, Court of Criminal Appeals, Place 4",,DEM,Tina Clinton,183,159,24,0
Ector,302,"Judge, Court of Criminal Appeals, Place 9",,REP,David Newell,449,362,87,0
Ector,302,"Judge, Court of Criminal Appeals, Place 9",,REP,Over Votes,0,0,0,0
Ector,302,"Judge, Court of Criminal Appeals, Place 9",,REP,Under Votes,22,19,3,0
Ector,302,"Judge, Court of Criminal Appeals, Place 9",,DEM,Brandon Birmingham,181,156,25,0
Ector,302,"Member, State Board of Education, District 1",,REP,Jennifer Ivey,442,356,86,0
Ector,302,"Member, State Board of Education, District 1",,REP,Over Votes,0,0,0,0
Ector,302,"Member, State Board of Education, District 1",,REP,Under Votes,22,19,3,0
Ector,302,"Member, State Board of Education, District 1",,DEM,Georgina Perez,188,162,26,0
Ector,302,State Representative,81,REP,Brooks Landgraf,548,444,104,0
Ector,302,State Representative,81,REP,Over Votes,0,0,0,0
Ector,302,State Representative,81,REP,Under Votes,104,93,11,0
Ector,302,"Justice, 11th Court of Appeals District, Place 2",,REP,Bruce Williams,522,420,102,0
Ector,302,"Justice, 11th Court of Appeals District, Place 2",,REP,Over Votes,0,0,0,0
Ector,302,"Justice, 11th Court of Appeals District, Place 2",,REP,Under Votes,130,117,13,0
Ector,302,"Justice, 11th Court of Appeals District, Place 3 (Unexpired Term)",,REP,W. Stacy Trotter,530,431,99,0
Ector,302,"Justice, 11th Court of Appeals District, Place 3 (Unexpired Term)",,REP,Over Votes,0,0,0,0
Ector,302,"Justice, 11th Court of Appeals District, Place 3 (Unexpired Term)",,REP,Under Votes,122,106,16,0
Ector,302,"District Judge, 161st Judicial District",,REP,Justin Low,522,422,100,0
Ector,302,"District Judge, 161st Judicial District",,REP,Over Votes,0,0,0,0
Ector,302,"District Judge, 161st Judicial District",,REP,Under Votes,130,115,15,0
Ector,302,"District Judge, 446th Judicial District",,REP,Sara Kate Billingsley,523,427,96,0
Ector,302,"District Judge, 446th Judicial District",,REP,Over Votes,0,0,0,0
Ector,302,"District Judge, 446th Judicial District",,REP,Under Votes,129,110,19,0
Ector,302,"District Attorney, 70th Judicial District",,REP,Dusty Gallivan,528,433,95,0
Ector,302,"District Attorney, 70th Judicial District",,REP,Over Votes,0,0,0,0
Ector,302,"District Attorney, 70th Judicial District",,REP,Under Votes,124,104,20,0
Ector,302,Mayor,,,Dewey Bryant,208,177,31,0
Ector,302,Mayor,,,Over Votes,0,0,0,0
Ector,302,Mayor,,,Under Votes,60,44,16,0
Ector,302,Mayor,,,Javier Joven,275,223,52,0
Ector,302,Mayor,,,Gloria G. Apolinario,109,93,16,0
Ector,302,"Council Member, At-Large",,,David R. Turner,247,191,56,0
Ector,302,"Council Member, At-Large",,,Over Votes,0,0,0,0
Ector,302,"Council Member, At-Large",,,Under Votes,80,63,17,0
Ector,302,"Council Member, At-Large",,,La-Tasha Gentry,68,54,14,0
Ector,302,"Council Member, At-Large",,,Jo Ann Davenport Littleton,86,79,7,0
Ector,302,"Council Member, At-Large",,,Denise Swanner,171,150,21,0
Ector,303,President,,REP,Donald J. Trump / Michael R. Pence,667,512,155,0
Ector,303,President,,REP,Over Votes,0,0,0,0
Ector,303,President,,REP,Under Votes,6,4,2,0
Ector,303,President,,DEM,Joseph R. Biden / Kamala D. Harris,339,279,60,0
Ector,303,President,,LIB,"Jo Jorgensen / Jeremy ""Spike"" Cohen",7,6,1,0
Ector,303,President,,GRN,Howie Hawkins / Angela Walker,4,2,2,0
Ector,303,President,,,President R. Boddie/Eric C. Stoneham,0,0,0,0
Ector,303,President,,,Brian Carroll/Amar Patel,0,0,0,0
Ector,303,President,,,Todd Cella/Tim Cella,0,0,0,0
Ector,303,President,,,Jesse Cuellar/Jimmy Monreal,0,0,0,0
Ector,303,President,,,Tom Hoefling/Andy Prior,0,0,0,0
Ector,303,President,,,Gloria La Riva/Leonard Peltier,0,0,0,0
Ector,303,President,,,Abram Loeb/Jennifer Jairala,0,0,0,0
Ector,303,President,,,Robert Morrow/Anne Beckett,0,0,0,0
Ector,303,President,,,Kasey Wells/Rachel Wells,0,0,0,0
Ector,303,U.S. Senate,,REP,John Cornyn,643,492,151,0
Ector,303,U.S. Senate,,REP,Over Votes,0,0,0,0
Ector,303,U.S. Senate,,REP,Under Votes,42,36,6,0
Ector,303,U.S. Senate,,DEM,"Mary ""MJ"" Hegar",305,250,55,0
Ector,303,U.S. Senate,,LIB,Kerry Douglas McKennon,17,14,3,0
Ector,303,U.S. Senate,,GRN,David B. Collins,16,11,5,0
Ector,303,U.S. Senate,,,Ricardo Turullols-Bonilla,0,0,0,0
Ector,303,U.S. House,11,REP,August Pfluger,648,498,150,0
Ector,303,U.S. House,11,REP,Over Votes,0,0,0,0
Ector,303,U.S. House,11,REP,Under Votes,44,37,7,0
Ector,303,U.S. House,11,DEM,Jon Mark Hogg,307,251,56,0
Ector,303,U.S. House,11,LIB,Wacey Alpha Cody,24,17,7,0
Ector,303,Railroad Commissioner,,REP,"James ""Jim"" Wright",631,492,139,0
Ector,303,Railroad Commissioner,,REP,Over Votes,0,0,0,0
Ector,303,Railroad Commissioner,,REP,Under Votes,43,35,8,0
Ector,303,Railroad Commissioner,,DEM,Chrysta Castañeda,322,260,62,0
Ector,303,Railroad Commissioner,,LIB,Matt Sterett,18,11,7,0
Ector,303,Railroad Commissioner,,GRN,"Katija ""Kat"" Gruene",9,5,4,0
Ector,303,"Chief Justice, Supreme Court",,REP,Nathan Hecht,618,474,144,0
Ector,303,"Chief Justice, Supreme Court",,REP,Over Votes,0,0,0,0
Ector,303,"Chief Justice, Supreme Court",,REP,Under Votes,44,36,8,0
Ector,303,"Chief Justice, Supreme Court",,DEM,Amy Clark Meachum,332,274,58,0
Ector,303,"Chief Justice, Supreme Court",,LIB,Mark Ash,29,19,10,0
Ector,303,"Justice, Supreme Court, Place 6, (Unexpired Term)",,REP,Jane Bland,660,504,156,0
Ector,303,"Justice, Supreme Court, Place 6, (Unexpired Term)",,REP,Over Votes,0,0,0,0
Ector,303,"Justice, Supreme Court, Place 6, (Unexpired Term)",,REP,Under Votes,49,41,8,0
Ector,303,"Justice, Supreme Court, Place 6, (Unexpired Term)",,DEM,Kathy Cheng,314,258,56,0
Ector,303,"Justice, Supreme Court, Place 7",,REP,Jeff Boyd,632,485,147,0
Ector,303,"Justice, Supreme Court, Place 7",,REP,Over Votes,0,0,0,0
Ector,303,"Justice, Supreme Court, Place 7",,REP,Under Votes,50,40,10,0
Ector,303,"Justice, Supreme Court, Place 7",,DEM,Staci Williams,317,261,56,0
Ector,303,"Justice, Supreme Court, Place 7",,LIB,William Bryan Strange III,24,17,7,0
Ector,303,"Justice, Supreme Court, Place 8",,REP,Brett Busby,628,484,144,0
Ector,303,"Justice, Supreme Court, Place 8",,REP,Over Votes,0,0,0,0
Ector,303,"Justice, Supreme Court, Place 8",,REP,Under Votes,52,41,11,0
Ector,303,"Justice, Supreme Court, Place 8",,DEM,Gisela D. Triana,321,262,59,0
Ector,303,"Justice, Supreme Court, Place 8",,LIB,Tom Oxford,22,16,6,0
Ector,303,"Judge, Court of Criminal Appeals, Place 3",,REP,Bert Richardson,637,487,150,0
Ector,303,"Judge, Court of Criminal Appeals, Place 3",,REP,Over Votes,0,0,0,0
Ector,303,"Judge, Court of Criminal Appeals, Place 3",,REP,Under Votes,51,42,9,0
Ector,303,"Judge, Court of Criminal Appeals, Place 3",,DEM,Elizabeth Davis Frizell,335,274,61,0
Ector,303,"Judge, Court of Criminal Appeals, Place 4",,REP,Kevin Patrick Yeary,649,498,151,0
Ector,303,"Judge, Court of Criminal Appeals, Place 4",,REP,Over Votes,0,0,0,0
Ector,303,"Judge, Court of Criminal Appeals, Place 4",,REP,Under Votes,50,41,9,0
Ector,303,"Judge, Court of Criminal Appeals, Place 4",,DEM,Tina Clinton,324,264,60,0
Ector,303,"Judge, Court of Criminal Appeals, Place 9",,REP,David Newell,663,509,154,0
Ector,303,"Judge, Court of Criminal Appeals, Place 9",,REP,Over Votes,0,0,0,0
Ector,303,"Judge, Court of Criminal Appeals, Place 9",,REP,Under Votes,51,41,10,0
Ector,303,"Judge, Court of Criminal Appeals, Place 9",,DEM,Brandon Birmingham,309,253,56,0
Ector,303,"Member, State Board of Education, District 1",,REP,Jennifer Ivey,636,493,143,0
Ector,303,"Member, State Board of Education, District 1",,REP,Over Votes,0,0,0,0
Ector,303,"Member, State Board of Education, District 1",,REP,Under Votes,51,42,9,0
Ector,303,"Member, State Board of Education, District 1",,DEM,Georgina Perez,336,268,68,0
Ector,303,State Representative,81,REP,Brooks Landgraf,802,614,188,0
Ector,303,State Representative,81,REP,Over Votes,0,0,0,0
Ector,303,State Representative,81,REP,Under Votes,221,189,32,0
Ector,303,"Justice, 11th Court of Appeals District, Place 2",,REP,Bruce Williams,770,587,183,0
Ector,303,"Justice, 11th Court of Appeals District, Place 2",,REP,Over Votes,0,0,0,0
Ector,303,"Justice, 11th Court of Appeals District, Place 2",,REP,Under Votes,253,216,37,0
Ector,303,"Justice, 11th Court of Appeals District, Place 3 (Unexpired Term)",,REP,W. Stacy Trotter,767,593,174,0
Ector,303,"Justice, 11th Court of Appeals District, Place 3 (Unexpired Term)",,REP,Over Votes,0,0,0,0
Ector,303,"Justice, 11th Court of Appeals District, Place 3 (Unexpired Term)",,REP,Under Votes,256,210,46,0
Ector,303,"District Judge, 161st Judicial District",,REP,Justin Low,771,590,181,0
Ector,303,"District Judge, 161st Judicial District",,REP,Over Votes,0,0,0,0
Ector,303,"District Judge, 161st Judicial District",,REP,Under Votes,252,213,39,0
Ector,303,"District Judge, 446th Judicial District",,REP,Sara Kate Billingsley,765,589,176,0
Ector,303,"District Judge, 446th Judicial District",,REP,Over Votes,0,0,0,0
Ector,303,"District Judge, 446th Judicial District",,REP,Under Votes,258,214,44,0
Ector,303,"District Attorney, 70th Judicial District",,REP,Dusty Gallivan,773,594,179,0
Ector,303,"District Attorney, 70th Judicial District",,REP,Over Votes,0,0,0,0
Ector,303,"District Attorney, 70th Judicial District",,REP,Under Votes,250,209,41,0
Ector,303,Mayor,,,Dewey Bryant,330,270,60,0
Ector,303,Mayor,,,Over Votes,0,0,0,0
Ector,303,Mayor,,,Under Votes,103,83,20,0
Ector,303,Mayor,,,Javier Joven,408,314,94,0
Ector,303,Mayor,,,Gloria G. Apolinario,182,136,46,0
Ector,303,"Council Member, At-Large",,,David R. Turner,412,319,93,0
Ector,303,"Council Member, At-Large",,,Over Votes,0,0,0,0
Ector,303,"Council Member, At-Large",,,Under Votes,118,94,24,0
Ector,303,"Council Member, At-Large",,,La-Tasha Gentry,132,100,32,0
Ector,303,"Council Member, At-Large",,,Jo Ann Davenport Littleton,137,111,26,0
Ector,303,"Council Member, At-Large",,,Denise Swanner,224,179,45,0
Ector,304,President,,REP,Donald J. Trump / Michael R. Pence,162,119,43,0
Ector,304,President,,REP,Over Votes,0,0,0,0
Ector,304,President,,REP,Under Votes,3,2,1,0
Ector,304,President,,DEM,Joseph R. Biden / Kamala D. Harris,90,62,28,0
Ector,304,President,,LIB,"Jo Jorgensen / Jeremy ""Spike"" Cohen",5,5,0,0
Ector,304,President,,GRN,Howie Hawkins / Angela Walker,0,0,0,0
Ector,304,President,,,President R. Boddie/Eric C. Stoneham,0,0,0,0
Ector,304,President,,,Brian Carroll/Amar Patel,0,0,0,0
Ector,304,President,,,Todd Cella/Tim Cella,0,0,0,0
Ector,304,President,,,Jesse Cuellar/Jimmy Monreal,0,0,0,0
Ector,304,President,,,Tom Hoefling/Andy Prior,0,0,0,0
Ector,304,President,,,Gloria La Riva/Leonard Peltier,0,0,0,0
Ector,304,President,,,Abram Loeb/Jennifer Jairala,0,0,0,0
Ector,304,President,,,Robert Morrow/Anne Beckett,0,0,0,0
Ector,304,President,,,Kasey Wells/Rachel Wells,0,0,0,0
Ector,304,U.S. Senate,,REP,John Cornyn,151,111,40,0
Ector,304,U.S. Senate,,REP,Over Votes,0,0,0,0
Ector,304,U.S. Senate,,REP,Under Votes,17,14,3,0
Ector,304,U.S. Senate,,DEM,"Mary ""MJ"" Hegar",84,58,26,0
Ector,304,U.S. Senate,,LIB,Kerry Douglas McKennon,7,4,3,0
Ector,304,U.S. Senate,,GRN,David B. Collins,1,1,0,0
Ector,304,U.S. Senate,,,Ricardo Turullols-Bonilla,0,0,0,0
Ector,304,U.S. House,11,REP,August Pfluger,149,110,39,0
Ector,304,U.S. House,11,REP,Over Votes,0,0,0,0
Ector,304,U.S. House,11,REP,Under Votes,19,14,5,0
Ector,304,U.S. House,11,DEM,Jon Mark Hogg,84,58,26,0
Ector,304,U.S. House,11,LIB,Wacey Alpha Cody,8,6,2,0
Ector,304,Railroad Commissioner,,REP,"James ""Jim"" Wright",141,105,36,0
Ector,304,Railroad Commissioner,,REP,Over Votes,0,0,0,0
Ector,304,Railroad Commissioner,,REP,Under Votes,18,14,4,0
Ector,304,Railroad Commissioner,,DEM,Chrysta Castañeda,93,64,29,0
Ector,304,Railroad Commissioner,,LIB,Matt Sterett,7,4,3,0
Ector,304,Railroad Commissioner,,GRN,"Katija ""Kat"" Gruene",1,1,0,0
Ector,304,"Chief Justice, Supreme Court",,REP,Nathan Hecht,145,108,37,0
Ector,304,"Chief Justice, Supreme Court",,REP,Over Votes,0,0,0,0
Ector,304,"Chief Justice, Supreme Court",,REP,Under Votes,17,13,4,0
Ector,304,"Chief Justice, Supreme Court",,DEM,Amy Clark Meachum,89,61,28,0
Ector,304,"Chief Justice, Supreme Court",,LIB,Mark Ash,9,6,3,0
Ector,304,"Justice, Supreme Court, Place 6, (Unexpired Term)",,REP,Jane Bland,155,115,40,0
Ector,304,"Justice, Supreme Court, Place 6, (Unexpired Term)",,REP,Over Votes,0,0,0,0
Ector,304,"Justice, Supreme Court, Place 6, (Unexpired Term)",,REP,Under Votes,18,13,5,0
Ector,304,"Justice, Supreme Court, Place 6, (Unexpired Term)",,DEM,Kathy Cheng,87,60,27,0
Ector,304,"Justice, Supreme Court, Place 7",,REP,Jeff Boyd,148,110,38,0
Ector,304,"Justice, Supreme Court, Place 7",,REP,Over Votes,0,0,0,0
Ector,304,"Justice, Supreme Court, Place 7",,REP,Under Votes,18,13,5,0
Ector,304,"Justice, Supreme Court, Place 7",,DEM,Staci Williams,86,61,25,0
Ector,304,"Justice, Supreme Court, Place 7",,LIB,William Bryan Strange III,8,4,4,0
Ector,304,"Justice, Supreme Court, Place 8",,REP,Brett Busby,145,109,36,0
Ector,304,"Justice, Supreme Court, Place 8",,REP,Over Votes,0,0,0,0
Ector,304,"Justice, Supreme Court, Place 8",,REP,Under Votes,19,14,5,0
Ector,304,"Justice, Supreme Court, Place 8",,DEM,Gisela D. Triana,90,61,29,0
Ector,304,"Justice, Supreme Court, Place 8",,LIB,Tom Oxford,6,4,2,0
Ector,304,"Judge, Court of Criminal Appeals, Place 3",,REP,Bert Richardson,153,113,40,0
Ector,304,"Judge, Court of Criminal Appeals, Place 3",,REP,Over Votes,0,0,0,0
Ector,304,"Judge, Court of Criminal Appeals, Place 3",,REP,Under Votes,19,13,6,0
Ector,304,"Judge, Court of Criminal Appeals, Place 3",,DEM,Elizabeth Davis Frizell,88,62,26,0
Ector,304,"Judge, Court of Criminal Appeals, Place 4",,REP,Kevin Patrick Yeary,153,113,40,0
Ector,304,"Judge, Court of Criminal Appeals, Place 4",,REP,Over Votes,0,0,0,0
Ector,304,"Judge, Court of Criminal Appeals, Place 4",,REP,Under Votes,20,14,6,0
Ector,304,"Judge, Court of Criminal Appeals, Place 4",,DEM,Tina Clinton,87,61,26,0
Ector,304,"Judge, Court of Criminal Appeals, Place 9",,REP,David Newell,154,111,43,0
Ector,304,"Judge, Court of Criminal Appeals, Place 9",,REP,Over Votes,0,0,0,0
Ector,304,"Judge, Court of Criminal Appeals, Place 9",,REP,Under Votes,20,14,6,0
Ector,304,"Judge, Court of Criminal Appeals, Place 9",,DEM,Brandon Birmingham,86,63,23,0
Ector,304,"Member, State Board of Education, District 1",,REP,Jennifer Ivey,148,109,39,0
Ector,304,"Member, State Board of Education, District 1",,REP,Over Votes,0,0,0,0
Ector,304,"Member, State Board of Education, District 1",,REP,Under Votes,20,14,6,0
Ector,304,"Member, State Board of Education, District 1",,DEM,Georgina Perez,92,65,27,0
Ector,304,State Representative,81,REP,Brooks Landgraf,187,133,54,0
Ector,304,State Representative,81,REP,Over Votes,0,0,0,0
Ector,304,State Representative,81,REP,Under Votes,73,55,18,0
Ector,304,"Justice, 11th Court of Appeals District, Place 2",,REP,Bruce Williams,181,129,52,0
Ector,304,"Justice, 11th Court of Appeals District, Place 2",,REP,Over Votes,0,0,0,0
Ector,304,"Justice, 11th Court of Appeals District, Place 2",,REP,Under Votes,79,59,20,0
Ector,304,"Justice, 11th Court of Appeals District, Place 3 (Unexpired Term)",,REP,W. Stacy Trotter,182,128,54,0
Ector,304,"Justice, 11th Court of Appeals District, Place 3 (Unexpired Term)",,REP,Over Votes,0,0,0,0
Ector,304,"Justice, 11th Court of Appeals District, Place 3 (Unexpired Term)",,REP,Under Votes,78,60,18,0
Ector,304,"District Judge, 161st Judicial District",,REP,Justin Low,179,126,53,0
Ector,304,"District Judge, 161st Judicial District",,REP,Over Votes,0,0,0,0
Ector,304,"District Judge, 161st Judicial District",,REP,Under Votes,81,62,19,0
Ector,304,"District Judge, 446th Judicial District",,REP,Sara Kate Billingsley,180,128,52,0
Ector,304,"District Judge, 446th Judicial District",,REP,Over Votes,0,0,0,0
Ector,304,"District Judge, 446th Judicial District",,REP,Under Votes,80,60,20,0
Ector,304,"District Attorney, 70th Judicial District",,REP,Dusty Gallivan,182,127,55,0
Ector,304,"District Attorney, 70th Judicial District",,REP,Over Votes,0,0,0,0
Ector,304,"District Attorney, 70th Judicial District",,REP,Under Votes,78,61,17,0
Ector,304,Mayor,,,Dewey Bryant,75,59,16,0
Ector,304,Mayor,,,Over Votes,0,0,0,0
Ector,304,Mayor,,,Under Votes,43,31,12,0
Ector,304,Mayor,,,Javier Joven,95,66,29,0
Ector,304,Mayor,,,Gloria G. Apolinario,47,32,15,0
Ector,304,"Council Member, At-Large",,,David R. Turner,107,80,27,0
Ector,304,"Council Member, At-Large",,,Over Votes,0,0,0,0
Ector,304,"Council Member, At-Large",,,Under Votes,44,29,15,0
Ector,304,"Council Member, At-Large",,,La-Tasha Gentry,25,19,6,0
Ector,304,"Council Member, At-Large",,,Jo Ann Davenport Littleton,54,40,14,0
Ector,304,"Council Member, At-Large",,,Denise Swanner,30,20,10,0
Ector,305,President,,REP,Donald J. Trump / Michael R. Pence,182,146,36,0
Ector,305,President,,REP,Over Votes,0,0,0,0
Ector,305,President,,REP,Under Votes,2,2,0,0
Ector,305,President,,DEM,Joseph R. Biden / Kamala D. Harris,125,92,33,0
Ector,305,President,,LIB,"Jo Jorgensen / Jeremy ""Spike"" Cohen",1,1,0,0
Ector,305,President,,GRN,Howie Hawkins / Angela Walker,1,0,1,0
Ector,305,President,,,President R. Boddie/Eric C. Stoneham,0,0,0,0
Ector,305,President,,,Brian Carroll/Amar Patel,1,0,1,0
Ector,305,President,,,Todd Cella/Tim Cella,0,0,0,0
Ector,305,President,,,Jesse Cuellar/Jimmy Monreal,0,0,0,0
Ector,305,President,,,Tom Hoefling/Andy Prior,0,0,0,0
Ector,305,President,,,Gloria La Riva/Leonard Peltier,0,0,0,0
Ector,305,President,,,Abram Loeb/Jennifer Jairala,0,0,0,0
Ector,305,President,,,Robert Morrow/Anne Beckett,0,0,0,0
Ector,305,President,,,Kasey Wells/Rachel Wells,0,0,0,0
Ector,305,U.S. Senate,,REP,John Cornyn,162,127,35,0
Ector,305,U.S. Senate,,REP,Over Votes,0,0,0,0
Ector,305,U.S. Senate,,REP,Under Votes,25,21,4,0
Ector,305,U.S. Senate,,DEM,"Mary ""MJ"" Hegar",113,84,29,0
Ector,305,U.S. Senate,,LIB,Kerry Douglas McKennon,8,7,1,0
Ector,305,U.S. Senate,,GRN,David B. Collins,4,2,2,0
Ector,305,U.S. Senate,,,Ricardo Turullols-Bonilla,0,0,0,0
Ector,305,U.S. House,11,REP,August Pfluger,162,128,34,0
Ector,305,U.S. House,11,REP,Over Votes,0,0,0,0
Ector,305,U.S. House,11,REP,Under Votes,25,19,6,0
Ector,305,U.S. House,11,DEM,Jon Mark Hogg,115,86,29,0
Ector,305,U.S. House,11,LIB,Wacey Alpha Cody,10,8,2,0
Ector,305,Railroad Commissioner,,REP,"James ""Jim"" Wright",162,130,32,0
Ector,305,Railroad Commissioner,,REP,Over Votes,0,0,0,0
Ector,305,Railroad Commissioner,,REP,Under Votes,24,18,6,0
Ector,305,Railroad Commissioner,,DEM,Chrysta Castañeda,114,83,31,0
Ector,305,Railroad Commissioner,,LIB,Matt Sterett,5,5,0,0
Ector,305,Railroad Commissioner,,GRN,"Katija ""Kat"" Gruene",7,5,2,0
Ector,305,"Chief Justice, Supreme Court",,REP,Nathan Hecht,161,129,32,0
Ector,305,"Chief Justice, Supreme Court",,REP,Over Votes,0,0,0,0
Ector,305,"Chief Justice, Supreme Court",,REP,Under Votes,25,19,6,0
Ector,305,"Chief Justice, Supreme Court",,DEM,Amy Clark Meachum,121,91,30,0
Ector,305,"Chief Justice, Supreme Court",,LIB,Mark Ash,5,2,3,0
Ector,305,"Justice, Supreme Court, Place 6, (Unexpired Term)",,REP,Jane Bland,163,129,34,0
Ector,305,"Justice, Supreme Court, Place 6, (Unexpired Term)",,REP,Over Votes,0,0,0,0
Ector,305,"Justice, Supreme Court, Place 6, (Unexpired Term)",,REP,Under Votes,27,21,6,0
Ector,305,"Justice, Supreme Court, Place 6, (Unexpired Term)",,DEM,Kathy Cheng,122,91,31,0
Ector,305,"Justice, Supreme Court, Place 7",,REP,Jeff Boyd,160,126,34,0
Ector,305,"Justice, Supreme Court, Place 7",,REP,Over Votes,0,0,0,0
Ector,305,"Justice, Supreme Court, Place 7",,REP,Under Votes,26,19,7,0
Ector,305,"Justice, Supreme Court, Place 7",,DEM,Staci Williams,121,94,27,0
Ector,305,"Justice, Supreme Court, Place 7",,LIB,William Bryan Strange III,5,2,3,0
Ector,305,"Justice, Supreme Court, Place 8",,REP,Brett Busby,164,130,34,0
Ector,305,"Justice, Supreme Court, Place 8",,REP,Over Votes,0,0,0,0
Ector,305,"Justice, Supreme Court, Place 8",,REP,Under Votes,28,20,8,0
Ector,305,"Justice, Supreme Court, Place 8",,DEM,Gisela D. Triana,115,88,27,0
Ector,305,"Justice, Supreme Court, Place 8",,LIB,Tom Oxford,5,3,2,0
Ector,305,"Judge, Court of Criminal Appeals, Place 3",,REP,Bert Richardson,162,129,33,0
Ector,305,"Judge, Court of Criminal Appeals, Place 3",,REP,Over Votes,0,0,0,0
Ector,305,"Judge, Court of Criminal Appeals, Place 3",,REP,Under Votes,25,17,8,0
Ector,305,"Judge, Court of Criminal Appeals, Place 3",,DEM,Elizabeth Davis Frizell,125,95,30,0
Ector,305,"Judge, Court of Criminal Appeals, Place 4",,REP,Kevin Patrick Yeary,165,132,33,0
Ector,305,"Judge, Court of Criminal Appeals, Place 4",,REP,Over Votes,0,0,0,0
Ector,305,"Judge, Court of Criminal Appeals, Place 4",,REP,Under Votes,26,17,9,0
Ector,305,"Judge, Court of Criminal Appeals, Place 4",,DEM,Tina Clinton,121,92,29,0
Ector,305,"Judge, Court of Criminal Appeals, Place 9",,REP,David Newell,168,135,33,0
Ector,305,"Judge, Court of Criminal Appeals, Place 9",,REP,Over Votes,0,0,0,0
Ector,305,"Judge, Court of Criminal Appeals, Place 9",,REP,Under Votes,27,19,8,0
Ector,305,"Judge, Court of Criminal Appeals, Place 9",,DEM,Brandon Birmingham,117,87,30,0
Ector,305,"Member, State Board of Education, District 1",,REP,Jennifer Ivey,159,127,32,0
Ector,305,"Member, State Board of Education, District 1",,REP,Over Votes,0,0,0,0
Ector,305,"Member, State Board of Education, District 1",,REP,Under Votes,26,18,8,0
Ector,305,"Member, State Board of Education, District 1",,DEM,Georgina Perez,127,96,31,0
Ector,305,State Representative,81,REP,Brooks Landgraf,218,177,41,0
Ector,305,State Representative,81,REP,Over Votes,0,0,0,0
Ector,305,State Representative,81,REP,Under Votes,94,64,30,0
Ector,305,"Justice, 11th Court of Appeals District, Place 2",,REP,Bruce Williams,213,171,42,0
Ector,305,"Justice, 11th Court of Appeals District, Place 2",,REP,Over Votes,0,0,0,0
Ector,305,"Justice, 11th Court of Appeals District, Place 2",,REP,Under Votes,99,70,29,0
Ector,305,"Justice, 11th Court of Appeals District, Place 3 (Unexpired Term)",,REP,W. Stacy Trotter,213,172,41,0
Ector,305,"Justice, 11th Court of Appeals District, Place 3 (Unexpired Term)",,REP,Over Votes,0,0,0,0
Ector,305,"Justice, 11th Court of Appeals District, Place 3 (Unexpired Term)",,REP,Under Votes,99,69,30,0
Ector,305,"District Judge, 161st Judicial District",,REP,Justin Low,217,175,42,0
Ector,305,"District Judge, 161st Judicial District",,REP,Over Votes,0,0,0,0
Ector,305,"District Judge, 161st Judicial District",,REP,Under Votes,95,66,29,0
Ector,305,"District Judge, 446th Judicial District",,REP,Sara Kate Billingsley,214,174,40,0
Ector,305,"District Judge, 446th Judicial District",,REP,Over Votes,0,0,0,0
Ector,305,"District Judge, 446th Judicial District",,REP,Under Votes,98,67,31,0
Ector,305,"District Attorney, 70th Judicial District",,REP,Dusty Gallivan,213,173,40,0
Ector,305,"District Attorney, 70th Judicial District",,REP,Over Votes,0,0,0,0
Ector,305,"District Attorney, 70th Judicial District",,REP,Under Votes,99,68,31,0
Ector,305,Mayor,,,Dewey Bryant,67,50,17,0
Ector,305,Mayor,,,Over Votes,0,0,0,0
Ector,305,Mayor,,,Under Votes,55,41,14,0
Ector,305,Mayor,,,Javier Joven,125,99,26,0
Ector,305,Mayor,,,Gloria G. Apolinario,65,51,14,0
Ector,305,"Council Member, At-Large",,,David R. Turner,122,97,25,0
Ector,305,"Council Member, At-Large",,,Over Votes,0,0,0,0
Ector,305,"Council Member, At-Large",,,Under Votes,58,43,15,0
Ector,305,"Council Member, At-Large",,,La-Tasha Gentry,45,32,13,0
Ector,305,"Council Member, At-Large",,,Jo Ann Davenport Littleton,44,36,8,0
Ector,305,"Council Member, At-Large",,,Denise Swanner,43,33,10,0
Ector,306,President,,REP,Donald J. Trump / Michael R. Pence,365,268,97,0
Ector,306,President,,REP,Over Votes,0,0,0,0
Ector,306,President,,REP,Under Votes,6,5,1,0
Ector,306,President,,DEM,Joseph R. Biden / Kamala D. Harris,232,173,59,0
Ector,306,President,,LIB,"Jo Jorgensen / Jeremy ""Spike"" Cohen",1,1,0,0
Ector,306,President,,GRN,Howie Hawkins / Angela Walker,2,2,0,0
Ector,306,President,,,President R. Boddie/Eric C. Stoneham,0,0,0,0
Ector,306,President,,,Brian Carroll/Amar Patel,0,0,0,0
Ector,306,President,,,Todd Cella/Tim Cella,0,0,0,0
Ector,306,President,,,Jesse Cuellar/Jimmy Monreal,0,0,0,0
Ector,306,President,,,Tom Hoefling/Andy Prior,0,0,0,0
Ector,306,President,,,Gloria La Riva/Leonard Peltier,0,0,0,0
Ector,306,President,,,Abram Loeb/Jennifer Jairala,0,0,0,0
Ector,306,President,,,Robert Morrow/Anne Beckett,0,0,0,0
Ector,306,President,,,Kasey Wells/Rachel Wells,0,0,0,0
Ector,306,U.S. Senate,,REP,John Cornyn,340,257,83,0
Ector,306,U.S. Senate,,REP,Over Votes,0,0,0,0
Ector,306,U.S. Senate,,REP,Under Votes,29,19,10,0
Ector,306,U.S. Senate,,DEM,"Mary ""MJ"" Hegar",213,155,58,0
Ector,306,U.S. Senate,,LIB,Kerry Douglas McKennon,15,12,3,0
Ector,306,U.S. Senate,,GRN,David B. Collins,9,6,3,0
Ector,306,U.S. Senate,,,Ricardo Turullols-Bonilla,0,0,0,0
Ector,306,U.S. House,11,REP,August Pfluger,337,252,85,0
Ector,306,U.S. House,11,REP,Over Votes,0,0,0,0
Ector,306,U.S. House,11,REP,Under Votes,32,21,11,0
Ector,306,U.S. House,11,DEM,Jon Mark Hogg,219,162,57,0
Ector,306,U.S. House,11,LIB,Wacey Alpha Cody,18,14,4,0
Ector,306,Railroad Commissioner,,REP,"James ""Jim"" Wright",336,254,82,0
Ector,306,Railroad Commissioner,,REP,Over Votes,0,0,0,0
Ector,306,Railroad Commissioner,,REP,Under Votes,33,21,12,0
Ector,306,Railroad Commissioner,,DEM,Chrysta Castañeda,215,156,59,0
Ector,306,Railroad Commissioner,,LIB,Matt Sterett,16,15,1,0
Ector,306,Railroad Commissioner,,GRN,"Katija ""Kat"" Gruene",6,3,3,0
Ector,306,"Chief Justice, Supreme Court",,REP,Nathan Hecht,328,248,80,0
Ector,306,"Chief Justice, Supreme Court",,REP,Over Votes,0,0,0,0
Ector,306,"Chief Justice, Supreme Court",,REP,Under Votes,34,23,11,0
Ector,306,"Chief Justice, Supreme Court",,DEM,Amy Clark Meachum,228,165,63,0
Ector,306,"Chief Justice, Supreme Court",,LIB,Mark Ash,16,13,3,0
Ector,306,"Justice, Supreme Court, Place 6, (Unexpired Term)",,REP,Jane Bland,347,258,89,0
Ector,306,"Justice, Supreme Court, Place 6, (Unexpired Term)",,REP,Over Votes,0,0,0,0
Ector,306,"Justice, Supreme Court, Place 6, (Unexpired Term)",,REP,Under Votes,32,23,9,0
Ector,306,"Justice, Supreme Court, Place 6, (Unexpired Term)",,DEM,Kathy Cheng,227,168,59,0
Ector,306,"Justice, Supreme Court, Place 7",,REP,Jeff Boyd,329,247,82,0
Ector,306,"Justice, Supreme Court, Place 7",,REP,Over Votes,0,0,0,0
Ector,306,"Justice, Supreme Court, Place 7",,REP,Under Votes,38,25,13,0
Ector,306,"Justice, Supreme Court, Place 7",,DEM,Staci Williams,223,164,59,0
Ector,306,"Justice, Supreme Court, Place 7",,LIB,William Bryan Strange III,16,13,3,0
Ector,306,"Justice, Supreme Court, Place 8",,REP,Brett Busby,330,247,83,0
Ector,306,"Justice, Supreme Court, Place 8",,REP,Over Votes,0,0,0,0
Ector,306,"Justice, Supreme Court, Place 8",,REP,Under Votes,40,27,13,0
Ector,306,"Justice, Supreme Court, Place 8",,DEM,Gisela D. Triana,224,167,57,0
Ector,306,"Justice, Supreme Court, Place 8",,LIB,Tom Oxford,12,8,4,0
Ector,306,"Judge, Court of Criminal Appeals, Place 3",,REP,Bert Richardson,334,252,82,0
Ector,306,"Judge, Court of Criminal Appeals, Place 3",,REP,Over Votes,0,0,0,0
Ector,306,"Judge, Court of Criminal Appeals, Place 3",,REP,Under Votes,37,25,12,0
Ector,306,"Judge, Court of Criminal Appeals, Place 3",,DEM,Elizabeth Davis Frizell,235,172,63,0
Ector,306,"Judge, Court of Criminal Appeals, Place 4",,REP,Kevin Patrick Yeary,340,258,82,0
Ector,306,"Judge, Court of Criminal Appeals, Place 4",,REP,Over Votes,0,0,0,0
Ector,306,"Judge, Court of Criminal Appeals, Place 4",,REP,Under Votes,38,27,11,0
Ector,306,"Judge, Court of Criminal Appeals, Place 4",,DEM,Tina Clinton,228,164,64,0
Ector,306,"Judge, Court of Criminal Appeals, Place 9",,REP,David Newell,333,251,82,0
Ector,306,"Judge, Court of Criminal Appeals, Place 9",,REP,Over Votes,0,0,0,0
Ector,306,"Judge, Court of Criminal Appeals, Place 9",,REP,Under Votes,38,25,13,0
Ector,306,"Judge, Court of Criminal Appeals, Place 9",,DEM,Brandon Birmingham,235,173,62,0
Ector,306,"Member, State Board of Education, District 1",,REP,Jennifer Ivey,337,252,85,0
Ector,306,"Member, State Board of Education, District 1",,REP,Over Votes,0,0,0,0
Ector,306,"Member, State Board of Education, District 1",,REP,Under Votes,37,26,11,0
Ector,306,"Member, State Board of Education, District 1",,DEM,Georgina Perez,232,171,61,0
Ector,306,State Representative,81,REP,Brooks Landgraf,472,347,125,0
Ector,306,State Representative,81,REP,Over Votes,0,0,0,0
Ector,306,State Representative,81,REP,Under Votes,134,102,32,0
Ector,306,"Justice, 11th Court of Appeals District, Place 2",,REP,Bruce Williams,454,335,119,0
Ector,306,"Justice, 11th Court of Appeals District, Place 2",,REP,Over Votes,0,0,0,0
Ector,306,"Justice, 11th Court of Appeals District, Place 2",,REP,Under Votes,152,114,38,0
Ector,306,"Justice, 11th Court of Appeals District, Place 3 (Unexpired Term)",,REP,W. Stacy Trotter,448,329,119,0
Ector,306,"Justice, 11th Court of Appeals District, Place 3 (Unexpired Term)",,REP,Over Votes,0,0,0,0
Ector,306,"Justice, 11th Court of Appeals District, Place 3 (Unexpired Term)",,REP,Under Votes,158,120,38,0
Ector,306,"District Judge, 161st Judicial District",,REP,Justin Low,450,328,122,0
Ector,306,"District Judge, 161st Judicial District",,REP,Over Votes,0,0,0,0
Ector,306,"District Judge, 161st Judicial District",,REP,Under Votes,156,121,35,0
Ector,306,"District Judge, 446th Judicial District",,REP,Sara Kate Billingsley,447,329,118,0
Ector,306,"District Judge, 446th Judicial District",,REP,Over Votes,0,0,0,0
Ector,306,"District Judge, 446th Judicial District",,REP,Under Votes,159,120,39,0
Ector,306,"District Attorney, 70th Judicial District",,REP,Dusty Gallivan,452,332,120,0
Ector,306,"District Attorney, 70th Judicial District",,REP,Over Votes,0,0,0,0
Ector,306,"District Attorney, 70th Judicial District",,REP,Under Votes,154,117,37,0
Ector,306,Mayor,,,Dewey Bryant,184,139,45,0
Ector,306,Mayor,,,Over Votes,0,0,0,0
Ector,306,Mayor,,,Under Votes,86,66,20,0
Ector,306,Mayor,,,Javier Joven,223,165,58,0
Ector,306,Mayor,,,Gloria G. Apolinario,113,79,34,0
Ector,306,"Council Member, At-Large",,,David R. Turner,255,193,62,0
Ector,306,"Council Member, At-Large",,,Over Votes,0,0,0,0
Ector,306,"Council Member, At-Large",,,Under Votes,89,63,26,0
Ector,306,"Council Member, At-Large",,,La-Tasha Gentry,78,58,20,0
Ector,306,"Council Member, At-Large",,,Jo Ann Davenport Littleton,79,59,20,0
Ector,306,"Council Member, At-Large",,,Denise Swanner,105,76,29,0
Ector,307,President,,REP,Donald J. Trump / Michael R. Pence,782,609,173,0
Ector,307,President,,REP,Over Votes,0,0,0,0
Ector,307,President,,REP,Under Votes,9,8,1,0
Ector,307,President,,DEM,Joseph R. Biden / Kamala D. Harris,420,338,82,0
Ector,307,President,,LIB,"Jo Jorgensen / Jeremy ""Spike"" Cohen",15,12,3,0
Ector,307,President,,GRN,Howie Hawkins / Angela Walker,1,1,0,0
Ector,307,President,,,President R. Boddie/Eric C. Stoneham,0,0,0,0
Ector,307,President,,,Brian Carroll/Amar Patel,0,0,0,0
Ector,307,President,,,Todd Cella/Tim Cella,0,0,0,0
Ector,307,President,,,Jesse Cuellar/Jimmy Monreal,0,0,0,0
Ector,307,President,,,Tom Hoefling/Andy Prior,0,0,0,0
Ector,307,President,,,Gloria La Riva/Leonard Peltier,0,0,0,0
Ector,307,President,,,Abram Loeb/Jennifer Jairala,0,0,0,0
Ector,307,President,,,Robert Morrow/Anne Beckett,0,0,0,0
Ector,307,President,,,Kasey Wells/Rachel Wells,0,0,0,0
Ector,307,U.S. Senate,,REP,John Cornyn,740,582,158,0
Ector,307,U.S. Senate,,REP,Over Votes,0,0,0,0
Ector,307,U.S. Senate,,REP,Under Votes,51,40,11,0
Ector,307,U.S. Senate,,DEM,"Mary ""MJ"" Hegar",404,323,81,0
Ector,307,U.S. Senate,,LIB,Kerry Douglas McKennon,25,16,9,0
Ector,307,U.S. Senate,,GRN,David B. Collins,7,7,0,0
Ector,307,U.S. Senate,,,Ricardo Turullols-Bonilla,0,0,0,0
Ector,307,U.S. House,11,REP,August Pfluger,748,589,159,0
Ector,307,U.S. House,11,REP,Over Votes,0,0,0,0
Ector,307,U.S. House,11,REP,Under Votes,54,44,10,0
Ector,307,U.S. House,11,DEM,Jon Mark Hogg,399,317,82,0
Ector,307,U.S. House,11,LIB,Wacey Alpha Cody,26,18,8,0
Ector,307,Railroad Commissioner,,REP,"James ""Jim"" Wright",738,583,155,0
Ector,307,Railroad Commissioner,,REP,Over Votes,0,0,0,0
Ector,307,Railroad Commissioner,,REP,Under Votes,50,37,13,0
Ector,307,Railroad Commissioner,,DEM,Chrysta Castañeda,398,321,77,0
Ector,307,Railroad Commissioner,,LIB,Matt Sterett,24,15,9,0
Ector,307,Railroad Commissioner,,GRN,"Katija ""Kat"" Gruene",17,12,5,0
Ector,307,"Chief Justice, Supreme Court",,REP,Nathan Hecht,721,569,152,0
Ector,307,"Chief Justice, Supreme Court",,REP,Over Votes,0,0,0,0
Ector,307,"Chief Justice, Supreme Court",,REP,Under Votes,54,41,13,0
Ector,307,"Chief Justice, Supreme Court",,DEM,Amy Clark Meachum,411,327,84,0
Ector,307,"Chief Justice, Supreme Court",,LIB,Mark Ash,41,31,10,0
Ector,307,"Justice, Supreme Court, Place 6, (Unexpired Term)",,REP,Jane Bland,752,590,162,0
Ector,307,"Justice, Supreme Court, Place 6, (Unexpired Term)",,REP,Over Votes,0,0,0,0
Ector,307,"Justice, Supreme Court, Place 6, (Unexpired Term)",,REP,Under Votes,59,47,12,0
Ector,307,"Justice, Supreme Court, Place 6, (Unexpired Term)",,DEM,Kathy Cheng,416,331,85,0
Ector,307,"Justice, Supreme Court, Place 7",,REP,Jeff Boyd,729,576,153,0
Ector,307,"Justice, Supreme Court, Place 7",,REP,Over Votes,0,0,0,0
Ector,307,"Justice, Supreme Court, Place 7",,REP,Under Votes,62,47,15,0
Ector,307,"Justice, Supreme Court, Place 7",,DEM,Staci Williams,408,324,84,0
Ector,307,"Justice, Supreme Court, Place 7",,LIB,William Bryan Strange III,28,21,7,0
Ector,307,"Justice, Supreme Court, Place 8",,REP,Brett Busby,721,571,150,0
Ector,307,"Justice, Supreme Court, Place 8",,REP,Over Votes,0,0,0,0
Ector,307,"Justice, Supreme Court, Place 8",,REP,Under Votes,61,47,14,0
Ector,307,"Justice, Supreme Court, Place 8",,DEM,Gisela D. Triana,418,331,87,0
Ector,307,"Justice, Supreme Court, Place 8",,LIB,Tom Oxford,27,19,8,0
Ector,307,"Judge, Court of Criminal Appeals, Place 3",,REP,Bert Richardson,734,580,154,0
Ector,307,"Judge, Court of Criminal Appeals, Place 3",,REP,Over Votes,0,0,0,0
Ector,307,"Judge, Court of Criminal Appeals, Place 3",,REP,Under Votes,62,47,15,0
Ector,307,"Judge, Court of Criminal Appeals, Place 3",,DEM,Elizabeth Davis Frizell,431,341,90,0
Ector,307,"Judge, Court of Criminal Appeals, Place 4",,REP,Kevin Patrick Yeary,745,587,158,0
Ector,307,"Judge, Court of Criminal Appeals, Place 4",,REP,Over Votes,0,0,0,0
Ector,307,"Judge, Court of Criminal Appeals, Place 4",,REP,Under Votes,59,45,14,0
Ector,307,"Judge, Court of Criminal Appeals, Place 4",,DEM,Tina Clinton,423,336,87,0
Ector,307,"Judge, Court of Criminal Appeals, Place 9",,REP,David Newell,742,584,158,0
Ector,307,"Judge, Court of Criminal Appeals, Place 9",,REP,Over Votes,0,0,0,0
Ector,307,"Judge, Court of Criminal Appeals, Place 9",,REP,Under Votes,64,50,14,0
Ector,307,"Judge, Court of Criminal Appeals, Place 9",,DEM,Brandon Birmingham,421,334,87,0
Ector,307,"Member, State Board of Education, District 1",,REP,Jennifer Ivey,740,579,161,0
Ector,307,"Member, State Board of Education, District 1",,REP,Over Votes,0,0,0,0
Ector,307,"Member, State Board of Education, District 1",,REP,Under Votes,62,49,13,0
Ector,307,"Member, State Board of Education, District 1",,DEM,Georgina Perez,425,340,85,0
Ector,307,State Representative,81,REP,Brooks Landgraf,954,732,222,0
Ector,307,State Representative,81,REP,Over Votes,0,0,0,0
Ector,307,State Representative,81,REP,Under Votes,273,236,37,0
Ector,307,"Justice, 11th Court of Appeals District, Place 2",,REP,Bruce Williams,925,712,213,0
Ector,307,"Justice, 11th Court of Appeals District, Place 2",,REP,Over Votes,0,0,0,0
Ector,307,"Justice, 11th Court of Appeals District, Place 2",,REP,Under Votes,302,256,46,0
Ector,307,"Justice, 11th Court of Appeals District, Place 3 (Unexpired Term)",,REP,W. Stacy Trotter,929,711,218,0
Ector,307,"Justice, 11th Court of Appeals District, Place 3 (Unexpired Term)",,REP,Over Votes,0,0,0,0
Ector,307,"Justice, 11th Court of Appeals District, Place 3 (Unexpired Term)",,REP,Under Votes,298,257,41,0
Ector,307,"District Judge, 161st Judicial District",,REP,Justin Low,911,699,212,0
Ector,307,"District Judge, 161st Judicial District",,REP,Over Votes,0,0,0,0
Ector,307,"District Judge, 161st Judicial District",,REP,Under Votes,316,269,47,0
Ector,307,"District Judge, 446th Judicial District",,REP,Sara Kate Billingsley,928,711,217,0
Ector,307,"District Judge, 446th Judicial District",,REP,Over Votes,0,0,0,0
Ector,307,"District Judge, 446th Judicial District",,REP,Under Votes,299,257,42,0
Ector,307,"District Attorney, 70th Judicial District",,REP,Dusty Gallivan,936,722,214,0
Ector,307,"District Attorney, 70th Judicial District",,REP,Over Votes,0,0,0,0
Ector,307,"District Attorney, 70th Judicial District",,REP,Under Votes,291,246,45,0
Ector,307,Mayor,,,Dewey Bryant,369,286,83,0
Ector,307,Mayor,,,Over Votes,0,0,0,0
Ector,307,Mayor,,,Under Votes,137,107,30,0
Ector,307,Mayor,,,Javier Joven,461,365,96,0
Ector,307,Mayor,,,Gloria G. Apolinario,260,210,50,0
Ector,307,"Council Member, At-Large",,,David R. Turner,460,345,115,0
Ector,307,"Council Member, At-Large",,,Over Votes,0,0,0,0
Ector,307,"Council Member, At-Large",,,Under Votes,159,132,27,0
Ector,307,"Council Member, At-Large",,,La-Tasha Gentry,195,162,33,0
Ector,307,"Council Member, At-Large",,,Jo Ann Davenport Littleton,167,131,36,0
Ector,307,"Council Member, At-Large",,,Denise Swanner,246,198,48,0
Ector,308,President,,REP,Donald J. Trump / Michael R. Pence,429,352,77,0
Ector,308,President,,REP,Over Votes,0,0,0,0
Ector,308,President,,REP,Under Votes,8,8,0,0
Ector,308,President,,DEM,Joseph R. Biden / Kamala D. Harris,136,115,21,0
Ector,308,President,,LIB,"Jo Jorgensen / Jeremy ""Spike"" Cohen",3,2,1,0
Ector,308,President,,GRN,Howie Hawkins / Angela Walker,1,0,1,0
Ector,308,President,,,President R. Boddie/Eric C. Stoneham,0,0,0,0
Ector,308,President,,,Brian Carroll/Amar Patel,2,0,2,0
Ector,308,President,,,Todd Cella/Tim Cella,0,0,0,0
Ector,308,President,,,Jesse Cuellar/Jimmy Monreal,0,0,0,0
Ector,308,President,,,Tom Hoefling/Andy Prior,0,0,0,0
Ector,308,President,,,Gloria La Riva/Leonard Peltier,0,0,0,0
Ector,308,President,,,Abram Loeb/Jennifer Jairala,0,0,0,0
Ector,308,President,,,Robert Morrow/Anne Beckett,0,0,0,0
Ector,308,President,,,Kasey Wells/Rachel Wells,0,0,0,0
Ector,308,U.S. Senate,,REP,John Cornyn,420,347,73,0
Ector,308,U.S. Senate,,REP,Over Votes,0,0,0,0
Ector,308,U.S. Senate,,REP,Under Votes,15,11,4,0
Ector,308,U.S. Senate,,DEM,"Mary ""MJ"" Hegar",130,108,22,0
Ector,308,U.S. Senate,,LIB,Kerry Douglas McKennon,12,10,2,0
Ector,308,U.S. Senate,,GRN,David B. Collins,2,1,1,0
Ector,308,U.S. Senate,,,Ricardo Turullols-Bonilla,0,0,0,0
Ector,308,U.S. House,11,REP,August Pfluger,418,348,70,0
Ector,308,U.S. House,11,REP,Over Votes,0,0,0,0
Ector,308,U.S. House,11,REP,Under Votes,19,14,5,0
Ector,308,U.S. House,11,DEM,Jon Mark Hogg,130,107,23,0
Ector,308,U.S. House,11,LIB,Wacey Alpha Cody,12,8,4,0
Ector,308,Railroad Commissioner,,REP,"James ""Jim"" Wright",414,344,70,0
Ector,308,Railroad Commissioner,,REP,Over Votes,0,0,0,0
Ector,308,Railroad Commissioner,,REP,Under Votes,17,13,4,0
Ector,308,Railroad Commissioner,,DEM,Chrysta Castañeda,132,108,24,0
Ector,308,Railroad Commissioner,,LIB,Matt Sterett,12,9,3,0
Ector,308,Railroad Commissioner,,GRN,"Katija ""Kat"" Gruene",4,3,1,0
Ector,308,"Chief Justice, Supreme Court",,REP,Nathan Hecht,410,342,68,0
Ector,308,"Chief Justice, Supreme Court",,REP,Over Votes,0,0,0,0
Ector,308,"Chief Justice, Supreme Court",,REP,Under Votes,20,16,4,0
Ector,308,"Chief Justice, Supreme Court",,DEM,Amy Clark Meachum,134,110,24,0
Ector,308,"Chief Justice, Supreme Court",,LIB,Mark Ash,15,9,6,0
Ector,308,"Justice, Supreme Court, Place 6, (Unexpired Term)",,REP,Jane Bland,418,346,72,0
Ector,308,"Justice, Supreme Court, Place 6, (Unexpired Term)",,REP,Over Votes,0,0,0,0
Ector,308,"Justice, Supreme Court, Place 6, (Unexpired Term)",,REP,Under Votes,20,15,5,0
Ector,308,"Justice, Supreme Court, Place 6, (Unexpired Term)",,DEM,Kathy Cheng,141,116,25,0
Ector,308,"Justice, Supreme Court, Place 7",,REP,Jeff Boyd,410,341,69,0
Ector,308,"Justice, Supreme Court, Place 7",,REP,Over Votes,0,0,0,0
Ector,308,"Justice, Supreme Court, Place 7",,REP,Under Votes,20,16,4,0
Ector,308,"Justice, Supreme Court, Place 7",,DEM,Staci Williams,135,111,24,0
Ector,308,"Justice, Supreme Court, Place 7",,LIB,William Bryan Strange III,14,9,5,0
Ector,308,"Justice, Supreme Court, Place 8",,REP,Brett Busby,405,335,70,0
Ector,308,"Justice, Supreme Court, Place 8",,REP,Over Votes,0,0,0,0
Ector,308,"Justice, Supreme Court, Place 8",,REP,Under Votes,20,16,4,0
Ector,308,"Justice, Supreme Court, Place 8",,DEM,Gisela D. Triana,138,116,22,0
Ector,308,"Justice, Supreme Court, Place 8",,LIB,Tom Oxford,16,10,6,0
Ector,308,"Judge, Court of Criminal Appeals, Place 3",,REP,Bert Richardson,415,344,71,0
Ector,308,"Judge, Court of Criminal Appeals, Place 3",,REP,Over Votes,0,0,0,0
Ector,308,"Judge, Court of Criminal Appeals, Place 3",,REP,Under Votes,22,16,6,0
Ector,308,"Judge, Court of Criminal Appeals, Place 3",,DEM,Elizabeth Davis Frizell,142,117,25,0
Ector,308,"Judge, Court of Criminal Appeals, Place 4",,REP,Kevin Patrick Yeary,418,345,73,0
Ector,308,"Judge, Court of Criminal Appeals, Place 4",,REP,Over Votes,0,0,0,0
Ector,308,"Judge, Court of Criminal Appeals, Place 4",,REP,Under Votes,21,15,6,0
Ector,308,"Judge, Court of Criminal Appeals, Place 4",,DEM,Tina Clinton,140,117,23,0
Ector,308,"Judge, Court of Criminal Appeals, Place 9",,REP,David Newell,414,343,71,0
Ector,308,"Judge, Court of Criminal Appeals, Place 9",,REP,Over Votes,0,0,0,0
Ector,308,"Judge, Court of Criminal Appeals, Place 9",,REP,Under Votes,23,17,6,0
Ector,308,"Judge, Court of Criminal Appeals, Place 9",,DEM,Brandon Birmingham,142,117,25,0
Ector,308,"Member, State Board of Education, District 1",,REP,Jennifer Ivey,417,344,73,0
Ector,308,"Member, State Board of Education, District 1",,REP,Over Votes,0,0,0,0
Ector,308,"Member, State Board of Education, District 1",,REP,Under Votes,22,15,7,0
Ector,308,"Member, State Board of Education, District 1",,DEM,Georgina Perez,140,118,22,0
Ector,308,State Representative,81,REP,Brooks Landgraf,479,397,82,0
Ector,308,State Representative,81,REP,Over Votes,0,0,0,0
Ector,308,State Representative,81,REP,Under Votes,100,80,20,0
Ector,308,"Justice, 11th Court of Appeals District, Place 2",,REP,Bruce Williams,468,388,80,0
Ector,308,"Justice, 11th Court of Appeals District, Place 2",,REP,Over Votes,0,0,0,0
Ector,308,"Justice, 11th Court of Appeals District, Place 2",,REP,Under Votes,111,89,22,0
Ector,308,"Justice, 11th Court of Appeals District, Place 3 (Unexpired Term)",,REP,W. Stacy Trotter,473,391,82,0
Ector,308,"Justice, 11th Court of Appeals District, Place 3 (Unexpired Term)",,REP,Over Votes,0,0,0,0
Ector,308,"Justice, 11th Court of Appeals District, Place 3 (Unexpired Term)",,REP,Under Votes,106,86,20,0
Ector,308,"District Judge, 161st Judicial District",,REP,Justin Low,468,389,79,0
Ector,308,"District Judge, 161st Judicial District",,REP,Over Votes,0,0,0,0
Ector,308,"District Judge, 161st Judicial District",,REP,Under Votes,111,88,23,0
Ector,308,"District Judge, 446th Judicial District",,REP,Sara Kate Billingsley,475,393,82,0
Ector,308,"District Judge, 446th Judicial District",,REP,Over Votes,0,0,0,0
Ector,308,"District Judge, 446th Judicial District",,REP,Under Votes,104,84,20,0
Ector,308,"District Attorney, 70th Judicial District",,REP,Dusty Gallivan,473,391,82,0
Ector,308,"District Attorney, 70th Judicial District",,REP,Over Votes,0,0,0,0
Ector,308,"District Attorney, 70th Judicial District",,REP,Under Votes,106,86,20,0
Ector,308,Mayor,,,Dewey Bryant,223,193,30,0
Ector,308,Mayor,,,Over Votes,0,0,0,0
Ector,308,Mayor,,,Under Votes,76,61,15,0
Ector,308,Mayor,,,Javier Joven,204,161,43,0
Ector,308,Mayor,,,Gloria G. Apolinario,76,62,14,0
Ector,308,"Council Member, At-Large",,,David R. Turner,235,190,45,0
Ector,308,"Council Member, At-Large",,,Over Votes,0,0,0,0
Ector,308,"Council Member, At-Large",,,Under Votes,69,54,15,0
Ector,308,"Council Member, At-Large",,,La-Tasha Gentry,54,45,9,0
Ector,308,"Council Member, At-Large",,,Jo Ann Davenport Littleton,82,66,16,0
Ector,308,"Council Member, At-Large",,,Denise Swanner,139,122,17,0
Ector,309,President,,REP,Donald J. Trump / Michael R. Pence,588,475,113,0
Ector,309,President,,REP,Over Votes,0,0,0,0
Ector,309,President,,REP,Under Votes,4,3,1,0
Ector,309,President,,DEM,Joseph R. Biden / Kamala D. Harris,203,172,31,0
Ector,309,President,,LIB,"Jo Jorgensen / Jeremy ""Spike"" Cohen",17,12,5,0
Ector,309,President,,GRN,Howie Hawkins / Angela Walker,1,0,1,0
Ector,309,President,,,President R. Boddie/Eric C. Stoneham,0,0,0,0
Ector,309,President,,,Brian Carroll/Amar Patel,0,0,0,0
Ector,309,President,,,Todd Cella/Tim Cella,0,0,0,0
Ector,309,President,,,Jesse Cuellar/Jimmy Monreal,0,0,0,0
Ector,309,President,,,Tom Hoefling/Andy Prior,0,0,0,0
Ector,309,President,,,Gloria La Riva/Leonard Peltier,0,0,0,0
Ector,309,President,,,Abram Loeb/Jennifer Jairala,0,0,0,0
Ector,309,President,,,Robert Morrow/Anne Beckett,0,0,0,0
Ector,309,President,,,Kasey Wells/Rachel Wells,0,0,0,0
Ector,309,U.S. Senate,,REP,John Cornyn,586,478,108,0
Ector,309,U.S. Senate,,REP,Over Votes,0,0,0,0
Ector,309,U.S. Senate,,REP,Under Votes,16,10,6,0
Ector,309,U.S. Senate,,DEM,"Mary ""MJ"" Hegar",178,155,23,0
Ector,309,U.S. Senate,,LIB,Kerry Douglas McKennon,28,18,10,0
Ector,309,U.S. Senate,,GRN,David B. Collins,5,1,4,0
Ector,309,U.S. Senate,,,Ricardo Turullols-Bonilla,0,0,0,0
Ector,309,U.S. House,11,REP,August Pfluger,585,477,108,0
Ector,309,U.S. House,11,REP,Over Votes,0,0,0,0
Ector,309,U.S. House,11,REP,Under Votes,17,10,7,0
Ector,309,U.S. House,11,DEM,Jon Mark Hogg,180,158,22,0
Ector,309,U.S. House,11,LIB,Wacey Alpha Cody,31,17,14,0
Ector,309,Railroad Commissioner,,REP,"James ""Jim"" Wright",572,468,104,0
Ector,309,Railroad Commissioner,,REP,Over Votes,0,0,0,0
Ector,309,Railroad Commissioner,,REP,Under Votes,21,12,9,0
Ector,309,Railroad Commissioner,,DEM,Chrysta Castañeda,182,156,26,0
Ector,309,Railroad Commissioner,,LIB,Matt Sterett,25,17,8,0
Ector,309,Railroad Commissioner,,GRN,"Katija ""Kat"" Gruene",13,9,4,0
Ector,309,"Chief Justice, Supreme Court",,REP,Nathan Hecht,567,468,99,0
Ector,309,"Chief Justice, Supreme Court",,REP,Over Votes,0,0,0,0
Ector,309,"Chief Justice, Supreme Court",,REP,Under Votes,20,12,8,0
Ector,309,"Chief Justice, Supreme Court",,DEM,Amy Clark Meachum,197,166,31,0
Ector,309,"Chief Justice, Supreme Court",,LIB,Mark Ash,29,16,13,0
Ector,309,"Justice, Supreme Court, Place 6, (Unexpired Term)",,REP,Jane Bland,599,486,113,0
Ector,309,"Justice, Supreme Court, Place 6, (Unexpired Term)",,REP,Over Votes,0,0,0,0
Ector,309,"Justice, Supreme Court, Place 6, (Unexpired Term)",,REP,Under Votes,16,9,7,0
Ector,309,"Justice, Supreme Court, Place 6, (Unexpired Term)",,DEM,Kathy Cheng,198,167,31,0
Ector,309,"Justice, Supreme Court, Place 7",,REP,Jeff Boyd,576,471,105,0
Ector,309,"Justice, Supreme Court, Place 7",,REP,Over Votes,0,0,0,0
Ector,309,"Justice, Supreme Court, Place 7",,REP,Under Votes,18,11,7,0
Ector,309,"Justice, Supreme Court, Place 7",,DEM,Staci Williams,190,164,26,0
Ector,309,"Justice, Supreme Court, Place 7",,LIB,William Bryan Strange III,29,16,13,0
Ector,309,"Justice, Supreme Court, Place 8",,REP,Brett Busby,576,470,106,0
Ector,309,"Justice, Supreme Court, Place 8",,REP,Over Votes,0,0,0,0
Ector,309,"Justice, Supreme Court, Place 8",,REP,Under Votes,19,12,7,0
Ector,309,"Justice, Supreme Court, Place 8",,DEM,Gisela D. Triana,188,162,26,0
Ector,309,"Justice, Supreme Court, Place 8",,LIB,Tom Oxford,30,18,12,0
Ector,309,"Judge, Court of Criminal Appeals, Place 3",,REP,Bert Richardson,590,479,111,0
Ector,309,"Judge, Court of Criminal Appeals, Place 3",,REP,Over Votes,0,0,0,0
Ector,309,"Judge, Court of Criminal Appeals, Place 3",,REP,Under Votes,21,13,8,0
Ector,309,"Judge, Court of Criminal Appeals, Place 3",,DEM,Elizabeth Davis Frizell,202,170,32,0
Ector,309,"Judge, Court of Criminal Appeals, Place 4",,REP,Kevin Patrick Yeary,598,484,114,0
Ector,309,"Judge, Court of Criminal Appeals, Place 4",,REP,Over Votes,0,0,0,0
Ector,309,"Judge, Court of Criminal Appeals, Place 4",,REP,Under Votes,21,13,8,0
Ector,309,"Judge, Court of Criminal Appeals, Place 4",,DEM,Tina Clinton,194,165,29,0
Ector,309,"Judge, Court of Criminal Appeals, Place 9",,REP,David Newell,595,483,112,0
Ector,309,"Judge, Court of Criminal Appeals, Place 9",,REP,Over Votes,0,0,0,0
Ector,309,"Judge, Court of Criminal Appeals, Place 9",,REP,Under Votes,22,14,8,0
Ector,309,"Judge, Court of Criminal Appeals, Place 9",,DEM,Brandon Birmingham,196,165,31,0
Ector,309,"Member, State Board of Education, District 1",,REP,Jennifer Ivey,591,480,111,0
Ector,309,"Member, State Board of Education, District 1",,REP,Over Votes,0,0,0,0
Ector,309,"Member, State Board of Education, District 1",,REP,Under Votes,24,16,8,0
Ector,309,"Member, State Board of Education, District 1",,DEM,Georgina Perez,198,166,32,0
Ector,309,State Representative,81,REP,Brooks Landgraf,701,567,134,0
Ector,309,State Representative,81,REP,Over Votes,0,0,0,0
Ector,309,State Representative,81,REP,Under Votes,112,95,17,0
Ector,309,"Justice, 11th Court of Appeals District, Place 2",,REP,Bruce Williams,681,549,132,0
Ector,309,"Justice, 11th Court of Appeals District, Place 2",,REP,Over Votes,0,0,0,0
Ector,309,"Justice, 11th Court of Appeals District, Place 2",,REP,Under Votes,132,113,19,0
Ector,309,"Justice, 11th Court of Appeals District, Place 3 (Unexpired Term)",,REP,W. Stacy Trotter,683,553,130,0
Ector,309,"Justice, 11th Court of Appeals District, Place 3 (Unexpired Term)",,REP,Over Votes,0,0,0,0
Ector,309,"Justice, 11th Court of Appeals District, Place 3 (Unexpired Term)",,REP,Under Votes,130,109,21,0
Ector,309,"District Judge, 161st Judicial District",,REP,Justin Low,677,553,124,0
Ector,309,"District Judge, 161st Judicial District",,REP,Over Votes,0,0,0,0
Ector,309,"District Judge, 161st Judicial District",,REP,Under Votes,136,109,27,0
Ector,309,"District Judge, 446th Judicial District",,REP,Sara Kate Billingsley,682,555,127,0
Ector,309,"District Judge, 446th Judicial District",,REP,Over Votes,0,0,0,0
Ector,309,"District Judge, 446th Judicial District",,REP,Under Votes,131,107,24,0
Ector,309,"District Attorney, 70th Judicial District",,REP,Dusty Gallivan,681,554,127,0
Ector,309,"District Attorney, 70th Judicial District",,REP,Over Votes,0,0,0,0
Ector,309,"District Attorney, 70th Judicial District",,REP,Under Votes,132,108,24,0
Ector,309,Mayor,,,Dewey Bryant,273,234,39,0
Ector,309,Mayor,,,Over Votes,0,0,0,0
Ector,309,Mayor,,,Under Votes,72,48,24,0
Ector,309,Mayor,,,Javier Joven,320,259,61,0
Ector,309,Mayor,,,Gloria G. Apolinario,148,121,27,0
Ector,309,"Council Member, District 1",,,Mark Matta,372,296,76,0
Ector,309,"Council Member, District 1",,,Over Votes,0,0,0,0
Ector,309,"Council Member, District 1",,,Under Votes,105,81,24,0
Ector,309,"Council Member, District 1",,,Michael K. Shelton Sr.,172,149,23,0
Ector,309,"Council Member, District 1",,,Tiki Davis,87,70,17,0
Ector,309,"Council Member, District 1",,,Eddie Mitchell,77,66,11,0
Ector,309,"Council Member, At-Large",,,David R. Turner,330,267,63,0
Ector,309,"Council Member, At-Large",,,Over Votes,0,0,0,0
Ector,309,"Council Member, At-Large",,,Under Votes,95,69,26,0
Ector,309,"Council Member, At-Large",,,La-Tasha Gentry,99,77,22,0
Ector,309,"Council Member, At-Large",,,Jo Ann Davenport Littleton,88,76,12,0
Ector,309,"Council Member, At-Large",,,Denise Swanner,201,173,28,0
Ector,311 City,President,,REP,Donald J. Trump / Michael R. Pence,430,342,88,0
Ector,311 City,President,,REP,Over Votes,0,0,0,0
Ector,311 City,President,,REP,Under Votes,4,3,1,0
Ector,311 City,President,,DEM,Joseph R. Biden / Kamala D. Harris,174,141,33,0
Ector,311 City,President,,LIB,"Jo Jorgensen / Jeremy ""Spike"" Cohen",4,1,3,0
Ector,311 City,President,,GRN,Howie Hawkins / Angela Walker,0,0,0,0
Ector,311 City,President,,,President R. Boddie/Eric C. Stoneham,0,0,0,0
Ector,311 City,President,,,Brian Carroll/Amar Patel,0,0,0,0
Ector,311 City,President,,,Todd Cella/Tim Cella,0,0,0,0
Ector,311 City,President,,,Jesse Cuellar/Jimmy Monreal,0,0,0,0
Ector,311 City,President,,,Tom Hoefling/Andy Prior,0,0,0,0
Ector,311 City,President,,,Gloria La Riva/Leonard Peltier,0,0,0,0
Ector,311 City,President,,,Abram Loeb/Jennifer Jairala,0,0,0,0
Ector,311 City,President,,,Robert Morrow/Anne Beckett,0,0,0,0
Ector,311 City,President,,,Kasey Wells/Rachel Wells,0,0,0,0
Ector,311 City,U.S. Senate,,REP,John Cornyn,420,333,87,0
Ector,311 City,U.S. Senate,,REP,Over Votes,0,0,0,0
Ector,311 City,U.S. Senate,,REP,Under Votes,18,15,3,0
Ector,311 City,U.S. Senate,,DEM,"Mary ""MJ"" Hegar",162,130,32,0
Ector,311 City,U.S. Senate,,LIB,Kerry Douglas McKennon,11,8,3,0
Ector,311 City,U.S. Senate,,GRN,David B. Collins,1,1,0,0
Ector,311 City,U.S. Senate,,,Ricardo Turullols-Bonilla,0,0,0,0
Ector,311 City,U.S. House,11,REP,August Pfluger,423,336,87,0
Ector,311 City,U.S. House,11,REP,Over Votes,0,0,0,0
Ector,311 City,U.S. House,11,REP,Under Votes,20,15,5,0
Ector,311 City,U.S. House,11,DEM,Jon Mark Hogg,159,128,31,0
Ector,311 City,U.S. House,11,LIB,Wacey Alpha Cody,10,8,2,0
Ector,311 City,Railroad Commissioner,,REP,"James ""Jim"" Wright",418,332,86,0
Ector,311 City,Railroad Commissioner,,REP,Over Votes,0,0,0,0
Ector,311 City,Railroad Commissioner,,REP,Under Votes,17,14,3,0
Ector,311 City,Railroad Commissioner,,DEM,Chrysta Castañeda,162,130,32,0
Ector,311 City,Railroad Commissioner,,LIB,Matt Sterett,11,9,2,0
Ector,311 City,Railroad Commissioner,,GRN,"Katija ""Kat"" Gruene",4,2,2,0
Ector,311 City,"Chief Justice, Supreme Court",,REP,Nathan Hecht,415,331,84,0
Ector,311 City,"Chief Justice, Supreme Court",,REP,Over Votes,0,0,0,0
Ector,311 City,"Chief Justice, Supreme Court",,REP,Under Votes,17,14,3,0
Ector,311 City,"Chief Justice, Supreme Court",,DEM,Amy Clark Meachum,170,137,33,0
Ector,311 City,"Chief Justice, Supreme Court",,LIB,Mark Ash,10,5,5,0
Ector,311 City,"Justice, Supreme Court, Place 6, (Unexpired Term)",,REP,Jane Bland,424,336,88,0
Ector,311 City,"Justice, Supreme Court, Place 6, (Unexpired Term)",,REP,Over Votes,0,0,0,0
Ector,311 City,"Justice, Supreme Court, Place 6, (Unexpired Term)",,REP,Under Votes,18,14,4,0
Ector,311 City,"Justice, Supreme Court, Place 6, (Unexpired Term)",,DEM,Kathy Cheng,170,137,33,0
Ector,311 City,"Justice, Supreme Court, Place 7",,REP,Jeff Boyd,427,337,90,0
Ector,311 City,"Justice, Supreme Court, Place 7",,REP,Over Votes,0,0,0,0
Ector,311 City,"Justice, Supreme Court, Place 7",,REP,Under Votes,18,16,2,0
Ector,311 City,"Justice, Supreme Court, Place 7",,DEM,Staci Williams,155,126,29,0
Ector,311 City,"Justice, Supreme Court, Place 7",,LIB,William Bryan Strange III,12,8,4,0
Ector,311 City,"Justice, Supreme Court, Place 8",,REP,Brett Busby,417,332,85,0
Ector,311 City,"Justice, Supreme Court, Place 8",,REP,Over Votes,0,0,0,0
Ector,311 City,"Justice, Supreme Court, Place 8",,REP,Under Votes,20,16,4,0
Ector,311 City,"Justice, Supreme Court, Place 8",,DEM,Gisela D. Triana,163,131,32,0
Ector,311 City,"Justice, Supreme Court, Place 8",,LIB,Tom Oxford,12,8,4,0
Ector,311 City,"Judge, Court of Criminal Appeals, Place 3",,REP,Bert Richardson,428,339,89,0
Ector,311 City,"Judge, Court of Criminal Appeals, Place 3",,REP,Over Votes,0,0,0,0
Ector,311 City,"Judge, Court of Criminal Appeals, Place 3",,REP,Under Votes,21,17,4,0
Ector,311 City,"Judge, Court of Criminal Appeals, Place 3",,DEM,Elizabeth Davis Frizell,163,131,32,0
Ector,311 City,"Judge, Court of Criminal Appeals, Place 4",,REP,Kevin Patrick Yeary,432,342,90,0
Ector,311 City,"Judge, Court of Criminal Appeals, Place 4",,REP,Over Votes,0,0,0,0
Ector,311 City,"Judge, Court of Criminal Appeals, Place 4",,REP,Under Votes,19,14,5,0
Ector,311 City,"Judge, Court of Criminal Appeals, Place 4",,DEM,Tina Clinton,161,131,30,0
Ector,311 City,"Judge, Court of Criminal Appeals, Place 9",,REP,David Newell,429,338,91,0
Ector,311 City,"Judge, Court of Criminal Appeals, Place 9",,REP,Over Votes,0,0,0,0
Ector,311 City,"Judge, Court of Criminal Appeals, Place 9",,REP,Under Votes,24,19,5,0
Ector,311 City,"Judge, Court of Criminal Appeals, Place 9",,DEM,Brandon Birmingham,159,130,29,0
Ector,311 City,"Member, State Board of Education, District 1",,REP,Jennifer Ivey,416,329,87,0
Ector,311 City,"Member, State Board of Education, District 1",,REP,Over Votes,0,0,0,0
Ector,311 City,"Member, State Board of Education, District 1",,REP,Under Votes,25,20,5,0
Ector,311 City,"Member, State Board of Education, District 1",,DEM,Georgina Perez,171,138,33,0
Ector,311 City,State Representative,81,REP,Brooks Landgraf,509,407,102,0
Ector,311 City,State Representative,81,REP,Over Votes,0,0,0,0
Ector,311 City,State Representative,81,REP,Under Votes,103,80,23,0
Ector,311 City,"Justice, 11th Court of Appeals District, Place 2",,REP,Bruce Williams,487,384,103,0
Ector,311 City,"Justice, 11th Court of Appeals District, Place 2",,REP,Over Votes,0,0,0,0
Ector,311 City,"Justice, 11th Court of Appeals District, Place 2",,REP,Under Votes,125,103,22,0
Ector,311 City,"Justice, 11th Court of Appeals District, Place 3 (Unexpired Term)",,REP,W. Stacy Trotter,488,385,103,0
Ector,311 City,"Justice, 11th Court of Appeals District, Place 3 (Unexpired Term)",,REP,Over Votes,0,0,0,0
Ector,311 City,"Justice, 11th Court of Appeals District, Place 3 (Unexpired Term)",,REP,Under Votes,124,102,22,0
Ector,311 City,"District Judge, 161st Judicial District",,REP,Justin Low,479,379,100,0
Ector,311 City,"District Judge, 161st Judicial District",,REP,Over Votes,0,0,0,0
Ector,311 City,"District Judge, 161st Judicial District",,REP,Under Votes,133,108,25,0
Ector,311 City,"District Judge, 446th Judicial District",,REP,Sara Kate Billingsley,486,384,102,0
Ector,311 City,"District Judge, 446th Judicial District",,REP,Over Votes,0,0,0,0
Ector,311 City,"District Judge, 446th Judicial District",,REP,Under Votes,126,103,23,0
Ector,311 City,"District Attorney, 70th Judicial District",,REP,Dusty Gallivan,486,384,102,0
Ector,311 City,"District Attorney, 70th Judicial District",,REP,Over Votes,0,0,0,0
Ector,311 City,"District Attorney, 70th Judicial District",,REP,Under Votes,126,103,23,0
Ector,311 City,Mayor,,,Dewey Bryant,203,169,34,0
Ector,311 City,Mayor,,,Over Votes,0,0,0,0
Ector,311 City,Mayor,,,Under Votes,53,39,14,0
Ector,311 City,Mayor,,,Javier Joven,252,196,56,0
Ector,311 City,Mayor,,,Gloria G. Apolinario,104,83,21,0
Ector,311 City,"Council Member, At-Large",,,David R. Turner,277,218,59,0
Ector,311 City,"Council Member, At-Large",,,Over Votes,0,0,0,0
Ector,311 City,"Council Member, At-Large",,,Under Votes,66,48,18,0
Ector,311 City,"Council Member, At-Large",,,La-Tasha Gentry,64,51,13,0
Ector,311 City,"Council Member, At-Large",,,Jo Ann Davenport Littleton,85,70,15,0
Ector,311 City,"Council Member, At-Large",,,Denise Swanner,120,100,20,0
Ector,311 County,President,,REP,Donald J. Trump / Michael R. Pence,23,18,5,0
Ector,311 County,President,,REP,Over Votes,0,0,0,0
Ector,311 County,President,,REP,Under Votes,0,0,0,0
Ector,311 County,President,,DEM,Joseph R. Biden / Kamala D. Harris,4,4,0,0
Ector,311 County,President,,LIB,"Jo Jorgensen / Jeremy ""Spike"" Cohen",0,0,0,0
Ector,311 County,President,,GRN,Howie Hawkins / Angela Walker,0,0,0,0
Ector,311 County,President,,,President R. Boddie/Eric C. Stoneham,0,0,0,0
Ector,311 County,President,,,Brian Carroll/Amar Patel,0,0,0,0
Ector,311 County,President,,,Todd Cella/Tim Cella,0,0,0,0
Ector,311 County,President,,,Jesse Cuellar/Jimmy Monreal,0,0,0,0
Ector,311 County,President,,,Tom Hoefling/Andy Prior,0,0,0,0
Ector,311 County,President,,,Gloria La Riva/Leonard Peltier,0,0,0,0
Ector,311 County,President,,,Abram Loeb/Jennifer Jairala,0,0,0,0
Ector,311 County,President,,,Robert Morrow/Anne Beckett,0,0,0,0
Ector,311 County,President,,,Kasey Wells/Rachel Wells,0,0,0,0
Ector,311 County,U.S. Senate,,REP,John Cornyn,22,18,4,0
Ector,311 County,U.S. Senate,,REP,Over Votes,0,0,0,0
Ector,311 County,U.S. Senate,,REP,Under Votes,1,1,0,0
Ector,311 County,U.S. Senate,,DEM,"Mary ""MJ"" Hegar",3,3,0,0
Ector,311 County,U.S. Senate,,LIB,Kerry Douglas McKennon,0,0,0,0
Ector,311 County,U.S. Senate,,GRN,David B. Collins,1,0,1,0
Ector,311 County,U.S. Senate,,,Ricardo Turullols-Bonilla,0,0,0,0
Ector,311 County,U.S. House,11,REP,August Pfluger,23,18,5,0
Ector,311 County,U.S. House,11,REP,Over Votes,0,0,0,0
Ector,311 County,U.S. House,11,REP,Under Votes,1,1,0,0
Ector,311 County,U.S. House,11,DEM,Jon Mark Hogg,3,3,0,0
Ector,311 County,U.S. House,11,LIB,Wacey Alpha Cody,0,0,0,0
Ector,311 County,Railroad Commissioner,,REP,"James ""Jim"" Wright",22,18,4,0
Ector,311 County,Railroad Commissioner,,REP,Over Votes,0,0,0,0
Ector,311 County,Railroad Commissioner,,REP,Under Votes,1,0,1,0
Ector,311 County,Railroad Commissioner,,DEM,Chrysta Castañeda,3,3,0,0
Ector,311 County,Railroad Commissioner,,LIB,Matt Sterett,1,1,0,0
Ector,311 County,Railroad Commissioner,,GRN,"Katija ""Kat"" Gruene",0,0,0,0
Ector,311 County,"Chief Justice, Supreme Court",,REP,Nathan Hecht,24,19,5,0
Ector,311 County,"Chief Justice, Supreme Court",,REP,Over Votes,0,0,0,0
Ector,311 County,"Chief Justice, Supreme Court",,REP,Under Votes,0,0,0,0
Ector,311 County,"Chief Justice, Supreme Court",,DEM,Amy Clark Meachum,3,3,0,0
Ector,311 County,"Chief Justice, Supreme Court",,LIB,Mark Ash,0,0,0,0
Ector,311 County,"Justice, Supreme Court, Place 6, (Unexpired Term)",,REP,Jane Bland,23,19,4,0
Ector,311 County,"Justice, Supreme Court, Place 6, (Unexpired Term)",,REP,Over Votes,0,0,0,0
Ector,311 County,"Justice, Supreme Court, Place 6, (Unexpired Term)",,REP,Under Votes,1,0,1,0
Ector,311 County,"Justice, Supreme Court, Place 6, (Unexpired Term)",,DEM,Kathy Cheng,3,3,0,0
Ector,311 County,"Justice, Supreme Court, Place 7",,REP,Jeff Boyd,24,19,5,0
Ector,311 County,"Justice, Supreme Court, Place 7",,REP,Over Votes,0,0,0,0
Ector,311 County,"Justice, Supreme Court, Place 7",,REP,Under Votes,0,0,0,0
Ector,311 County,"Justice, Supreme Court, Place 7",,DEM,Staci Williams,3,3,0,0
Ector,311 County,"Justice, Supreme Court, Place 7",,LIB,William Bryan Strange III,0,0,0,0
Ector,311 County,"Justice, Supreme Court, Place 8",,REP,Brett Busby,23,18,5,0
Ector,311 County,"Justice, Supreme Court, Place 8",,REP,Over Votes,0,0,0,0
Ector,311 County,"Justice, Supreme Court, Place 8",,REP,Under Votes,0,0,0,0
Ector,311 County,"Justice, Supreme Court, Place 8",,DEM,Gisela D. Triana,3,3,0,0
Ector,311 County,"Justice, Supreme Court, Place 8",,LIB,Tom Oxford,1,1,0,0
Ector,311 County,"Judge, Court of Criminal Appeals, Place 3",,REP,Bert Richardson,22,18,4,0
Ector,311 County,"Judge, Court of Criminal Appeals, Place 3",,REP,Over Votes,0,0,0,0
Ector,311 County,"Judge, Court of Criminal Appeals, Place 3",,REP,Under Votes,1,0,1,0
Ector,311 County,"Judge, Court of Criminal Appeals, Place 3",,DEM,Elizabeth Davis Frizell,4,4,0,0
Ector,311 County,"Judge, Court of Criminal Appeals, Place 4",,REP,Kevin Patrick Yeary,23,18,5,0
Ector,311 County,"Judge, Court of Criminal Appeals, Place 4",,REP,Over Votes,0,0,0,0
Ector,311 County,"Judge, Court of Criminal Appeals, Place 4",,REP,Under Votes,1,1,0,0
Ector,311 County,"Judge, Court of Criminal Appeals, Place 4",,DEM,Tina Clinton,3,3,0,0
Ector,311 County,"Judge, Court of Criminal Appeals, Place 9",,REP,David Newell,23,18,5,0
Ector,311 County,"Judge, Court of Criminal Appeals, Place 9",,REP,Over Votes,0,0,0,0
Ector,311 County,"Judge, Court of Criminal Appeals, Place 9",,REP,Under Votes,0,0,0,0
Ector,311 County,"Judge, Court of Criminal Appeals, Place 9",,DEM,Brandon Birmingham,4,4,0,0
Ector,311 County,"Member, State Board of Education, District 1",,REP,Jennifer Ivey,22,18,4,0
Ector,311 County,"Member, State Board of Education, District 1",,REP,Over Votes,0,0,0,0
Ector,311 County,"Member, State Board of Education, District 1",,REP,Under Votes,1,0,1,0
Ector,311 County,"Member, State Board of Education, District 1",,DEM,Georgina Perez,4,4,0,0
Ector,311 County,State Representative,81,REP,Brooks Landgraf,24,20,4,0
Ector,311 County,State Representative,81,REP,Over Votes,0,0,0,0
Ector,311 County,State Representative,81,REP,Under Votes,3,2,1,0
Ector,311 County,"Justice, 11th Court of Appeals District, Place 2",,REP,Bruce Williams,22,19,3,0
Ector,311 County,"Justice, 11th Court of Appeals District, Place 2",,REP,Over Votes,0,0,0,0
Ector,311 County,"Justice, 11th Court of Appeals District, Place 2",,REP,Under Votes,5,3,2,0
Ector,311 County,"Justice, 11th Court of Appeals District, Place 3 (Unexpired Term)",,REP,W. Stacy Trotter,22,19,3,0
Ector,311 County,"Justice, 11th Court of Appeals District, Place 3 (Unexpired Term)",,REP,Over Votes,0,0,0,0
Ector,311 County,"Justice, 11th Court of Appeals District, Place 3 (Unexpired Term)",,REP,Under Votes,5,3,2,0
Ector,311 County,"District Judge, 161st Judicial District",,REP,Justin Low,23,20,3,0
Ector,311 County,"District Judge, 161st Judicial District",,REP,Over Votes,0,0,0,0
Ector,311 County,"District Judge, 161st Judicial District",,REP,Under Votes,4,2,2,0
Ector,311 County,"District Judge, 446th Judicial District",,REP,Sara Kate Billingsley,22,19,3,0
Ector,311 County,"District Judge, 446th Judicial District",,REP,Over Votes,0,0,0,0
Ector,311 County,"District Judge, 446th Judicial District",,REP,Under Votes,5,3,2,0
Ector,311 County,"District Attorney, 70th Judicial District",,REP,Dusty Gallivan,21,18,3,0
Ector,311 County,"District Attorney, 70th Judicial District",,REP,Over Votes,0,0,0,0
Ector,311 County,"District Attorney, 70th Judicial District",,REP,Under Votes,6,4,2,0
Ector,312,President,,REP,Donald J. Trump / Michael R. Pence,653,556,97,0
Ector,312,President,,REP,Over Votes,0,0,0,0
Ector,312,President,,REP,Under Votes,4,4,0,0
Ector,312,President,,DEM,Joseph R. Biden / Kamala D. Harris,218,186,32,0
Ector,312,President,,LIB,"Jo Jorgensen / Jeremy ""Spike"" Cohen",17,14,3,0
Ector,312,President,,GRN,Howie Hawkins / Angela Walker,3,3,0,0
Ector,312,President,,,President R. Boddie/Eric C. Stoneham,0,0,0,0
Ector,312,President,,,Brian Carroll/Amar Patel,0,0,0,0
Ector,312,President,,,Todd Cella/Tim Cella,0,0,0,0
Ector,312,President,,,Jesse Cuellar/Jimmy Monreal,0,0,0,0
Ector,312,President,,,Tom Hoefling/Andy Prior,0,0,0,0
Ector,312,President,,,Gloria La Riva/Leonard Peltier,0,0,0,0
Ector,312,President,,,Abram Loeb/Jennifer Jairala,0,0,0,0
Ector,312,President,,,Robert Morrow/Anne Beckett,1,1,0,0
Ector,312,President,,,Kasey Wells/Rachel Wells,0,0,0,0
Ector,312,U.S. Senate,,REP,John Cornyn,644,553,91,0
Ector,312,U.S. Senate,,REP,Over Votes,0,0,0,0
Ector,312,U.S. Senate,,REP,Under Votes,16,15,1,0
Ector,312,U.S. Senate,,DEM,"Mary ""MJ"" Hegar",197,164,33,0
Ector,312,U.S. Senate,,LIB,Kerry Douglas McKennon,33,27,6,0
Ector,312,U.S. Senate,,GRN,David B. Collins,6,5,1,0
Ector,312,U.S. Senate,,,Ricardo Turullols-Bonilla,0,0,0,0
Ector,312,U.S. House,11,REP,August Pfluger,638,551,87,0
Ector,312,U.S. House,11,REP,Over Votes,0,0,0,0
Ector,312,U.S. House,11,REP,Under Votes,20,17,3,0
Ector,312,U.S. House,11,DEM,Jon Mark Hogg,206,173,33,0
Ector,312,U.S. House,11,LIB,Wacey Alpha Cody,32,23,9,0
Ector,312,Railroad Commissioner,,REP,"James ""Jim"" Wright",648,562,86,0
Ector,312,Railroad Commissioner,,REP,Over Votes,0,0,0,0
Ector,312,Railroad Commissioner,,REP,Under Votes,18,15,3,0
Ector,312,Railroad Commissioner,,DEM,Chrysta Castañeda,193,157,36,0
Ector,312,Railroad Commissioner,,LIB,Matt Sterett,28,23,5,0
Ector,312,Railroad Commissioner,,GRN,"Katija ""Kat"" Gruene",9,7,2,0
Ector,312,"Chief Justice, Supreme Court",,REP,Nathan Hecht,634,546,88,0
Ector,312,"Chief Justice, Supreme Court",,REP,Over Votes,0,0,0,0
Ector,312,"Chief Justice, Supreme Court",,REP,Under Votes,19,16,3,0
Ector,312,"Chief Justice, Supreme Court",,DEM,Amy Clark Meachum,207,173,34,0
Ector,312,"Chief Justice, Supreme Court",,LIB,Mark Ash,36,29,7,0
Ector,312,"Justice, Supreme Court, Place 6, (Unexpired Term)",,REP,Jane Bland,668,574,94,0
Ector,312,"Justice, Supreme Court, Place 6, (Unexpired Term)",,REP,Over Votes,0,0,0,0
Ector,312,"Justice, Supreme Court, Place 6, (Unexpired Term)",,REP,Under Votes,14,11,3,0
Ector,312,"Justice, Supreme Court, Place 6, (Unexpired Term)",,DEM,Kathy Cheng,214,179,35,0
Ector,312,"Justice, Supreme Court, Place 7",,REP,Jeff Boyd,646,556,90,0
Ector,312,"Justice, Supreme Court, Place 7",,REP,Over Votes,0,0,0,0
Ector,312,"Justice, Supreme Court, Place 7",,REP,Under Votes,21,18,3,0
Ector,312,"Justice, Supreme Court, Place 7",,DEM,Staci Williams,206,173,33,0
Ector,312,"Justice, Supreme Court, Place 7",,LIB,William Bryan Strange III,23,17,6,0
Ector,312,"Justice, Supreme Court, Place 8",,REP,Brett Busby,638,548,90,0
Ector,312,"Justice, Supreme Court, Place 8",,REP,Over Votes,0,0,0,0
Ector,312,"Justice, Supreme Court, Place 8",,REP,Under Votes,22,19,3,0
Ector,312,"Justice, Supreme Court, Place 8",,DEM,Gisela D. Triana,197,165,32,0
Ector,312,"Justice, Supreme Court, Place 8",,LIB,Tom Oxford,39,32,7,0
Ector,312,"Judge, Court of Criminal Appeals, Place 3",,REP,Bert Richardson,655,560,95,0
Ector,312,"Judge, Court of Criminal Appeals, Place 3",,REP,Over Votes,0,0,0,0
Ector,312,"Judge, Court of Criminal Appeals, Place 3",,REP,Under Votes,23,20,3,0
Ector,312,"Judge, Court of Criminal Appeals, Place 3",,DEM,Elizabeth Davis Frizell,218,184,34,0
Ector,312,"Judge, Court of Criminal Appeals, Place 4",,REP,Kevin Patrick Yeary,656,561,95,0
Ector,312,"Judge, Court of Criminal Appeals, Place 4",,REP,Over Votes,0,0,0,0
Ector,312,"Judge, Court of Criminal Appeals, Place 4",,REP,Under Votes,28,25,3,0
Ector,312,"Judge, Court of Criminal Appeals, Place 4",,DEM,Tina Clinton,212,178,34,0
Ector,312,"Judge, Court of Criminal Appeals, Place 9",,REP,David Newell,664,568,96,0
Ector,312,"Judge, Court of Criminal Appeals, Place 9",,REP,Over Votes,0,0,0,0
Ector,312,"Judge, Court of Criminal Appeals, Place 9",,REP,Under Votes,24,21,3,0
Ector,312,"Judge, Court of Criminal Appeals, Place 9",,DEM,Brandon Birmingham,208,175,33,0
Ector,312,"Member, State Board of Education, District 1",,REP,Jennifer Ivey,651,558,93,0
Ector,312,"Member, State Board of Education, District 1",,REP,Over Votes,0,0,0,0
Ector,312,"Member, State Board of Education, District 1",,REP,Under Votes,26,23,3,0
Ector,312,"Member, State Board of Education, District 1",,DEM,Georgina Perez,219,183,36,0
Ector,312,State Representative,81,REP,Brooks Landgraf,770,654,116,0
Ector,312,State Representative,81,REP,Over Votes,0,0,0,0
Ector,312,State Representative,81,REP,Under Votes,126,110,16,0
Ector,312,"Justice, 11th Court of Appeals District, Place 2",,REP,Bruce Williams,738,623,115,0
Ector,312,"Justice, 11th Court of Appeals District, Place 2",,REP,Over Votes,0,0,0,0
Ector,312,"Justice, 11th Court of Appeals District, Place 2",,REP,Under Votes,158,141,17,0
Ector,312,"Justice, 11th Court of Appeals District, Place 3 (Unexpired Term)",,REP,W. Stacy Trotter,730,617,113,0
Ector,312,"Justice, 11th Court of Appeals District, Place 3 (Unexpired Term)",,REP,Over Votes,0,0,0,0
Ector,312,"Justice, 11th Court of Appeals District, Place 3 (Unexpired Term)",,REP,Under Votes,166,147,19,0
Ector,312,"District Judge, 161st Judicial District",,REP,Justin Low,723,609,114,0
Ector,312,"District Judge, 161st Judicial District",,REP,Over Votes,0,0,0,0
Ector,312,"District Judge, 161st Judicial District",,REP,Under Votes,173,155,18,0
Ector,312,"District Judge, 446th Judicial District",,REP,Sara Kate Billingsley,735,622,113,0
Ector,312,"District Judge, 446th Judicial District",,REP,Over Votes,0,0,0,0
Ector,312,"District Judge, 446th Judicial District",,REP,Under Votes,161,142,19,0
Ector,312,"District Attorney, 70th Judicial District",,REP,Dusty Gallivan,742,628,114,0
Ector,312,"District Attorney, 70th Judicial District",,REP,Over Votes,0,0,0,0
Ector,312,"District Attorney, 70th Judicial District",,REP,Under Votes,154,136,18,0
Ector,312,Mayor,,,Dewey Bryant,337,287,50,0
Ector,312,Mayor,,,Over Votes,0,0,0,0
Ector,312,Mayor,,,Under Votes,76,67,9,0
Ector,312,Mayor,,,Javier Joven,334,286,48,0
Ector,312,Mayor,,,Gloria G. Apolinario,149,124,25,0
Ector,312,"Council Member, District 1",,,Mark Matta,394,338,56,0
Ector,312,"Council Member, District 1",,,Over Votes,0,0,0,0
Ector,312,"Council Member, District 1",,,Under Votes,93,79,14,0
Ector,312,"Council Member, District 1",,,Michael K. Shelton Sr.,188,164,24,0
Ector,312,"Council Member, District 1",,,Tiki Davis,127,107,20,0
Ector,312,"Council Member, District 1",,,Eddie Mitchell,94,76,18,0
Ector,312,"Council Member, At-Large",,,David R. Turner,342,290,52,0
Ector,312,"Council Member, At-Large",,,Over Votes,0,0,0,0
Ector,312,"Council Member, At-Large",,,Under Votes,94,81,13,0
Ector,312,"Council Member, At-Large",,,La-Tasha Gentry,95,72,23,0
Ector,312,"Council Member, At-Large",,,Jo Ann Davenport Littleton,103,91,12,0
Ector,312,"Council Member, At-Large",,,Denise Swanner,262,230,32,0
Ector,401,President,,REP,Donald J. Trump / Michael R. Pence,290,242,48,0
Ector,401,President,,REP,Over Votes,1,1,0,0
Ector,401,President,,REP,Under Votes,4,3,1,0
Ector,401,President,,DEM,Joseph R. Biden / Kamala D. Harris,149,124,25,0
Ector,401,President,,LIB,"Jo Jorgensen / Jeremy ""Spike"" Cohen",4,3,1,0
Ector,401,President,,GRN,Howie Hawkins / Angela Walker,1,1,0,0
Ector,401,President,,,President R. Boddie/Eric C. Stoneham,0,0,0,0
Ector,401,President,,,Brian Carroll/Amar Patel,0,0,0,0
Ector,401,President,,,Todd Cella/Tim Cella,0,0,0,0
Ector,401,President,,,Jesse Cuellar/Jimmy Monreal,0,0,0,0
Ector,401,President,,,Tom Hoefling/Andy Prior,0,0,0,0
Ector,401,President,,,Gloria La Riva/Leonard Peltier,0,0,0,0
Ector,401,President,,,Abram Loeb/Jennifer Jairala,0,0,0,0
Ector,401,President,,,Robert Morrow/Anne Beckett,0,0,0,0
Ector,401,President,,,Kasey Wells/Rachel Wells,0,0,0,0
Ector,401,U.S. Senate,,REP,John Cornyn,273,226,47,0
Ector,401,U.S. Senate,,REP,Over Votes,1,1,0,0
Ector,401,U.S. Senate,,REP,Under Votes,14,9,5,0
Ector,401,U.S. Senate,,DEM,"Mary ""MJ"" Hegar",145,126,19,0
Ector,401,U.S. Senate,,LIB,Kerry Douglas McKennon,10,7,3,0
Ector,401,U.S. Senate,,GRN,David B. Collins,6,5,1,0
Ector,401,U.S. Senate,,,Ricardo Turullols-Bonilla,0,0,0,0
Ector,401,U.S. House,11,REP,August Pfluger,275,230,45,0
Ector,401,U.S. House,11,REP,Over Votes,0,0,0,0
Ector,401,U.S. House,11,REP,Under Votes,15,11,4,0
Ector,401,U.S. House,11,DEM,Jon Mark Hogg,146,124,22,0
Ector,401,U.S. House,11,LIB,Wacey Alpha Cody,13,9,4,0
Ector,401,Railroad Commissioner,,REP,"James ""Jim"" Wright",280,238,42,0
Ector,401,Railroad Commissioner,,REP,Over Votes,1,1,0,0
Ector,401,Railroad Commissioner,,REP,Under Votes,14,10,4,0
Ector,401,Railroad Commissioner,,DEM,Chrysta Castañeda,139,113,26,0
Ector,401,Railroad Commissioner,,LIB,Matt Sterett,10,7,3,0
Ector,401,Railroad Commissioner,,GRN,"Katija ""Kat"" Gruene",5,5,0,0
Ector,401,"Chief Justice, Supreme Court",,REP,Nathan Hecht,268,224,44,0
Ector,401,"Chief Justice, Supreme Court",,REP,Over Votes,1,1,0,0
Ector,401,"Chief Justice, Supreme Court",,REP,Under Votes,16,12,4,0
Ector,401,"Chief Justice, Supreme Court",,DEM,Amy Clark Meachum,154,131,23,0
Ector,401,"Chief Justice, Supreme Court",,LIB,Mark Ash,10,6,4,0
Ector,401,"Justice, Supreme Court, Place 6, (Unexpired Term)",,REP,Jane Bland,285,239,46,0
Ector,401,"Justice, Supreme Court, Place 6, (Unexpired Term)",,REP,Over Votes,0,0,0,0
Ector,401,"Justice, Supreme Court, Place 6, (Unexpired Term)",,REP,Under Votes,14,10,4,0
Ector,401,"Justice, Supreme Court, Place 6, (Unexpired Term)",,DEM,Kathy Cheng,150,125,25,0
Ector,401,"Justice, Supreme Court, Place 7",,REP,Jeff Boyd,275,231,44,0
Ector,401,"Justice, Supreme Court, Place 7",,REP,Over Votes,0,0,0,0
Ector,401,"Justice, Supreme Court, Place 7",,REP,Under Votes,16,12,4,0
Ector,401,"Justice, Supreme Court, Place 7",,DEM,Staci Williams,148,123,25,0
Ector,401,"Justice, Supreme Court, Place 7",,LIB,William Bryan Strange III,10,8,2,0
Ector,401,"Justice, Supreme Court, Place 8",,REP,Brett Busby,272,226,46,0
Ector,401,"Justice, Supreme Court, Place 8",,REP,Over Votes,0,0,0,0
Ector,401,"Justice, Supreme Court, Place 8",,REP,Under Votes,19,15,4,0
Ector,401,"Justice, Supreme Court, Place 8",,DEM,Gisela D. Triana,149,124,25,0
Ector,401,"Justice, Supreme Court, Place 8",,LIB,Tom Oxford,9,9,0,0
Ector,401,"Judge, Court of Criminal Appeals, Place 3",,REP,Bert Richardson,282,237,45,0
Ector,401,"Judge, Court of Criminal Appeals, Place 3",,REP,Over Votes,0,0,0,0
Ector,401,"Judge, Court of Criminal Appeals, Place 3",,REP,Under Votes,15,11,4,0
Ector,401,"Judge, Court of Criminal Appeals, Place 3",,DEM,Elizabeth Davis Frizell,152,126,26,0
Ector,401,"Judge, Court of Criminal Appeals, Place 4",,REP,Kevin Patrick Yeary,283,237,46,0
Ector,401,"Judge, Court of Criminal Appeals, Place 4",,REP,Over Votes,0,0,0,0
Ector,401,"Judge, Court of Criminal Appeals, Place 4",,REP,Under Votes,16,12,4,0
Ector,401,"Judge, Court of Criminal Appeals, Place 4",,DEM,Tina Clinton,150,125,25,0
Ector,401,"Judge, Court of Criminal Appeals, Place 9",,REP,David Newell,282,237,45,0
Ector,401,"Judge, Court of Criminal Appeals, Place 9",,REP,Over Votes,0,0,0,0
Ector,401,"Judge, Court of Criminal Appeals, Place 9",,REP,Under Votes,17,13,4,0
Ector,401,"Judge, Court of Criminal Appeals, Place 9",,DEM,Brandon Birmingham,150,124,26,0
Ector,401,"Member, State Board of Education, District 1",,REP,Jennifer Ivey,281,238,43,0
Ector,401,"Member, State Board of Education, District 1",,REP,Over Votes,0,0,0,0
Ector,401,"Member, State Board of Education, District 1",,REP,Under Votes,21,17,4,0
Ector,401,"Member, State Board of Education, District 1",,DEM,Georgina Perez,147,119,28,0
Ector,401,State Representative,81,REP,Brooks Landgraf,340,285,55,0
Ector,401,State Representative,81,REP,Over Votes,0,0,0,0
Ector,401,State Representative,81,REP,Under Votes,109,89,20,0
Ector,401,"Justice, 11th Court of Appeals District, Place 2",,REP,Bruce Williams,337,278,59,0
Ector,401,"Justice, 11th Court of Appeals District, Place 2",,REP,Over Votes,0,0,0,0
Ector,401,"Justice, 11th Court of Appeals District, Place 2",,REP,Under Votes,112,96,16,0
Ector,401,"Justice, 11th Court of Appeals District, Place 3 (Unexpired Term)",,REP,W. Stacy Trotter,330,276,54,0
Ector,401,"Justice, 11th Court of Appeals District, Place 3 (Unexpired Term)",,REP,Over Votes,0,0,0,0
Ector,401,"Justice, 11th Court of Appeals District, Place 3 (Unexpired Term)",,REP,Under Votes,119,98,21,0
Ector,401,"District Judge, 161st Judicial District",,REP,Justin Low,329,275,54,0
Ector,401,"District Judge, 161st Judicial District",,REP,Over Votes,0,0,0,0
Ector,401,"District Judge, 161st Judicial District",,REP,Under Votes,120,99,21,0
Ector,401,"District Judge, 446th Judicial District",,REP,Sara Kate Billingsley,327,272,55,0
Ector,401,"District Judge, 446th Judicial District",,REP,Over Votes,0,0,0,0
Ector,401,"District Judge, 446th Judicial District",,REP,Under Votes,122,102,20,0
Ector,401,"District Attorney, 70th Judicial District",,REP,Dusty Gallivan,332,277,55,0
Ector,401,"District Attorney, 70th Judicial District",,REP,Over Votes,0,0,0,0
Ector,401,"District Attorney, 70th Judicial District",,REP,Under Votes,117,97,20,0
Ector,401,Mayor,,,Dewey Bryant,177,152,25,0
Ector,401,Mayor,,,Over Votes,0,0,0,0
Ector,401,Mayor,,,Under Votes,51,41,10,0
Ector,401,Mayor,,,Javier Joven,135,110,25,0
Ector,401,Mayor,,,Gloria G. Apolinario,86,71,15,0
Ector,401,"Council Member, District 1",,,Mark Matta,160,132,28,0
Ector,401,"Council Member, District 1",,,Over Votes,0,0,0,0
Ector,401,"Council Member, District 1",,,Under Votes,62,53,9,0
Ector,401,"Council Member, District 1",,,Michael K. Shelton Sr.,100,81,19,0
Ector,401,"Council Member, District 1",,,Tiki Davis,83,72,11,0
Ector,401,"Council Member, District 1",,,Eddie Mitchell,44,36,8,0
Ector,401,"Council Member, At-Large",,,David R. Turner,156,131,25,0
Ector,401,"Council Member, At-Large",,,Over Votes,0,0,0,0
Ector,401,"Council Member, At-Large",,,Under Votes,58,47,11,0
Ector,401,"Council Member, At-Large",,,La-Tasha Gentry,57,46,11,0
Ector,401,"Council Member, At-Large",,,Jo Ann Davenport Littleton,64,56,8,0
Ector,401,"Council Member, At-Large",,,Denise Swanner,114,94,20,0
Ector,402 City,President,,REP,Donald J. Trump / Michael R. Pence,275,180,95,0
Ector,402 City,President,,REP,Over Votes,2,2,0,0
Ector,402 City,President,,REP,Under Votes,7,5,2,0
Ector,402 City,President,,DEM,Joseph R. Biden / Kamala D. Harris,470,377,93,0
Ector,402 City,President,,LIB,"Jo Jorgensen / Jeremy ""Spike"" Cohen",6,5,1,0
Ector,402 City,President,,GRN,Howie Hawkins / Angela Walker,3,2,1,0
Ector,402 City,President,,,President R. Boddie/Eric C. Stoneham,0,0,0,0
Ector,402 City,President,,,Brian Carroll/Amar Patel,0,0,0,0
Ector,402 City,President,,,Todd Cella/Tim Cella,0,0,0,0
Ector,402 City,President,,,Jesse Cuellar/Jimmy Monreal,1,1,0,0
Ector,402 City,President,,,Tom Hoefling/Andy Prior,0,0,0,0
Ector,402 City,President,,,Gloria La Riva/Leonard Peltier,0,0,0,0
Ector,402 City,President,,,Abram Loeb/Jennifer Jairala,0,0,0,0
Ector,402 City,President,,,Robert Morrow/Anne Beckett,0,0,0,0
Ector,402 City,President,,,Kasey Wells/Rachel Wells,0,0,0,0
Ector,402 City,U.S. Senate,,REP,John Cornyn,258,175,83,0
Ector,402 City,U.S. Senate,,REP,Over Votes,0,0,0,0
Ector,402 City,U.S. Senate,,REP,Under Votes,36,19,17,0
Ector,402 City,U.S. Senate,,DEM,"Mary ""MJ"" Hegar",447,364,83,0
Ector,402 City,U.S. Senate,,LIB,Kerry Douglas McKennon,16,10,6,0
Ector,402 City,U.S. Senate,,GRN,David B. Collins,7,4,3,0
Ector,402 City,U.S. Senate,,,Ricardo Turullols-Bonilla,0,0,0,0
Ector,402 City,U.S. House,11,REP,August Pfluger,250,168,82,0
Ector,402 City,U.S. House,11,REP,Over Votes,0,0,0,0
Ector,402 City,U.S. House,11,REP,Under Votes,45,25,20,0
Ector,402 City,U.S. House,11,DEM,Jon Mark Hogg,452,369,83,0
Ector,402 City,U.S. House,11,LIB,Wacey Alpha Cody,17,10,7,0
Ector,402 City,Railroad Commissioner,,REP,"James ""Jim"" Wright",248,163,85,0
Ector,402 City,Railroad Commissioner,,REP,Over Votes,0,0,0,0
Ector,402 City,Railroad Commissioner,,REP,Under Votes,46,28,18,0
Ector,402 City,Railroad Commissioner,,DEM,Chrysta Castañeda,444,365,79,0
Ector,402 City,Railroad Commissioner,,LIB,Matt Sterett,19,12,7,0
Ector,402 City,Railroad Commissioner,,GRN,"Katija ""Kat"" Gruene",7,4,3,0
Ector,402 City,"Chief Justice, Supreme Court",,REP,Nathan Hecht,237,158,79,0
Ector,402 City,"Chief Justice, Supreme Court",,REP,Over Votes,0,0,0,0
Ector,402 City,"Chief Justice, Supreme Court",,REP,Under Votes,49,30,19,0
Ector,402 City,"Chief Justice, Supreme Court",,DEM,Amy Clark Meachum,454,369,85,0
Ector,402 City,"Chief Justice, Supreme Court",,LIB,Mark Ash,24,15,9,0
Ector,402 City,"Justice, Supreme Court, Place 6, (Unexpired Term)",,REP,Jane Bland,258,173,85,0
Ector,402 City,"Justice, Supreme Court, Place 6, (Unexpired Term)",,REP,Over Votes,0,0,0,0
Ector,402 City,"Justice, Supreme Court, Place 6, (Unexpired Term)",,REP,Under Votes,53,31,22,0
Ector,402 City,"Justice, Supreme Court, Place 6, (Unexpired Term)",,DEM,Kathy Cheng,453,368,85,0
Ector,402 City,"Justice, Supreme Court, Place 7",,REP,Jeff Boyd,243,159,84,0
Ector,402 City,"Justice, Supreme Court, Place 7",,REP,Over Votes,0,0,0,0
Ector,402 City,"Justice, Supreme Court, Place 7",,REP,Under Votes,52,32,20,0
Ector,402 City,"Justice, Supreme Court, Place 7",,DEM,Staci Williams,450,371,79,0
Ector,402 City,"Justice, Supreme Court, Place 7",,LIB,William Bryan Strange III,19,10,9,0
Ector,402 City,"Justice, Supreme Court, Place 8",,REP,Brett Busby,244,162,82,0
Ector,402 City,"Justice, Supreme Court, Place 8",,REP,Over Votes,0,0,0,0
Ector,402 City,"Justice, Supreme Court, Place 8",,REP,Under Votes,55,33,22,0
Ector,402 City,"Justice, Supreme Court, Place 8",,DEM,Gisela D. Triana,445,365,80,0
Ector,402 City,"Justice, Supreme Court, Place 8",,LIB,Tom Oxford,20,12,8,0
Ector,402 City,"Judge, Court of Criminal Appeals, Place 3",,REP,Bert Richardson,251,167,84,0
Ector,402 City,"Judge, Court of Criminal Appeals, Place 3",,REP,Over Votes,0,0,0,0
Ector,402 City,"Judge, Court of Criminal Appeals, Place 3",,REP,Under Votes,56,35,21,0
Ector,402 City,"Judge, Court of Criminal Appeals, Place 3",,DEM,Elizabeth Davis Frizell,457,370,87,0
Ector,402 City,"Judge, Court of Criminal Appeals, Place 4",,REP,Kevin Patrick Yeary,257,173,84,0
Ector,402 City,"Judge, Court of Criminal Appeals, Place 4",,REP,Over Votes,0,0,0,0
Ector,402 City,"Judge, Court of Criminal Appeals, Place 4",,REP,Under Votes,56,35,21,0
Ector,402 City,"Judge, Court of Criminal Appeals, Place 4",,DEM,Tina Clinton,451,364,87,0
Ector,402 City,"Judge, Court of Criminal Appeals, Place 9",,REP,David Newell,254,168,86,0
Ector,402 City,"Judge, Court of Criminal Appeals, Place 9",,REP,Over Votes,0,0,0,0
Ector,402 City,"Judge, Court of Criminal Appeals, Place 9",,REP,Under Votes,56,34,22,0
Ector,402 City,"Judge, Court of Criminal Appeals, Place 9",,DEM,Brandon Birmingham,454,370,84,0
Ector,402 City,"Member, State Board of Education, District 1",,REP,Jennifer Ivey,251,168,83,0
Ector,402 City,"Member, State Board of Education, District 1",,REP,Over Votes,0,0,0,0
Ector,402 City,"Member, State Board of Education, District 1",,REP,Under Votes,51,30,21,0
Ector,402 City,"Member, State Board of Education, District 1",,DEM,Georgina Perez,462,374,88,0
Ector,402 City,State Representative,81,REP,Brooks Landgraf,446,315,131,0
Ector,402 City,State Representative,81,REP,Over Votes,0,0,0,0
Ector,402 City,State Representative,81,REP,Under Votes,318,257,61,0
Ector,402 City,"Justice, 11th Court of Appeals District, Place 2",,REP,Bruce Williams,432,300,132,0
Ector,402 City,"Justice, 11th Court of Appeals District, Place 2",,REP,Over Votes,0,0,0,0
Ector,402 City,"Justice, 11th Court of Appeals District, Place 2",,REP,Under Votes,332,272,60,0
Ector,402 City,"Justice, 11th Court of Appeals District, Place 3 (Unexpired Term)",,REP,W. Stacy Trotter,431,305,126,0
Ector,402 City,"Justice, 11th Court of Appeals District, Place 3 (Unexpired Term)",,REP,Over Votes,0,0,0,0
Ector,402 City,"Justice, 11th Court of Appeals District, Place 3 (Unexpired Term)",,REP,Under Votes,333,267,66,0
Ector,402 City,"District Judge, 161st Judicial District",,REP,Justin Low,433,305,128,0
Ector,402 City,"District Judge, 161st Judicial District",,REP,Over Votes,0,0,0,0
Ector,402 City,"District Judge, 161st Judicial District",,REP,Under Votes,331,267,64,0
Ector,402 City,"District Judge, 446th Judicial District",,REP,Sara Kate Billingsley,427,303,124,0
Ector,402 City,"District Judge, 446th Judicial District",,REP,Over Votes,0,0,0,0
Ector,402 City,"District Judge, 446th Judicial District",,REP,Under Votes,337,269,68,0
Ector,402 City,"District Attorney, 70th Judicial District",,REP,Dusty Gallivan,432,307,125,0
Ector,402 City,"District Attorney, 70th Judicial District",,REP,Over Votes,0,0,0,0
Ector,402 City,"District Attorney, 70th Judicial District",,REP,Under Votes,332,265,67,0
Ector,402 City,Mayor,,,Dewey Bryant,227,174,53,0
Ector,402 City,Mayor,,,Over Votes,0,0,0,0
Ector,402 City,Mayor,,,Under Votes,100,65,35,0
Ector,402 City,Mayor,,,Javier Joven,241,179,62,0
Ector,402 City,Mayor,,,Gloria G. Apolinario,196,154,42,0
Ector,402 City,"Council Member, District 1",,,Mark Matta,194,142,52,0
Ector,402 City,"Council Member, District 1",,,Over Votes,0,0,0,0
Ector,402 City,"Council Member, District 1",,,Under Votes,77,46,31,0
Ector,402 City,"Council Member, District 1",,,Michael K. Shelton Sr.,110,88,22,0
Ector,402 City,"Council Member, District 1",,,Tiki Davis,193,149,44,0
Ector,402 City,"Council Member, District 1",,,Eddie Mitchell,190,147,43,0
Ector,402 City,"Council Member, At-Large",,,David R. Turner,199,134,65,0
Ector,402 City,"Council Member, At-Large",,,Over Votes,0,0,0,0
Ector,402 City,"Council Member, At-Large",,,Under Votes,75,41,34,0
Ector,402 City,"Council Member, At-Large",,,La-Tasha Gentry,168,123,45,0
Ector,402 City,"Council Member, At-Large",,,Jo Ann Davenport Littleton,257,219,38,0
Ector,402 City,"Council Member, At-Large",,,Denise Swanner,65,55,10,0
Ector,402 County,President,,REP,Donald J. Trump / Michael R. Pence,131,102,29,0
Ector,402 County,President,,REP,Over Votes,0,0,0,0
Ector,402 County,President,,REP,Under Votes,0,0,0,0
Ector,402 County,President,,DEM,Joseph R. Biden / Kamala D. Harris,52,40,12,0
Ector,402 County,President,,LIB,"Jo Jorgensen / Jeremy ""Spike"" Cohen",0,0,0,0
Ector,402 County,President,,GRN,Howie Hawkins / Angela Walker,0,0,0,0
Ector,402 County,President,,,President R. Boddie/Eric C. Stoneham,0,0,0,0
Ector,402 County,President,,,Brian Carroll/Amar Patel,0,0,0,0
Ector,402 County,President,,,Todd Cella/Tim Cella,0,0,0,0
Ector,402 County,President,,,Jesse Cuellar/Jimmy Monreal,0,0,0,0
Ector,402 County,President,,,Tom Hoefling/Andy Prior,0,0,0,0
Ector,402 County,President,,,Gloria La Riva/Leonard Peltier,0,0,0,0
Ector,402 County,President,,,Abram Loeb/Jennifer Jairala,0,0,0,0
Ector,402 County,President,,,Robert Morrow/Anne Beckett,0,0,0,0
Ector,402 County,President,,,Kasey Wells/Rachel Wells,0,0,0,0
Ector,402 County,U.S. Senate,,REP,John Cornyn,125,97,28,0
Ector,402 County,U.S. Senate,,REP,Over Votes,0,0,0,0
Ector,402 County,U.S. Senate,,REP,Under Votes,5,5,0,0
Ector,402 County,U.S. Senate,,DEM,"Mary ""MJ"" Hegar",50,38,12,0
Ector,402 County,U.S. Senate,,LIB,Kerry Douglas McKennon,3,2,1,0
Ector,402 County,U.S. Senate,,GRN,David B. Collins,0,0,0,0
Ector,402 County,U.S. Senate,,,Ricardo Turullols-Bonilla,0,0,0,0
Ector,402 County,U.S. House,11,REP,August Pfluger,123,96,27,0
Ector,402 County,U.S. House,11,REP,Over Votes,0,0,0,0
Ector,402 County,U.S. House,11,REP,Under Votes,6,4,2,0
Ector,402 County,U.S. House,11,DEM,Jon Mark Hogg,46,36,10,0
Ector,402 County,U.S. House,11,LIB,Wacey Alpha Cody,8,6,2,0
Ector,402 County,Railroad Commissioner,,REP,"James ""Jim"" Wright",129,101,28,0
Ector,402 County,Railroad Commissioner,,REP,Over Votes,0,0,0,0
Ector,402 County,Railroad Commissioner,,REP,Under Votes,4,3,1,0
Ector,402 County,Railroad Commissioner,,DEM,Chrysta Castañeda,46,34,12,0
Ector,402 County,Railroad Commissioner,,LIB,Matt Sterett,2,2,0,0
Ector,402 County,Railroad Commissioner,,GRN,"Katija ""Kat"" Gruene",2,2,0,0
Ector,402 County,"Chief Justice, Supreme Court",,REP,Nathan Hecht,124,97,27,0
Ector,402 County,"Chief Justice, Supreme Court",,REP,Over Votes,0,0,0,0
Ector,402 County,"Chief Justice, Supreme Court",,REP,Under Votes,5,4,1,0
Ector,402 County,"Chief Justice, Supreme Court",,DEM,Amy Clark Meachum,49,37,12,0
Ector,402 County,"Chief Justice, Supreme Court",,LIB,Mark Ash,5,4,1,0
Ector,402 County,"Justice, Supreme Court, Place 6, (Unexpired Term)",,REP,Jane Bland,129,101,28,0
Ector,402 County,"Justice, Supreme Court, Place 6, (Unexpired Term)",,REP,Over Votes,0,0,0,0
Ector,402 County,"Justice, Supreme Court, Place 6, (Unexpired Term)",,REP,Under Votes,4,3,1,0
Ector,402 County,"Justice, Supreme Court, Place 6, (Unexpired Term)",,DEM,Kathy Cheng,50,38,12,0
Ector,402 County,"Justice, Supreme Court, Place 7",,REP,Jeff Boyd,122,94,28,0
Ector,402 County,"Justice, Supreme Court, Place 7",,REP,Over Votes,0,0,0,0
Ector,402 County,"Justice, Supreme Court, Place 7",,REP,Under Votes,7,6,1,0
Ector,402 County,"Justice, Supreme Court, Place 7",,DEM,Staci Williams,49,39,10,0
Ector,402 County,"Justice, Supreme Court, Place 7",,LIB,William Bryan Strange III,5,3,2,0
Ector,402 County,"Justice, Supreme Court, Place 8",,REP,Brett Busby,124,97,27,0
Ector,402 County,"Justice, Supreme Court, Place 8",,REP,Over Votes,0,0,0,0
Ector,402 County,"Justice, Supreme Court, Place 8",,REP,Under Votes,6,5,1,0
Ector,402 County,"Justice, Supreme Court, Place 8",,DEM,Gisela D. Triana,47,36,11,0
Ector,402 County,"Justice, Supreme Court, Place 8",,LIB,Tom Oxford,6,4,2,0
Ector,402 County,"Judge, Court of Criminal Appeals, Place 3",,REP,Bert Richardson,124,98,26,0
Ector,402 County,"Judge, Court of Criminal Appeals, Place 3",,REP,Over Votes,0,0,0,0
Ector,402 County,"Judge, Court of Criminal Appeals, Place 3",,REP,Under Votes,6,5,1,0
Ector,402 County,"Judge, Court of Criminal Appeals, Place 3",,DEM,Elizabeth Davis Frizell,53,39,14,0
Ector,402 County,"Judge, Court of Criminal Appeals, Place 4",,REP,Kevin Patrick Yeary,126,97,29,0
Ector,402 County,"Judge, Court of Criminal Appeals, Place 4",,REP,Over Votes,0,0,0,0
Ector,402 County,"Judge, Court of Criminal Appeals, Place 4",,REP,Under Votes,7,6,1,0
Ector,402 County,"Judge, Court of Criminal Appeals, Place 4",,DEM,Tina Clinton,50,39,11,0
Ector,402 County,"Judge, Court of Criminal Appeals, Place 9",,REP,David Newell,127,98,29,0
Ector,402 County,"Judge, Court of Criminal Appeals, Place 9",,REP,Over Votes,0,0,0,0
Ector,402 County,"Judge, Court of Criminal Appeals, Place 9",,REP,Under Votes,7,6,1,0
Ector,402 County,"Judge, Court of Criminal Appeals, Place 9",,DEM,Brandon Birmingham,49,38,11,0
Ector,402 County,"Member, State Board of Education, District 1",,REP,Jennifer Ivey,124,97,27,0
Ector,402 County,"Member, State Board of Education, District 1",,REP,Over Votes,0,0,0,0
Ector,402 County,"Member, State Board of Education, District 1",,REP,Under Votes,6,4,2,0
Ector,402 County,"Member, State Board of Education, District 1",,DEM,Georgina Perez,53,41,12,0
Ector,402 County,State Representative,81,REP,Brooks Landgraf,147,112,35,0
Ector,402 County,State Representative,81,REP,Over Votes,0,0,0,0
Ector,402 County,State Representative,81,REP,Under Votes,36,30,6,0
Ector,402 County,"Justice, 11th Court of Appeals District, Place 2",,REP,Bruce Williams,146,113,33,0
Ector,402 County,"Justice, 11th Court of Appeals District, Place 2",,REP,Over Votes,0,0,0,0
Ector,402 County,"Justice, 11th Court of Appeals District, Place 2",,REP,Under Votes,37,29,8,0
Ector,402 County,"Justice, 11th Court of Appeals District, Place 3 (Unexpired Term)",,REP,W. Stacy Trotter,145,111,34,0
Ector,402 County,"Justice, 11th Court of Appeals District, Place 3 (Unexpired Term)",,REP,Over Votes,0,0,0,0
Ector,402 County,"Justice, 11th Court of Appeals District, Place 3 (Unexpired Term)",,REP,Under Votes,38,31,7,0
Ector,402 County,"District Judge, 161st Judicial District",,REP,Justin Low,146,112,34,0
Ector,402 County,"District Judge, 161st Judicial District",,REP,Over Votes,0,0,0,0
Ector,402 County,"District Judge, 161st Judicial District",,REP,Under Votes,37,30,7,0
Ector,402 County,"District Judge, 446th Judicial District",,REP,Sara Kate Billingsley,144,109,35,0
Ector,402 County,"District Judge, 446th Judicial District",,REP,Over Votes,0,0,0,0
Ector,402 County,"District Judge, 446th Judicial District",,REP,Under Votes,39,33,6,0
Ector,402 County,"District Attorney, 70th Judicial District",,REP,Dusty Gallivan,145,111,34,0
Ector,402 County,"District Attorney, 70th Judicial District",,REP,Over Votes,0,0,0,0
Ector,402 County,"District Attorney, 70th Judicial District",,REP,Under Votes,38,31,7,0
Ector,403,President,,REP,Donald J. Trump / Michael R. Pence,545,390,155,0
Ector,403,President,,REP,Over Votes,0,0,0,0
Ector,403,President,,REP,Under Votes,15,11,4,0
Ector,403,President,,DEM,Joseph R. Biden / Kamala D. Harris,694,579,115,0
Ector,403,President,,LIB,"Jo Jorgensen / Jeremy ""Spike"" Cohen",4,2,2,0
Ector,403,President,,GRN,Howie Hawkins / Angela Walker,6,5,1,0
Ector,403,President,,,President R. Boddie/Eric C. Stoneham,0,0,0,0
Ector,403,President,,,Brian Carroll/Amar Patel,0,0,0,0
Ector,403,President,,,Todd Cella/Tim Cella,0,0,0,0
Ector,403,President,,,Jesse Cuellar/Jimmy Monreal,0,0,0,0
Ector,403,President,,,Tom Hoefling/Andy Prior,0,0,0,0
Ector,403,President,,,Gloria La Riva/Leonard Peltier,0,0,0,0
Ector,403,President,,,Abram Loeb/Jennifer Jairala,0,0,0,0
Ector,403,President,,,Robert Morrow/Anne Beckett,0,0,0,0
Ector,403,President,,,Kasey Wells/Rachel Wells,0,0,0,0
Ector,403,U.S. Senate,,REP,John Cornyn,482,356,126,0
Ector,403,U.S. Senate,,REP,Over Votes,0,0,0,0
Ector,403,U.S. Senate,,REP,Under Votes,112,89,23,0
Ector,403,U.S. Senate,,DEM,"Mary ""MJ"" Hegar",640,526,114,0
Ector,403,U.S. Senate,,LIB,Kerry Douglas McKennon,16,7,9,0
Ector,403,U.S. Senate,,GRN,David B. Collins,14,9,5,0
Ector,403,U.S. Senate,,,Ricardo Turullols-Bonilla,0,0,0,0
Ector,403,U.S. House,11,REP,August Pfluger,474,347,127,0
Ector,403,U.S. House,11,REP,Over Votes,0,0,0,0
Ector,403,U.S. House,11,REP,Under Votes,128,103,25,0
Ector,403,U.S. House,11,DEM,Jon Mark Hogg,635,520,115,0
Ector,403,U.S. House,11,LIB,Wacey Alpha Cody,27,17,10,0
Ector,403,Railroad Commissioner,,REP,"James ""Jim"" Wright",455,331,124,0
Ector,403,Railroad Commissioner,,REP,Over Votes,0,0,0,0
Ector,403,Railroad Commissioner,,REP,Under Votes,130,106,24,0
Ector,403,Railroad Commissioner,,DEM,Chrysta Castañeda,651,535,116,0
Ector,403,Railroad Commissioner,,LIB,Matt Sterett,13,7,6,0
Ector,403,Railroad Commissioner,,GRN,"Katija ""Kat"" Gruene",15,8,7,0
Ector,403,"Chief Justice, Supreme Court",,REP,Nathan Hecht,434,320,114,0
Ector,403,"Chief Justice, Supreme Court",,REP,Over Votes,0,0,0,0
Ector,403,"Chief Justice, Supreme Court",,REP,Under Votes,138,112,26,0
Ector,403,"Chief Justice, Supreme Court",,DEM,Amy Clark Meachum,664,538,126,0
Ector,403,"Chief Justice, Supreme Court",,LIB,Mark Ash,28,17,11,0
Ector,403,"Justice, Supreme Court, Place 6, (Unexpired Term)",,REP,Jane Bland,480,348,132,0
Ector,403,"Justice, Supreme Court, Place 6, (Unexpired Term)",,REP,Over Votes,0,0,0,0
Ector,403,"Justice, Supreme Court, Place 6, (Unexpired Term)",,REP,Under Votes,149,120,29,0
Ector,403,"Justice, Supreme Court, Place 6, (Unexpired Term)",,DEM,Kathy Cheng,635,519,116,0
Ector,403,"Justice, Supreme Court, Place 7",,REP,Jeff Boyd,462,340,122,0
Ector,403,"Justice, Supreme Court, Place 7",,REP,Over Votes,0,0,0,0
Ector,403,"Justice, Supreme Court, Place 7",,REP,Under Votes,141,114,27,0
Ector,403,"Justice, Supreme Court, Place 7",,DEM,Staci Williams,639,520,119,0
Ector,403,"Justice, Supreme Court, Place 7",,LIB,William Bryan Strange III,22,13,9,0
Ector,403,"Justice, Supreme Court, Place 8",,REP,Brett Busby,445,329,116,0
Ector,403,"Justice, Supreme Court, Place 8",,REP,Over Votes,0,0,0,0
Ector,403,"Justice, Supreme Court, Place 8",,REP,Under Votes,148,121,27,0
Ector,403,"Justice, Supreme Court, Place 8",,DEM,Gisela D. Triana,644,521,123,0
Ector,403,"Justice, Supreme Court, Place 8",,LIB,Tom Oxford,27,16,11,0
Ector,403,"Judge, Court of Criminal Appeals, Place 3",,REP,Bert Richardson,448,331,117,0
Ector,403,"Judge, Court of Criminal Appeals, Place 3",,REP,Over Votes,0,0,0,0
Ector,403,"Judge, Court of Criminal Appeals, Place 3",,REP,Under Votes,152,123,29,0
Ector,403,"Judge, Court of Criminal Appeals, Place 3",,DEM,Elizabeth Davis Frizell,664,533,131,0
Ector,403,"Judge, Court of Criminal Appeals, Place 4",,REP,Kevin Patrick Yeary,457,334,123,0
Ector,403,"Judge, Court of Criminal Appeals, Place 4",,REP,Over Votes,0,0,0,0
Ector,403,"Judge, Court of Criminal Appeals, Place 4",,REP,Under Votes,146,119,27,0
Ector,403,"Judge, Court of Criminal Appeals, Place 4",,DEM,Tina Clinton,661,534,127,0
Ector,403,"Judge, Court of Criminal Appeals, Place 9",,REP,David Newell,474,346,128,0
Ector,403,"Judge, Court of Criminal Appeals, Place 9",,REP,Over Votes,0,0,0,0
Ector,403,"Judge, Court of Criminal Appeals, Place 9",,REP,Under Votes,149,121,28,0
Ector,403,"Judge, Court of Criminal Appeals, Place 9",,DEM,Brandon Birmingham,641,520,121,0
Ector,403,"Member, State Board of Education, District 1",,REP,Jennifer Ivey,456,334,122,0
Ector,403,"Member, State Board of Education, District 1",,REP,Over Votes,0,0,0,0
Ector,403,"Member, State Board of Education, District 1",,REP,Under Votes,148,118,30,0
Ector,403,"Member, State Board of Education, District 1",,DEM,Georgina Perez,660,535,125,0
Ector,403,State Representative,81,REP,Brooks Landgraf,751,568,183,0
Ector,403,State Representative,81,REP,Over Votes,0,0,0,0
Ector,403,State Representative,81,REP,Under Votes,513,419,94,0
Ector,403,"Justice, 11th Court of Appeals District, Place 2",,REP,Bruce Williams,707,525,182,0
Ector,403,"Justice, 11th Court of Appeals District, Place 2",,REP,Over Votes,0,0,0,0
Ector,403,"Justice, 11th Court of Appeals District, Place 2",,REP,Under Votes,557,462,95,0
Ector,403,"Justice, 11th Court of Appeals District, Place 3 (Unexpired Term)",,REP,W. Stacy Trotter,707,533,174,0
Ector,403,"Justice, 11th Court of Appeals District, Place 3 (Unexpired Term)",,REP,Over Votes,0,0,0,0
Ector,403,"Justice, 11th Court of Appeals District, Place 3 (Unexpired Term)",,REP,Under Votes,557,454,103,0
Ector,403,"District Judge, 161st Judicial District",,REP,Justin Low,710,535,175,0
Ector,403,"District Judge, 161st Judicial District",,REP,Over Votes,0,0,0,0
Ector,403,"District Judge, 161st Judicial District",,REP,Under Votes,554,452,102,0
Ector,403,"District Judge, 446th Judicial District",,REP,Sara Kate Billingsley,714,538,176,0
Ector,403,"District Judge, 446th Judicial District",,REP,Over Votes,0,0,0,0
Ector,403,"District Judge, 446th Judicial District",,REP,Under Votes,550,449,101,0
Ector,403,"District Attorney, 70th Judicial District",,REP,Dusty Gallivan,717,540,177,0
Ector,403,"District Attorney, 70th Judicial District",,REP,Over Votes,0,0,0,0
Ector,403,"District Attorney, 70th Judicial District",,REP,Under Votes,547,447,100,0
Ector,403,Mayor,,,Dewey Bryant,315,253,62,0
Ector,403,Mayor,,,Over Votes,0,0,0,0
Ector,403,Mayor,,,Under Votes,217,167,50,0
Ector,403,Mayor,,,Javier Joven,505,387,118,0
Ector,403,Mayor,,,Gloria G. Apolinario,227,180,47,0
Ector,403,"Council Member, District 1",,,Mark Matta,479,387,92,0
Ector,403,"Council Member, District 1",,,Over Votes,0,0,0,0
Ector,403,"Council Member, District 1",,,Under Votes,206,151,55,0
Ector,403,"Council Member, District 1",,,Michael K. Shelton Sr.,128,101,27,0
Ector,403,"Council Member, District 1",,,Tiki Davis,175,128,47,0
Ector,403,"Council Member, District 1",,,Eddie Mitchell,276,220,56,0
Ector,403,"Council Member, At-Large",,,David R. Turner,325,245,80,0
Ector,403,"Council Member, At-Large",,,Over Votes,0,0,0,0
Ector,403,"Council Member, At-Large",,,Under Votes,223,161,62,0
Ector,403,"Council Member, At-Large",,,La-Tasha Gentry,194,145,49,0
Ector,403,"Council Member, At-Large",,,Jo Ann Davenport Littleton,387,322,65,0
Ector,403,"Council Member, At-Large",,,Denise Swanner,135,114,21,0
Ector,404,President,,REP,Donald J. Trump / Michael R. Pence,662,432,230,0
Ector,404,President,,REP,Over Votes,0,0,0,0
Ector,404,President,,REP,Under Votes,7,4,3,0
Ector,404,President,,DEM,Joseph R. Biden / Kamala D. Harris,247,173,74,0
Ector,404,President,,LIB,"Jo Jorgensen / Jeremy ""Spike"" Cohen",6,4,2,0
Ector,404,President,,GRN,Howie Hawkins / Angela Walker,2,1,1,0
Ector,404,President,,,President R. Boddie/Eric C. Stoneham,0,0,0,0
Ector,404,President,,,Brian Carroll/Amar Patel,0,0,0,0
Ector,404,President,,,Todd Cella/Tim Cella,0,0,0,0
Ector,404,President,,,Jesse Cuellar/Jimmy Monreal,0,0,0,0
Ector,404,President,,,Tom Hoefling/Andy Prior,0,0,0,0
Ector,404,President,,,Gloria La Riva/Leonard Peltier,0,0,0,0
Ector,404,President,,,Abram Loeb/Jennifer Jairala,0,0,0,0
Ector,404,President,,,Robert Morrow/Anne Beckett,0,0,0,0
Ector,404,President,,,Kasey Wells/Rachel Wells,0,0,0,0
Ector,404,U.S. Senate,,REP,John Cornyn,617,412,205,0
Ector,404,U.S. Senate,,REP,Over Votes,0,0,0,0
Ector,404,U.S. Senate,,REP,Under Votes,45,25,20,0
Ector,404,U.S. Senate,,DEM,"Mary ""MJ"" Hegar",234,162,72,0
Ector,404,U.S. Senate,,LIB,Kerry Douglas McKennon,20,13,7,0
Ector,404,U.S. Senate,,GRN,David B. Collins,8,2,6,0
Ector,404,U.S. Senate,,,Ricardo Turullols-Bonilla,0,0,0,0
Ector,404,U.S. House,11,REP,August Pfluger,622,412,210,0
Ector,404,U.S. House,11,REP,Over Votes,0,0,0,0
Ector,404,U.S. House,11,REP,Under Votes,57,32,25,0
Ector,404,U.S. House,11,DEM,Jon Mark Hogg,226,160,66,0
Ector,404,U.S. House,11,LIB,Wacey Alpha Cody,19,10,9,0
Ector,404,Railroad Commissioner,,REP,"James ""Jim"" Wright",620,411,209,0
Ector,404,Railroad Commissioner,,REP,Over Votes,0,0,0,0
Ector,404,Railroad Commissioner,,REP,Under Votes,48,26,22,0
Ector,404,Railroad Commissioner,,DEM,Chrysta Castañeda,230,162,68,0
Ector,404,Railroad Commissioner,,LIB,Matt Sterett,22,13,9,0
Ector,404,Railroad Commissioner,,GRN,"Katija ""Kat"" Gruene",4,2,2,0
Ector,404,"Chief Justice, Supreme Court",,REP,Nathan Hecht,614,409,205,0
Ector,404,"Chief Justice, Supreme Court",,REP,Over Votes,0,0,0,0
Ector,404,"Chief Justice, Supreme Court",,REP,Under Votes,51,30,21,0
Ector,404,"Chief Justice, Supreme Court",,DEM,Amy Clark Meachum,236,161,75,0
Ector,404,"Chief Justice, Supreme Court",,LIB,Mark Ash,23,14,9,0
Ector,404,"Justice, Supreme Court, Place 6, (Unexpired Term)",,REP,Jane Bland,641,422,219,0
Ector,404,"Justice, Supreme Court, Place 6, (Unexpired Term)",,REP,Over Votes,0,0,0,0
Ector,404,"Justice, Supreme Court, Place 6, (Unexpired Term)",,REP,Under Votes,54,31,23,0
Ector,404,"Justice, Supreme Court, Place 6, (Unexpired Term)",,DEM,Kathy Cheng,229,161,68,0
Ector,404,"Justice, Supreme Court, Place 7",,REP,Jeff Boyd,618,409,209,0
Ector,404,"Justice, Supreme Court, Place 7",,REP,Over Votes,0,0,0,0
Ector,404,"Justice, Supreme Court, Place 7",,REP,Under Votes,52,27,25,0
Ector,404,"Justice, Supreme Court, Place 7",,DEM,Staci Williams,234,163,71,0
Ector,404,"Justice, Supreme Court, Place 7",,LIB,William Bryan Strange III,20,15,5,0
Ector,404,"Justice, Supreme Court, Place 8",,REP,Brett Busby,609,401,208,0
Ector,404,"Justice, Supreme Court, Place 8",,REP,Over Votes,0,0,0,0
Ector,404,"Justice, Supreme Court, Place 8",,REP,Under Votes,51,28,23,0
Ector,404,"Justice, Supreme Court, Place 8",,DEM,Gisela D. Triana,241,168,73,0
Ector,404,"Justice, Supreme Court, Place 8",,LIB,Tom Oxford,23,17,6,0
Ector,404,"Judge, Court of Criminal Appeals, Place 3",,REP,Bert Richardson,623,414,209,0
Ector,404,"Judge, Court of Criminal Appeals, Place 3",,REP,Over Votes,0,0,0,0
Ector,404,"Judge, Court of Criminal Appeals, Place 3",,REP,Under Votes,54,29,25,0
Ector,404,"Judge, Court of Criminal Appeals, Place 3",,DEM,Elizabeth Davis Frizell,247,171,76,0
Ector,404,"Judge, Court of Criminal Appeals, Place 4",,REP,Kevin Patrick Yeary,619,411,208,0
Ector,404,"Judge, Court of Criminal Appeals, Place 4",,REP,Over Votes,0,0,0,0
Ector,404,"Judge, Court of Criminal Appeals, Place 4",,REP,Under Votes,54,30,24,0
Ector,404,"Judge, Court of Criminal Appeals, Place 4",,DEM,Tina Clinton,251,173,78,0
Ector,404,"Judge, Court of Criminal Appeals, Place 9",,REP,David Newell,622,410,212,0
Ector,404,"Judge, Court of Criminal Appeals, Place 9",,REP,Over Votes,0,0,0,0
Ector,404,"Judge, Court of Criminal Appeals, Place 9",,REP,Under Votes,54,30,24,0
Ector,404,"Judge, Court of Criminal Appeals, Place 9",,DEM,Brandon Birmingham,248,174,74,0
Ector,404,"Member, State Board of Education, District 1",,REP,Jennifer Ivey,607,403,204,0
Ector,404,"Member, State Board of Education, District 1",,REP,Over Votes,0,0,0,0
Ector,404,"Member, State Board of Education, District 1",,REP,Under Votes,59,35,24,0
Ector,404,"Member, State Board of Education, District 1",,DEM,Georgina Perez,258,176,82,0
Ector,404,State Representative,81,REP,Brooks Landgraf,753,491,262,0
Ector,404,State Representative,81,REP,Over Votes,0,0,0,0
Ector,404,State Representative,81,REP,Under Votes,171,123,48,0
Ector,404,"Justice, 11th Court of Appeals District, Place 2",,REP,Bruce Williams,737,486,251,0
Ector,404,"Justice, 11th Court of Appeals District, Place 2",,REP,Over Votes,0,0,0,0
Ector,404,"Justice, 11th Court of Appeals District, Place 2",,REP,Under Votes,187,128,59,0
Ector,404,"Justice, 11th Court of Appeals District, Place 3 (Unexpired Term)",,REP,W. Stacy Trotter,735,487,248,0
Ector,404,"Justice, 11th Court of Appeals District, Place 3 (Unexpired Term)",,REP,Over Votes,0,0,0,0
Ector,404,"Justice, 11th Court of Appeals District, Place 3 (Unexpired Term)",,REP,Under Votes,189,127,62,0
Ector,404,"District Judge, 161st Judicial District",,REP,Justin Low,726,477,249,0
Ector,404,"District Judge, 161st Judicial District",,REP,Over Votes,0,0,0,0
Ector,404,"District Judge, 161st Judicial District",,REP,Under Votes,198,137,61,0
Ector,404,"District Judge, 446th Judicial District",,REP,Sara Kate Billingsley,728,478,250,0
Ector,404,"District Judge, 446th Judicial District",,REP,Over Votes,0,0,0,0
Ector,404,"District Judge, 446th Judicial District",,REP,Under Votes,196,136,60,0
Ector,404,"District Attorney, 70th Judicial District",,REP,Dusty Gallivan,733,480,253,0
Ector,404,"District Attorney, 70th Judicial District",,REP,Over Votes,0,0,0,0
Ector,404,"District Attorney, 70th Judicial District",,REP,Under Votes,191,134,57,0
Ector,405,President,,REP,Donald J. Trump / Michael R. Pence,212,146,66,0
Ector,405,President,,REP,Over Votes,1,1,0,0
Ector,405,President,,REP,Under Votes,9,6,3,0
Ector,405,President,,DEM,Joseph R. Biden / Kamala D. Harris,202,169,33,0
Ector,405,President,,LIB,"Jo Jorgensen / Jeremy ""Spike"" Cohen",4,2,2,0
Ector,405,President,,GRN,Howie Hawkins / Angela Walker,1,0,1,0
Ector,405,President,,,President R. Boddie/Eric C. Stoneham,0,0,0,0
Ector,405,President,,,Brian Carroll/Amar Patel,0,0,0,0
Ector,405,President,,,Todd Cella/Tim Cella,0,0,0,0
Ector,405,President,,,Jesse Cuellar/Jimmy Monreal,0,0,0,0
Ector,405,President,,,Tom Hoefling/Andy Prior,0,0,0,0
Ector,405,President,,,Gloria La Riva/Leonard Peltier,0,0,0,0
Ector,405,President,,,Abram Loeb/Jennifer Jairala,0,0,0,0
Ector,405,President,,,Robert Morrow/Anne Beckett,0,0,0,0
Ector,405,President,,,Kasey Wells/Rachel Wells,0,0,0,0
Ector,405,U.S. Senate,,REP,John Cornyn,182,127,55,0
Ector,405,U.S. Senate,,REP,Over Votes,0,0,0,0
Ector,405,U.S. Senate,,REP,Under Votes,42,38,4,0
Ector,405,U.S. Senate,,DEM,"Mary ""MJ"" Hegar",194,153,41,0
Ector,405,U.S. Senate,,LIB,Kerry Douglas McKennon,7,4,3,0
Ector,405,U.S. Senate,,GRN,David B. Collins,4,2,2,0
Ector,405,U.S. Senate,,,Ricardo Turullols-Bonilla,0,0,0,0
Ector,405,U.S. House,11,REP,August Pfluger,185,127,58,0
Ector,405,U.S. House,11,REP,Over Votes,0,0,0,0
Ector,405,U.S. House,11,REP,Under Votes,44,40,4,0
Ector,405,U.S. House,11,DEM,Jon Mark Hogg,195,155,40,0
Ector,405,U.S. House,11,LIB,Wacey Alpha Cody,5,2,3,0
Ector,405,Railroad Commissioner,,REP,"James ""Jim"" Wright",176,119,57,0
Ector,405,Railroad Commissioner,,REP,Over Votes,1,1,0,0
Ector,405,Railroad Commissioner,,REP,Under Votes,42,37,5,0
Ector,405,Railroad Commissioner,,DEM,Chrysta Castañeda,199,162,37,0
Ector,405,Railroad Commissioner,,LIB,Matt Sterett,3,1,2,0
Ector,405,Railroad Commissioner,,GRN,"Katija ""Kat"" Gruene",8,4,4,0
Ector,405,"Chief Justice, Supreme Court",,REP,Nathan Hecht,179,120,59,0
Ector,405,"Chief Justice, Supreme Court",,REP,Over Votes,0,0,0,0
Ector,405,"Chief Justice, Supreme Court",,REP,Under Votes,39,35,4,0
Ector,405,"Chief Justice, Supreme Court",,DEM,Amy Clark Meachum,200,161,39,0
Ector,405,"Chief Justice, Supreme Court",,LIB,Mark Ash,11,8,3,0
Ector,405,"Justice, Supreme Court, Place 6, (Unexpired Term)",,REP,Jane Bland,186,127,59,0
Ector,405,"Justice, Supreme Court, Place 6, (Unexpired Term)",,REP,Over Votes,0,0,0,0
Ector,405,"Justice, Supreme Court, Place 6, (Unexpired Term)",,REP,Under Votes,46,41,5,0
Ector,405,"Justice, Supreme Court, Place 6, (Unexpired Term)",,DEM,Kathy Cheng,197,156,41,0
Ector,405,"Justice, Supreme Court, Place 7",,REP,Jeff Boyd,175,119,56,0
Ector,405,"Justice, Supreme Court, Place 7",,REP,Over Votes,0,0,0,0
Ector,405,"Justice, Supreme Court, Place 7",,REP,Under Votes,49,43,6,0
Ector,405,"Justice, Supreme Court, Place 7",,DEM,Staci Williams,200,158,42,0
Ector,405,"Justice, Supreme Court, Place 7",,LIB,William Bryan Strange III,5,4,1,0
Ector,405,"Justice, Supreme Court, Place 8",,REP,Brett Busby,177,119,58,0
Ector,405,"Justice, Supreme Court, Place 8",,REP,Over Votes,0,0,0,0
Ector,405,"Justice, Supreme Court, Place 8",,REP,Under Votes,47,41,6,0
Ector,405,"Justice, Supreme Court, Place 8",,DEM,Gisela D. Triana,196,158,38,0
Ector,405,"Justice, Supreme Court, Place 8",,LIB,Tom Oxford,9,6,3,0
Ector,405,"Judge, Court of Criminal Appeals, Place 3",,REP,Bert Richardson,179,120,59,0
Ector,405,"Judge, Court of Criminal Appeals, Place 3",,REP,Over Votes,0,0,0,0
Ector,405,"Judge, Court of Criminal Appeals, Place 3",,REP,Under Votes,47,41,6,0
Ector,405,"Judge, Court of Criminal Appeals, Place 3",,DEM,Elizabeth Davis Frizell,203,163,40,0
Ector,405,"Judge, Court of Criminal Appeals, Place 4",,REP,Kevin Patrick Yeary,180,120,60,0
Ector,405,"Judge, Court of Criminal Appeals, Place 4",,REP,Over Votes,0,0,0,0
Ector,405,"Judge, Court of Criminal Appeals, Place 4",,REP,Under Votes,47,42,5,0
Ector,405,"Judge, Court of Criminal Appeals, Place 4",,DEM,Tina Clinton,202,162,40,0
Ector,405,"Judge, Court of Criminal Appeals, Place 9",,REP,David Newell,190,127,63,0
Ector,405,"Judge, Court of Criminal Appeals, Place 9",,REP,Over Votes,0,0,0,0
Ector,405,"Judge, Court of Criminal Appeals, Place 9",,REP,Under Votes,48,42,6,0
Ector,405,"Judge, Court of Criminal Appeals, Place 9",,DEM,Brandon Birmingham,191,155,36,0
Ector,405,"Member, State Board of Education, District 1",,REP,Jennifer Ivey,176,117,59,0
Ector,405,"Member, State Board of Education, District 1",,REP,Over Votes,0,0,0,0
Ector,405,"Member, State Board of Education, District 1",,REP,Under Votes,48,44,4,0
Ector,405,"Member, State Board of Education, District 1",,DEM,Georgina Perez,205,163,42,0
Ector,405,State Representative,81,REP,Brooks Landgraf,264,183,81,0
Ector,405,State Representative,81,REP,Over Votes,0,0,0,0
Ector,405,State Representative,81,REP,Under Votes,165,141,24,0
Ector,405,"Justice, 11th Court of Appeals District, Place 2",,REP,Bruce Williams,251,167,84,0
Ector,405,"Justice, 11th Court of Appeals District, Place 2",,REP,Over Votes,0,0,0,0
Ector,405,"Justice, 11th Court of Appeals District, Place 2",,REP,Under Votes,178,157,21,0
Ector,405,"Justice, 11th Court of Appeals District, Place 3 (Unexpired Term)",,REP,W. Stacy Trotter,247,169,78,0
Ector,405,"Justice, 11th Court of Appeals District, Place 3 (Unexpired Term)",,REP,Over Votes,0,0,0,0
Ector,405,"Justice, 11th Court of Appeals District, Place 3 (Unexpired Term)",,REP,Under Votes,182,155,27,0
Ector,405,"District Judge, 161st Judicial District",,REP,Justin Low,246,166,80,0
Ector,405,"District Judge, 161st Judicial District",,REP,Over Votes,0,0,0,0
Ector,405,"District Judge, 161st Judicial District",,REP,Under Votes,183,158,25,0
Ector,405,"District Judge, 446th Judicial District",,REP,Sara Kate Billingsley,243,165,78,0
Ector,405,"District Judge, 446th Judicial District",,REP,Over Votes,0,0,0,0
Ector,405,"District Judge, 446th Judicial District",,REP,Under Votes,186,159,27,0
Ector,405,"District Attorney, 70th Judicial District",,REP,Dusty Gallivan,249,169,80,0
Ector,405,"District Attorney, 70th Judicial District",,REP,Over Votes,0,0,0,0
Ector,405,"District Attorney, 70th Judicial District",,REP,Under Votes,180,155,25,0
Ector,405,Mayor,,,Dewey Bryant,93,65,28,0
Ector,405,Mayor,,,Over Votes,0,0,0,0
Ector,405,Mayor,,,Under Votes,68,55,13,0
Ector,405,Mayor,,,Javier Joven,182,139,43,0
Ector,405,Mayor,,,Gloria G. Apolinario,86,65,21,0
Ector,405,"Council Member, At-Large",,,David R. Turner,126,87,39,0
Ector,405,"Council Member, At-Large",,,Over Votes,0,0,0,0
Ector,405,"Council Member, At-Large",,,Under Votes,76,60,16,0
Ector,405,"Council Member, At-Large",,,La-Tasha Gentry,46,30,16,0
Ector,405,"Council Member, At-Large",,,Jo Ann Davenport Littleton,126,109,17,0
Ector,405,"Council Member, At-Large",,,Denise Swanner,55,38,17,0
Ector,406 City,President,,REP,Donald J. Trump / Michael R. Pence,776,549,227,0
Ector,406 City,President,,REP,Over Votes,0,0,0,0
Ector,406 City,President,,REP,Under Votes,15,9,6,0
Ector,406 City,President,,DEM,Joseph R. Biden / Kamala D. Harris,501,401,100,0
Ector,406 City,President,,LIB,"Jo Jorgensen / Jeremy ""Spike"" Cohen",13,11,2,0
Ector,406 City,President,,GRN,Howie Hawkins / Angela Walker,6,4,2,0
Ector,406 City,President,,,President R. Boddie/Eric C. Stoneham,0,0,0,0
Ector,406 City,President,,,Brian Carroll/Amar Patel,0,0,0,0
Ector,406 City,President,,,Todd Cella/Tim Cella,0,0,0,0
Ector,406 City,President,,,Jesse Cuellar/Jimmy Monreal,0,0,0,0
Ector,406 City,President,,,Tom Hoefling/Andy Prior,0,0,0,0
Ector,406 City,President,,,Gloria La Riva/Leonard Peltier,0,0,0,0
Ector,406 City,President,,,Abram Loeb/Jennifer Jairala,0,0,0,0
Ector,406 City,President,,,Robert Morrow/Anne Beckett,0,0,0,0
Ector,406 City,President,,,Kasey Wells/Rachel Wells,0,0,0,0
Ector,406 City,U.S. Senate,,REP,John Cornyn,724,521,203,0
Ector,406 City,U.S. Senate,,REP,Over Votes,0,0,0,0
Ector,406 City,U.S. Senate,,REP,Under Votes,71,48,23,0
Ector,406 City,U.S. Senate,,DEM,"Mary ""MJ"" Hegar",469,376,93,0
Ector,406 City,U.S. Senate,,LIB,Kerry Douglas McKennon,31,17,14,0
Ector,406 City,U.S. Senate,,GRN,David B. Collins,16,12,4,0
Ector,406 City,U.S. Senate,,,Ricardo Turullols-Bonilla,0,0,0,0
Ector,406 City,U.S. House,11,REP,August Pfluger,720,524,196,0
Ector,406 City,U.S. House,11,REP,Over Votes,0,0,0,0
Ector,406 City,U.S. House,11,REP,Under Votes,79,55,24,0
Ector,406 City,U.S. House,11,DEM,Jon Mark Hogg,478,372,106,0
Ector,406 City,U.S. House,11,LIB,Wacey Alpha Cody,34,23,11,0
Ector,406 City,Railroad Commissioner,,REP,"James ""Jim"" Wright",698,504,194,0
Ector,406 City,Railroad Commissioner,,REP,Over Votes,0,0,0,0
Ector,406 City,Railroad Commissioner,,REP,Under Votes,73,51,22,0
Ector,406 City,Railroad Commissioner,,DEM,Chrysta Castañeda,502,394,108,0
Ector,406 City,Railroad Commissioner,,LIB,Matt Sterett,21,12,9,0
Ector,406 City,Railroad Commissioner,,GRN,"Katija ""Kat"" Gruene",17,13,4,0
Ector,406 City,"Chief Justice, Supreme Court",,REP,Nathan Hecht,692,504,188,0
Ector,406 City,"Chief Justice, Supreme Court",,REP,Over Votes,0,0,0,0
Ector,406 City,"Chief Justice, Supreme Court",,REP,Under Votes,76,53,23,0
Ector,406 City,"Chief Justice, Supreme Court",,DEM,Amy Clark Meachum,511,396,115,0
Ector,406 City,"Chief Justice, Supreme Court",,LIB,Mark Ash,32,21,11,0
Ector,406 City,"Justice, Supreme Court, Place 6, (Unexpired Term)",,REP,Jane Bland,737,531,206,0
Ector,406 City,"Justice, Supreme Court, Place 6, (Unexpired Term)",,REP,Over Votes,0,0,0,0
Ector,406 City,"Justice, Supreme Court, Place 6, (Unexpired Term)",,REP,Under Votes,77,51,26,0
Ector,406 City,"Justice, Supreme Court, Place 6, (Unexpired Term)",,DEM,Kathy Cheng,497,392,105,0
Ector,406 City,"Justice, Supreme Court, Place 7",,REP,Jeff Boyd,711,513,198,0
Ector,406 City,"Justice, Supreme Court, Place 7",,REP,Over Votes,0,0,0,0
Ector,406 City,"Justice, Supreme Court, Place 7",,REP,Under Votes,78,52,26,0
Ector,406 City,"Justice, Supreme Court, Place 7",,DEM,Staci Williams,491,388,103,0
Ector,406 City,"Justice, Supreme Court, Place 7",,LIB,William Bryan Strange III,31,21,10,0
Ector,406 City,"Justice, Supreme Court, Place 8",,REP,Brett Busby,694,507,187,0
Ector,406 City,"Justice, Supreme Court, Place 8",,REP,Over Votes,0,0,0,0
Ector,406 City,"Justice, Supreme Court, Place 8",,REP,Under Votes,82,55,27,0
Ector,406 City,"Justice, Supreme Court, Place 8",,DEM,Gisela D. Triana,499,390,109,0
Ector,406 City,"Justice, Supreme Court, Place 8",,LIB,Tom Oxford,36,22,14,0
Ector,406 City,"Judge, Court of Criminal Appeals, Place 3",,REP,Bert Richardson,727,525,202,0
Ector,406 City,"Judge, Court of Criminal Appeals, Place 3",,REP,Over Votes,0,0,0,0
Ector,406 City,"Judge, Court of Criminal Appeals, Place 3",,REP,Under Votes,84,56,28,0
Ector,406 City,"Judge, Court of Criminal Appeals, Place 3",,DEM,Elizabeth Davis Frizell,500,393,107,0
Ector,406 City,"Judge, Court of Criminal Appeals, Place 4",,REP,Kevin Patrick Yeary,722,524,198,0
Ector,406 City,"Judge, Court of Criminal Appeals, Place 4",,REP,Over Votes,0,0,0,0
Ector,406 City,"Judge, Court of Criminal Appeals, Place 4",,REP,Under Votes,85,58,27,0
Ector,406 City,"Judge, Court of Criminal Appeals, Place 4",,DEM,Tina Clinton,504,392,112,0
Ector,406 City,"Judge, Court of Criminal Appeals, Place 9",,REP,David Newell,731,520,211,0
Ector,406 City,"Judge, Court of Criminal Appeals, Place 9",,REP,Over Votes,0,0,0,0
Ector,406 City,"Judge, Court of Criminal Appeals, Place 9",,REP,Under Votes,84,58,26,0
Ector,406 City,"Judge, Court of Criminal Appeals, Place 9",,DEM,Brandon Birmingham,496,396,100,0
Ector,406 City,"Member, State Board of Education, District 1",,REP,Jennifer Ivey,688,499,189,0
Ector,406 City,"Member, State Board of Education, District 1",,REP,Over Votes,0,0,0,0
Ector,406 City,"Member, State Board of Education, District 1",,REP,Under Votes,88,58,30,0
Ector,406 City,"Member, State Board of Education, District 1",,DEM,Georgina Perez,535,417,118,0
Ector,406 City,State Representative,81,REP,Brooks Landgraf,963,712,251,0
Ector,406 City,State Representative,81,REP,Over Votes,0,0,0,0
Ector,406 City,State Representative,81,REP,Under Votes,348,262,86,0
Ector,406 City,"Justice, 11th Court of Appeals District, Place 2",,REP,Bruce Williams,922,673,249,0
Ector,406 City,"Justice, 11th Court of Appeals District, Place 2",,REP,Over Votes,0,0,0,0
Ector,406 City,"Justice, 11th Court of Appeals District, Place 2",,REP,Under Votes,389,301,88,0
Ector,406 City,"Justice, 11th Court of Appeals District, Place 3 (Unexpired Term)",,REP,W. Stacy Trotter,926,681,245,0
Ector,406 City,"Justice, 11th Court of Appeals District, Place 3 (Unexpired Term)",,REP,Over Votes,0,0,0,0
Ector,406 City,"Justice, 11th Court of Appeals District, Place 3 (Unexpired Term)",,REP,Under Votes,385,293,92,0
Ector,406 City,"District Judge, 161st Judicial District",,REP,Justin Low,932,684,248,0
Ector,406 City,"District Judge, 161st Judicial District",,REP,Over Votes,0,0,0,0
Ector,406 City,"District Judge, 161st Judicial District",,REP,Under Votes,379,290,89,0
Ector,406 City,"District Judge, 446th Judicial District",,REP,Sara Kate Billingsley,927,676,251,0
Ector,406 City,"District Judge, 446th Judicial District",,REP,Over Votes,0,0,0,0
Ector,406 City,"District Judge, 446th Judicial District",,REP,Under Votes,384,298,86,0
Ector,406 City,"District Attorney, 70th Judicial District",,REP,Dusty Gallivan,935,688,247,0
Ector,406 City,"District Attorney, 70th Judicial District",,REP,Over Votes,0,0,0,0
Ector,406 City,"District Attorney, 70th Judicial District",,REP,Under Votes,376,286,90,0
Ector,406 City,Mayor,,,Dewey Bryant,358,284,74,0
Ector,406 City,Mayor,,,Over Votes,0,0,0,0
Ector,406 City,Mayor,,,Under Votes,182,130,52,0
Ector,406 City,Mayor,,,Javier Joven,501,360,141,0
Ector,406 City,Mayor,,,Gloria G. Apolinario,270,200,70,0
Ector,406 City,"Council Member, At-Large",,,David R. Turner,523,369,154,0
Ector,406 City,"Council Member, At-Large",,,Over Votes,0,0,0,0
Ector,406 City,"Council Member, At-Large",,,Under Votes,184,131,53,0
Ector,406 City,"Council Member, At-Large",,,La-Tasha Gentry,177,132,45,0
Ector,406 City,"Council Member, At-Large",,,Jo Ann Davenport Littleton,210,173,37,0
Ector,406 City,"Council Member, At-Large",,,Denise Swanner,217,169,48,0
Ector,406 County,President,,REP,Donald J. Trump / Michael R. Pence,1,1,0,0
Ector,406 County,President,,REP,Over Votes,0,0,0,0
Ector,406 County,President,,REP,Under Votes,0,0,0,0
Ector,406 County,President,,DEM,Joseph R. Biden / Kamala D. Harris,0,0,0,0
Ector,406 County,President,,LIB,"Jo Jorgensen / Jeremy ""Spike"" Cohen",0,0,0,0
Ector,406 County,President,,GRN,Howie Hawkins / Angela Walker,0,0,0,0
Ector,406 County,President,,,President R. Boddie/Eric C. Stoneham,0,0,0,0
Ector,406 County,President,,,Brian Carroll/Amar Patel,0,0,0,0
Ector,406 County,President,,,Todd Cella/Tim Cella,0,0,0,0
Ector,406 County,President,,,Jesse Cuellar/Jimmy Monreal,0,0,0,0
Ector,406 County,President,,,Tom Hoefling/Andy Prior,0,0,0,0
Ector,406 County,President,,,Gloria La Riva/Leonard Peltier,0,0,0,0
Ector,406 County,President,,,Abram Loeb/Jennifer Jairala,0,0,0,0
Ector,406 County,President,,,Robert Morrow/Anne Beckett,0,0,0,0
Ector,406 County,President,,,Kasey Wells/Rachel Wells,0,0,0,0
Ector,406 County,U.S. Senate,,REP,John Cornyn,1,1,0,0
Ector,406 County,U.S. Senate,,REP,Over Votes,0,0,0,0
Ector,406 County,U.S. Senate,,REP,Under Votes,0,0,0,0
Ector,406 County,U.S. Senate,,DEM,"Mary ""MJ"" Hegar",0,0,0,0
Ector,406 County,U.S. Senate,,LIB,Kerry Douglas McKennon,0,0,0,0
Ector,406 County,U.S. Senate,,GRN,David B. Collins,0,0,0,0
Ector,406 County,U.S. Senate,,,Ricardo Turullols-Bonilla,0,0,0,0
Ector,406 County,U.S. House,11,REP,August Pfluger,1,1,0,0
Ector,406 County,U.S. House,11,REP,Over Votes,0,0,0,0
Ector,406 County,U.S. House,11,REP,Under Votes,0,0,0,0
Ector,406 County,U.S. House,11,DEM,Jon Mark Hogg,0,0,0,0
Ector,406 County,U.S. House,11,LIB,Wacey Alpha Cody,0,0,0,0
Ector,406 County,Railroad Commissioner,,REP,"James ""Jim"" Wright",1,1,0,0
Ector,406 County,Railroad Commissioner,,REP,Over Votes,0,0,0,0
Ector,406 County,Railroad Commissioner,,REP,Under Votes,0,0,0,0
Ector,406 County,Railroad Commissioner,,DEM,Chrysta Castañeda,0,0,0,0
Ector,406 County,Railroad Commissioner,,LIB,Matt Sterett,0,0,0,0
Ector,406 County,Railroad Commissioner,,GRN,"Katija ""Kat"" Gruene",0,0,0,0
Ector,406 County,"Chief Justice, Supreme Court",,REP,Nathan Hecht,1,1,0,0
Ector,406 County,"Chief Justice, Supreme Court",,REP,Over Votes,0,0,0,0
Ector,406 County,"Chief Justice, Supreme Court",,REP,Under Votes,0,0,0,0
Ector,406 County,"Chief Justice, Supreme Court",,DEM,Amy Clark Meachum,0,0,0,0
Ector,406 County,"Chief Justice, Supreme Court",,LIB,Mark Ash,0,0,0,0
Ector,406 County,"Justice, Supreme Court, Place 6, (Unexpired Term)",,REP,Jane Bland,1,1,0,0
Ector,406 County,"Justice, Supreme Court, Place 6, (Unexpired Term)",,REP,Over Votes,0,0,0,0
Ector,406 County,"Justice, Supreme Court, Place 6, (Unexpired Term)",,REP,Under Votes,0,0,0,0
Ector,406 County,"Justice, Supreme Court, Place 6, (Unexpired Term)",,DEM,Kathy Cheng,0,0,0,0
Ector,406 County,"Justice, Supreme Court, Place 7",,REP,Jeff Boyd,1,1,0,0
Ector,406 County,"Justice, Supreme Court, Place 7",,REP,Over Votes,0,0,0,0
Ector,406 County,"Justice, Supreme Court, Place 7",,REP,Under Votes,0,0,0,0
Ector,406 County,"Justice, Supreme Court, Place 7",,DEM,Staci Williams,0,0,0,0
Ector,406 County,"Justice, Supreme Court, Place 7",,LIB,William Bryan Strange III,0,0,0,0
Ector,406 County,"Justice, Supreme Court, Place 8",,REP,Brett Busby,1,1,0,0
Ector,406 County,"Justice, Supreme Court, Place 8",,REP,Over Votes,0,0,0,0
Ector,406 County,"Justice, Supreme Court, Place 8",,REP,Under Votes,0,0,0,0
Ector,406 County,"Justice, Supreme Court, Place 8",,DEM,Gisela D. Triana,0,0,0,0
Ector,406 County,"Justice, Supreme Court, Place 8",,LIB,Tom Oxford,0,0,0,0
Ector,406 County,"Judge, Court of Criminal Appeals, Place 3",,REP,Bert Richardson,1,1,0,0
Ector,406 County,"Judge, Court of Criminal Appeals, Place 3",,REP,Over Votes,0,0,0,0
Ector,406 County,"Judge, Court of Criminal Appeals, Place 3",,REP,Under Votes,0,0,0,0
Ector,406 County,"Judge, Court of Criminal Appeals, Place 3",,DEM,Elizabeth Davis Frizell,0,0,0,0
Ector,406 County,"Judge, Court of Criminal Appeals, Place 4",,REP,Kevin Patrick Yeary,1,1,0,0
Ector,406 County,"Judge, Court of Criminal Appeals, Place 4",,REP,Over Votes,0,0,0,0
Ector,406 County,"Judge, Court of Criminal Appeals, Place 4",,REP,Under Votes,0,0,0,0
Ector,406 County,"Judge, Court of Criminal Appeals, Place 4",,DEM,Tina Clinton,0,0,0,0
Ector,406 County,"Judge, Court of Criminal Appeals, Place 9",,REP,David Newell,1,1,0,0
Ector,406 County,"Judge, Court of Criminal Appeals, Place 9",,REP,Over Votes,0,0,0,0
Ector,406 County,"Judge, Court of Criminal Appeals, Place 9",,REP,Under Votes,0,0,0,0
Ector,406 County,"Judge, Court of Criminal Appeals, Place 9",,DEM,Brandon Birmingham,0,0,0,0
Ector,406 County,"Member, State Board of Education, District 1",,REP,Jennifer Ivey,1,1,0,0
Ector,406 County,"Member, State Board of Education, District 1",,REP,Over Votes,0,0,0,0
Ector,406 County,"Member, State Board of Education, District 1",,REP,Under Votes,0,0,0,0
Ector,406 County,"Member, State Board of Education, District 1",,DEM,Georgina Perez,0,0,0,0
Ector,406 County,State Representative,81,REP,Brooks Landgraf,1,1,0,0
Ector,406 County,State Representative,81,REP,Over Votes,0,0,0,0
Ector,406 County,State Representative,81,REP,Under Votes,0,0,0,0
Ector,406 County,"Justice, 11th Court of Appeals District, Place 2",,REP,Bruce Williams,1,1,0,0
Ector,406 County,"Justice, 11th Court of Appeals District, Place 2",,REP,Over Votes,0,0,0,0
Ector,406 County,"Justice, 11th Court of Appeals District, Place 2",,REP,Under Votes,0,0,0,0
Ector,406 County,"Justice, 11th Court of Appeals District, Place 3 (Unexpired Term)",,REP,W. Stacy Trotter,1,1,0,0
Ector,406 County,"Justice, 11th Court of Appeals District, Place 3 (Unexpired Term)",,REP,Over Votes,0,0,0,0
Ector,406 County,"Justice, 11th Court of Appeals District, Place 3 (Unexpired Term)",,REP,Under Votes,0,0,0,0
Ector,406 County,"District Judge, 161st Judicial District",,REP,Justin Low,1,1,0,0
Ector,406 County,"District Judge, 161st Judicial District",,REP,Over Votes,0,0,0,0
Ector,406 County,"District Judge, 161st Judicial District",,REP,Under Votes,0,0,0,0
Ector,406 County,"District Judge, 446th Judicial District",,REP,Sara Kate Billingsley,0,0,0,0
Ector,406 County,"District Judge, 446th Judicial District",,REP,Over Votes,0,0,0,0
Ector,406 County,"District Judge, 446th Judicial District",,REP,Under Votes,1,1,0,0
Ector,406 County,"District Attorney, 70th Judicial District",,REP,Dusty Gallivan,1,1,0,0
Ector,406 County,"District Attorney, 70th Judicial District",,REP,Over Votes,0,0,0,0
Ector,406 County,"District Attorney, 70th Judicial District",,REP,Under Votes,0,0,0,0
Ector,407,President,,REP,Donald J. Trump / Michael R. Pence,518,412,106,0
Ector,407,President,,REP,Over Votes,0,0,0,0
Ector,407,President,,REP,Under Votes,5,2,3,0
Ector,407,President,,DEM,Joseph R. Biden / Kamala D. Harris,130,93,37,0
Ector,407,President,,LIB,"Jo Jorgensen / Jeremy ""Spike"" Cohen",4,3,1,0
Ector,407,President,,GRN,Howie Hawkins / Angela Walker,3,2,1,0
Ector,407,President,,,President R. Boddie/Eric C. Stoneham,0,0,0,0
Ector,407,President,,,Brian Carroll/Amar Patel,0,0,0,0
Ector,407,President,,,Todd Cella/Tim Cella,0,0,0,0
Ector,407,President,,,Jesse Cuellar/Jimmy Monreal,0,0,0,0
Ector,407,President,,,Tom Hoefling/Andy Prior,0,0,0,0
Ector,407,President,,,Gloria La Riva/Leonard Peltier,0,0,0,0
Ector,407,President,,,Abram Loeb/Jennifer Jairala,0,0,0,0
Ector,407,President,,,Robert Morrow/Anne Beckett,0,0,0,0
Ector,407,President,,,Kasey Wells/Rachel Wells,0,0,0,0
Ector,407,U.S. Senate,,REP,John Cornyn,491,390,101,0
Ector,407,U.S. Senate,,REP,Over Votes,0,0,0,0
Ector,407,U.S. Senate,,REP,Under Votes,26,19,7,0
Ector,407,U.S. Senate,,DEM,"Mary ""MJ"" Hegar",135,98,37,0
Ector,407,U.S. Senate,,LIB,Kerry Douglas McKennon,5,3,2,0
Ector,407,U.S. Senate,,GRN,David B. Collins,3,2,1,0
Ector,407,U.S. Senate,,,Ricardo Turullols-Bonilla,0,0,0,0
Ector,407,U.S. House,11,REP,August Pfluger,494,396,98,0
Ector,407,U.S. House,11,REP,Over Votes,0,0,0,0
Ector,407,U.S. House,11,REP,Under Votes,30,21,9,0
Ector,407,U.S. House,11,DEM,Jon Mark Hogg,132,92,40,0
Ector,407,U.S. House,11,LIB,Wacey Alpha Cody,4,3,1,0
Ector,407,Railroad Commissioner,,REP,"James ""Jim"" Wright",481,388,93,0
Ector,407,Railroad Commissioner,,REP,Over Votes,0,0,0,0
Ector,407,Railroad Commissioner,,REP,Under Votes,28,20,8,0
Ector,407,Railroad Commissioner,,DEM,Chrysta Castañeda,142,102,40,0
Ector,407,Railroad Commissioner,,LIB,Matt Sterett,6,1,5,0
Ector,407,Railroad Commissioner,,GRN,"Katija ""Kat"" Gruene",3,1,2,0
Ector,407,"Chief Justice, Supreme Court",,REP,Nathan Hecht,481,386,95,0
Ector,407,"Chief Justice, Supreme Court",,REP,Over Votes,0,0,0,0
Ector,407,"Chief Justice, Supreme Court",,REP,Under Votes,28,21,7,0
Ector,407,"Chief Justice, Supreme Court",,DEM,Amy Clark Meachum,141,100,41,0
Ector,407,"Chief Justice, Supreme Court",,LIB,Mark Ash,10,5,5,0
Ector,407,"Justice, Supreme Court, Place 6, (Unexpired Term)",,REP,Jane Bland,497,398,99,0
Ector,407,"Justice, Supreme Court, Place 6, (Unexpired Term)",,REP,Over Votes,0,0,0,0
Ector,407,"Justice, Supreme Court, Place 6, (Unexpired Term)",,REP,Under Votes,30,22,8,0
Ector,407,"Justice, Supreme Court, Place 6, (Unexpired Term)",,DEM,Kathy Cheng,133,92,41,0
Ector,407,"Justice, Supreme Court, Place 7",,REP,Jeff Boyd,478,385,93,0
Ector,407,"Justice, Supreme Court, Place 7",,REP,Over Votes,0,0,0,0
Ector,407,"Justice, Supreme Court, Place 7",,REP,Under Votes,28,21,7,0
Ector,407,"Justice, Supreme Court, Place 7",,DEM,Staci Williams,141,98,43,0
Ector,407,"Justice, Supreme Court, Place 7",,LIB,William Bryan Strange III,13,8,5,0
Ector,407,"Justice, Supreme Court, Place 8",,REP,Brett Busby,478,384,94,0
Ector,407,"Justice, Supreme Court, Place 8",,REP,Over Votes,0,0,0,0
Ector,407,"Justice, Supreme Court, Place 8",,REP,Under Votes,29,20,9,0
Ector,407,"Justice, Supreme Court, Place 8",,DEM,Gisela D. Triana,142,100,42,0
Ector,407,"Justice, Supreme Court, Place 8",,LIB,Tom Oxford,11,8,3,0
Ector,407,"Judge, Court of Criminal Appeals, Place 3",,REP,Bert Richardson,491,392,99,0
Ector,407,"Judge, Court of Criminal Appeals, Place 3",,REP,Over Votes,0,0,0,0
Ector,407,"Judge, Court of Criminal Appeals, Place 3",,REP,Under Votes,30,21,9,0
Ector,407,"Judge, Court of Criminal Appeals, Place 3",,DEM,Elizabeth Davis Frizell,139,99,40,0
Ector,407,"Judge, Court of Criminal Appeals, Place 4",,REP,Kevin Patrick Yeary,493,393,100,0
Ector,407,"Judge, Court of Criminal Appeals, Place 4",,REP,Over Votes,0,0,0,0
Ector,407,"Judge, Court of Criminal Appeals, Place 4",,REP,Under Votes,26,19,7,0
Ector,407,"Judge, Court of Criminal Appeals, Place 4",,DEM,Tina Clinton,141,100,41,0
Ector,407,"Judge, Court of Criminal Appeals, Place 9",,REP,David Newell,501,402,99,0
Ector,407,"Judge, Court of Criminal Appeals, Place 9",,REP,Over Votes,0,0,0,0
Ector,407,"Judge, Court of Criminal Appeals, Place 9",,REP,Under Votes,30,20,10,0
Ector,407,"Judge, Court of Criminal Appeals, Place 9",,DEM,Brandon Birmingham,129,90,39,0
Ector,407,"Member, State Board of Education, District 1",,REP,Jennifer Ivey,475,381,94,0
Ector,407,"Member, State Board of Education, District 1",,REP,Over Votes,0,0,0,0
Ector,407,"Member, State Board of Education, District 1",,REP,Under Votes,33,20,13,0
Ector,407,"Member, State Board of Education, District 1",,DEM,Georgina Perez,152,111,41,0
Ector,407,State Representative,81,REP,Brooks Landgraf,557,437,120,0
Ector,407,State Representative,81,REP,Over Votes,0,0,0,0
Ector,407,State Representative,81,REP,Under Votes,103,75,28,0
Ector,407,"Justice, 11th Court of Appeals District, Place 2",,REP,Bruce Williams,545,423,122,0
Ector,407,"Justice, 11th Court of Appeals District, Place 2",,REP,Over Votes,0,0,0,0
Ector,407,"Justice, 11th Court of Appeals District, Place 2",,REP,Under Votes,115,89,26,0
Ector,407,"Justice, 11th Court of Appeals District, Place 3 (Unexpired Term)",,REP,W. Stacy Trotter,554,432,122,0
Ector,407,"Justice, 11th Court of Appeals District, Place 3 (Unexpired Term)",,REP,Over Votes,0,0,0,0
Ector,407,"Justice, 11th Court of Appeals District, Place 3 (Unexpired Term)",,REP,Under Votes,106,80,26,0
Ector,407,"District Judge, 161st Judicial District",,REP,Justin Low,550,430,120,0
Ector,407,"District Judge, 161st Judicial District",,REP,Over Votes,0,0,0,0
Ector,407,"District Judge, 161st Judicial District",,REP,Under Votes,110,82,28,0
Ector,407,"District Judge, 446th Judicial District",,REP,Sara Kate Billingsley,547,425,122,0
Ector,407,"District Judge, 446th Judicial District",,REP,Over Votes,0,0,0,0
Ector,407,"District Judge, 446th Judicial District",,REP,Under Votes,113,87,26,0
Ector,407,"District Attorney, 70th Judicial District",,REP,Dusty Gallivan,551,427,124,0
Ector,407,"District Attorney, 70th Judicial District",,REP,Over Votes,0,0,0,0
Ector,407,"District Attorney, 70th Judicial District",,REP,Under Votes,109,85,24,0
Ector,408,President,,REP,Donald J. Trump / Michael R. Pence,167,124,43,0
Ector,408,President,,REP,Over Votes,0,0,0,0
Ector,408,President,,REP,Under Votes,2,2,0,0
Ector,408,President,,DEM,Joseph R. Biden / Kamala D. Harris,140,119,21,0
Ector,408,President,,LIB,"Jo Jorgensen / Jeremy ""Spike"" Cohen",6,3,3,0
Ector,408,President,,GRN,Howie Hawkins / Angela Walker,1,0,1,0
Ector,408,President,,,President R. Boddie/Eric C. Stoneham,0,0,0,0
Ector,408,President,,,Brian Carroll/Amar Patel,0,0,0,0
Ector,408,President,,,Todd Cella/Tim Cella,0,0,0,0
Ector,408,President,,,Jesse Cuellar/Jimmy Monreal,0,0,0,0
Ector,408,President,,,Tom Hoefling/Andy Prior,0,0,0,0
Ector,408,President,,,Gloria La Riva/Leonard Peltier,0,0,0,0
Ector,408,President,,,Abram Loeb/Jennifer Jairala,0,0,0,0
Ector,408,President,,,Robert Morrow/Anne Beckett,0,0,0,0
Ector,408,President,,,Kasey Wells/Rachel Wells,0,0,0,0
Ector,408,U.S. Senate,,REP,John Cornyn,157,118,39,0
Ector,408,U.S. Senate,,REP,Over Votes,0,0,0,0
Ector,408,U.S. Senate,,REP,Under Votes,17,11,6,0
Ector,408,U.S. Senate,,DEM,"Mary ""MJ"" Hegar",129,113,16,0
Ector,408,U.S. Senate,,LIB,Kerry Douglas McKennon,10,3,7,0
Ector,408,U.S. Senate,,GRN,David B. Collins,3,3,0,0
Ector,408,U.S. Senate,,,Ricardo Turullols-Bonilla,0,0,0,0
Ector,408,U.S. House,11,REP,August Pfluger,155,113,42,0
Ector,408,U.S. House,11,REP,Over Votes,0,0,0,0
Ector,408,U.S. House,11,REP,Under Votes,20,14,6,0
Ector,408,U.S. House,11,DEM,Jon Mark Hogg,134,117,17,0
Ector,408,U.S. House,11,LIB,Wacey Alpha Cody,7,4,3,0
Ector,408,Railroad Commissioner,,REP,"James ""Jim"" Wright",152,115,37,0
Ector,408,Railroad Commissioner,,REP,Over Votes,0,0,0,0
Ector,408,Railroad Commissioner,,REP,Under Votes,20,12,8,0
Ector,408,Railroad Commissioner,,DEM,Chrysta Castañeda,133,115,18,0
Ector,408,Railroad Commissioner,,LIB,Matt Sterett,8,3,5,0
Ector,408,Railroad Commissioner,,GRN,"Katija ""Kat"" Gruene",3,3,0,0
Ector,408,"Chief Justice, Supreme Court",,REP,Nathan Hecht,155,117,38,0
Ector,408,"Chief Justice, Supreme Court",,REP,Over Votes,0,0,0,0
Ector,408,"Chief Justice, Supreme Court",,REP,Under Votes,18,12,6,0
Ector,408,"Chief Justice, Supreme Court",,DEM,Amy Clark Meachum,131,114,17,0
Ector,408,"Chief Justice, Supreme Court",,LIB,Mark Ash,12,5,7,0
Ector,408,"Justice, Supreme Court, Place 6, (Unexpired Term)",,REP,Jane Bland,159,117,42,0
Ector,408,"Justice, Supreme Court, Place 6, (Unexpired Term)",,REP,Over Votes,0,0,0,0
Ector,408,"Justice, Supreme Court, Place 6, (Unexpired Term)",,REP,Under Votes,23,16,7,0
Ector,408,"Justice, Supreme Court, Place 6, (Unexpired Term)",,DEM,Kathy Cheng,134,115,19,0
Ector,408,"Justice, Supreme Court, Place 7",,REP,Jeff Boyd,155,117,38,0
Ector,408,"Justice, Supreme Court, Place 7",,REP,Over Votes,0,0,0,0
Ector,408,"Justice, Supreme Court, Place 7",,REP,Under Votes,22,16,6,0
Ector,408,"Justice, Supreme Court, Place 7",,DEM,Staci Williams,130,111,19,0
Ector,408,"Justice, Supreme Court, Place 7",,LIB,William Bryan Strange III,9,4,5,0
Ector,408,"Justice, Supreme Court, Place 8",,REP,Brett Busby,146,110,36,0
Ector,408,"Justice, Supreme Court, Place 8",,REP,Over Votes,0,0,0,0
Ector,408,"Justice, Supreme Court, Place 8",,REP,Under Votes,20,13,7,0
Ector,408,"Justice, Supreme Court, Place 8",,DEM,Gisela D. Triana,143,122,21,0
Ector,408,"Justice, Supreme Court, Place 8",,LIB,Tom Oxford,7,3,4,0
Ector,408,"Judge, Court of Criminal Appeals, Place 3",,REP,Bert Richardson,153,115,38,0
Ector,408,"Judge, Court of Criminal Appeals, Place 3",,REP,Over Votes,0,0,0,0
Ector,408,"Judge, Court of Criminal Appeals, Place 3",,REP,Under Votes,22,15,7,0
Ector,408,"Judge, Court of Criminal Appeals, Place 3",,DEM,Elizabeth Davis Frizell,141,118,23,0
Ector,408,"Judge, Court of Criminal Appeals, Place 4",,REP,Kevin Patrick Yeary,158,119,39,0
Ector,408,"Judge, Court of Criminal Appeals, Place 4",,REP,Over Votes,0,0,0,0
Ector,408,"Judge, Court of Criminal Appeals, Place 4",,REP,Under Votes,20,13,7,0
Ector,408,"Judge, Court of Criminal Appeals, Place 4",,DEM,Tina Clinton,138,116,22,0
Ector,408,"Judge, Court of Criminal Appeals, Place 9",,REP,David Newell,158,122,36,0
Ector,408,"Judge, Court of Criminal Appeals, Place 9",,REP,Over Votes,0,0,0,0
Ector,408,"Judge, Court of Criminal Appeals, Place 9",,REP,Under Votes,18,12,6,0
Ector,408,"Judge, Court of Criminal Appeals, Place 9",,DEM,Brandon Birmingham,140,114,26,0
Ector,408,"Member, State Board of Education, District 1",,REP,Jennifer Ivey,149,112,37,0
Ector,408,"Member, State Board of Education, District 1",,REP,Over Votes,0,0,0,0
Ector,408,"Member, State Board of Education, District 1",,REP,Under Votes,20,14,6,0
Ector,408,"Member, State Board of Education, District 1",,DEM,Georgina Perez,147,122,25,0
Ector,408,State Representative,81,REP,Brooks Landgraf,218,167,51,0
Ector,408,State Representative,81,REP,Over Votes,0,0,0,0
Ector,408,State Representative,81,REP,Under Votes,98,81,17,0
Ector,408,"Justice, 11th Court of Appeals District, Place 2",,REP,Bruce Williams,217,165,52,0
Ector,408,"Justice, 11th Court of Appeals District, Place 2",,REP,Over Votes,0,0,0,0
Ector,408,"Justice, 11th Court of Appeals District, Place 2",,REP,Under Votes,99,83,16,0
Ector,408,"Justice, 11th Court of Appeals District, Place 3 (Unexpired Term)",,REP,W. Stacy Trotter,211,160,51,0
Ector,408,"Justice, 11th Court of Appeals District, Place 3 (Unexpired Term)",,REP,Over Votes,0,0,0,0
Ector,408,"Justice, 11th Court of Appeals District, Place 3 (Unexpired Term)",,REP,Under Votes,105,88,17,0
Ector,408,"District Judge, 161st Judicial District",,REP,Justin Low,208,157,51,0
Ector,408,"District Judge, 161st Judicial District",,REP,Over Votes,0,0,0,0
Ector,408,"District Judge, 161st Judicial District",,REP,Under Votes,108,91,17,0
Ector,408,"District Judge, 446th Judicial District",,REP,Sara Kate Billingsley,215,164,51,0
Ector,408,"District Judge, 446th Judicial District",,REP,Over Votes,0,0,0,0
Ector,408,"District Judge, 446th Judicial District",,REP,Under Votes,101,84,17,0
Ector,408,"District Attorney, 70th Judicial District",,REP,Dusty Gallivan,217,166,51,0
Ector,408,"District Attorney, 70th Judicial District",,REP,Over Votes,0,0,0,0
Ector,408,"District Attorney, 70th Judicial District",,REP,Under Votes,99,82,17,0
Ector,408,Mayor,,,Dewey Bryant,83,68,15,0
Ector,408,Mayor,,,Over Votes,0,0,0,0
Ector,408,Mayor,,,Under Votes,42,32,10,0
Ector,408,Mayor,,,Javier Joven,107,83,24,0
Ector,408,Mayor,,,Gloria G. Apolinario,84,65,19,0
Ector,408,"Council Member, At-Large",,,David R. Turner,116,91,25,0
Ector,408,"Council Member, At-Large",,,Over Votes,0,0,0,0
Ector,408,"Council Member, At-Large",,,Under Votes,46,34,12,0
Ector,408,"Council Member, At-Large",,,La-Tasha Gentry,47,40,7,0
Ector,408,"Council Member, At-Large",,,Jo Ann Davenport Littleton,50,44,6,0
Ector,408,"Council Member, At-Large",,,Denise Swanner,57,39,18,0
Ector,409,President,,REP,Donald J. Trump / Michael R. Pence,470,309,161,0
Ector,409,President,,REP,Over Votes,0,0,0,0
Ector,409,President,,REP,Under Votes,6,4,2,0
Ector,409,President,,DEM,Joseph R. Biden / Kamala D. Harris,180,133,47,0
Ector,409,President,,LIB,"Jo Jorgensen / Jeremy ""Spike"" Cohen",2,2,0,0
Ector,409,President,,GRN,Howie Hawkins / Angela Walker,0,0,0,0
Ector,409,President,,,President R. Boddie/Eric C. Stoneham,0,0,0,0
Ector,409,President,,,Brian Carroll/Amar Patel,0,0,0,0
Ector,409,President,,,Todd Cella/Tim Cella,0,0,0,0
Ector,409,President,,,Jesse Cuellar/Jimmy Monreal,0,0,0,0
Ector,409,President,,,Tom Hoefling/Andy Prior,0,0,0,0
Ector,409,President,,,Gloria La Riva/Leonard Peltier,0,0,0,0
Ector,409,President,,,Abram Loeb/Jennifer Jairala,0,0,0,0
Ector,409,President,,,Robert Morrow/Anne Beckett,0,0,0,0
Ector,409,President,,,Kasey Wells/Rachel Wells,0,0,0,0
Ector,409,U.S. Senate,,REP,John Cornyn,431,287,144,0
Ector,409,U.S. Senate,,REP,Over Votes,0,0,0,0
Ector,409,U.S. Senate,,REP,Under Votes,35,19,16,0
Ector,409,U.S. Senate,,DEM,"Mary ""MJ"" Hegar",178,133,45,0
Ector,409,U.S. Senate,,LIB,Kerry Douglas McKennon,9,6,3,0
Ector,409,U.S. Senate,,GRN,David B. Collins,5,3,2,0
Ector,409,U.S. Senate,,,Ricardo Turullols-Bonilla,0,0,0,0
Ector,409,U.S. House,11,REP,August Pfluger,433,289,144,0
Ector,409,U.S. House,11,REP,Over Votes,0,0,0,0
Ector,409,U.S. House,11,REP,Under Votes,37,23,14,0
Ector,409,U.S. House,11,DEM,Jon Mark Hogg,176,127,49,0
Ector,409,U.S. House,11,LIB,Wacey Alpha Cody,12,9,3,0
Ector,409,Railroad Commissioner,,REP,"James ""Jim"" Wright",426,287,139,0
Ector,409,Railroad Commissioner,,REP,Over Votes,0,0,0,0
Ector,409,Railroad Commissioner,,REP,Under Votes,29,19,10,0
Ector,409,Railroad Commissioner,,DEM,Chrysta Castañeda,191,135,56,0
Ector,409,Railroad Commissioner,,LIB,Matt Sterett,8,5,3,0
Ector,409,Railroad Commissioner,,GRN,"Katija ""Kat"" Gruene",4,2,2,0
Ector,409,"Chief Justice, Supreme Court",,REP,Nathan Hecht,424,284,140,0
Ector,409,"Chief Justice, Supreme Court",,REP,Over Votes,0,0,0,0
Ector,409,"Chief Justice, Supreme Court",,REP,Under Votes,28,19,9,0
Ector,409,"Chief Justice, Supreme Court",,DEM,Amy Clark Meachum,191,137,54,0
Ector,409,"Chief Justice, Supreme Court",,LIB,Mark Ash,15,8,7,0
Ector,409,"Justice, Supreme Court, Place 6, (Unexpired Term)",,REP,Jane Bland,443,297,146,0
Ector,409,"Justice, Supreme Court, Place 6, (Unexpired Term)",,REP,Over Votes,0,0,0,0
Ector,409,"Justice, Supreme Court, Place 6, (Unexpired Term)",,REP,Under Votes,31,20,11,0
Ector,409,"Justice, Supreme Court, Place 6, (Unexpired Term)",,DEM,Kathy Cheng,184,131,53,0
Ector,409,"Justice, Supreme Court, Place 7",,REP,Jeff Boyd,431,287,144,0
Ector,409,"Justice, Supreme Court, Place 7",,REP,Over Votes,0,0,0,0
Ector,409,"Justice, Supreme Court, Place 7",,REP,Under Votes,33,21,12,0
Ector,409,"Justice, Supreme Court, Place 7",,DEM,Staci Williams,185,134,51,0
Ector,409,"Justice, Supreme Court, Place 7",,LIB,William Bryan Strange III,9,6,3,0
Ector,409,"Justice, Supreme Court, Place 8",,REP,Brett Busby,420,278,142,0
Ector,409,"Justice, Supreme Court, Place 8",,REP,Over Votes,0,0,0,0
Ector,409,"Justice, Supreme Court, Place 8",,REP,Under Votes,33,21,12,0
Ector,409,"Justice, Supreme Court, Place 8",,DEM,Gisela D. Triana,194,142,52,0
Ector,409,"Justice, Supreme Court, Place 8",,LIB,Tom Oxford,11,7,4,0
Ector,409,"Judge, Court of Criminal Appeals, Place 3",,REP,Bert Richardson,433,292,141,0
Ector,409,"Judge, Court of Criminal Appeals, Place 3",,REP,Over Votes,0,0,0,0
Ector,409,"Judge, Court of Criminal Appeals, Place 3",,REP,Under Votes,35,22,13,0
Ector,409,"Judge, Court of Criminal Appeals, Place 3",,DEM,Elizabeth Davis Frizell,190,134,56,0
Ector,409,"Judge, Court of Criminal Appeals, Place 4",,REP,Kevin Patrick Yeary,429,289,140,0
Ector,409,"Judge, Court of Criminal Appeals, Place 4",,REP,Over Votes,0,0,0,0
Ector,409,"Judge, Court of Criminal Appeals, Place 4",,REP,Under Votes,36,22,14,0
Ector,409,"Judge, Court of Criminal Appeals, Place 4",,DEM,Tina Clinton,193,137,56,0
Ector,409,"Judge, Court of Criminal Appeals, Place 9",,REP,David Newell,439,294,145,0
Ector,409,"Judge, Court of Criminal Appeals, Place 9",,REP,Over Votes,0,0,0,0
Ector,409,"Judge, Court of Criminal Appeals, Place 9",,REP,Under Votes,39,26,13,0
Ector,409,"Judge, Court of Criminal Appeals, Place 9",,DEM,Brandon Birmingham,180,128,52,0
Ector,409,"Member, State Board of Education, District 1",,REP,Jennifer Ivey,413,276,137,0
Ector,409,"Member, State Board of Education, District 1",,REP,Over Votes,0,0,0,0
Ector,409,"Member, State Board of Education, District 1",,REP,Under Votes,37,23,14,0
Ector,409,"Member, State Board of Education, District 1",,DEM,Georgina Perez,208,149,59,0
Ector,409,State Representative,81,REP,Brooks Landgraf,519,346,173,0
Ector,409,State Representative,81,REP,Over Votes,0,0,0,0
Ector,409,State Representative,81,REP,Under Votes,139,102,37,0
Ector,409,"Justice, 11th Court of Appeals District, Place 2",,REP,Bruce Williams,516,339,177,0
Ector,409,"Justice, 11th Court of Appeals District, Place 2",,REP,Over Votes,0,0,0,0
Ector,409,"Justice, 11th Court of Appeals District, Place 2",,REP,Under Votes,142,109,33,0
Ector,409,"Justice, 11th Court of Appeals District, Place 3 (Unexpired Term)",,REP,W. Stacy Trotter,513,337,176,0
Ector,409,"Justice, 11th Court of Appeals District, Place 3 (Unexpired Term)",,REP,Over Votes,0,0,0,0
Ector,409,"Justice, 11th Court of Appeals District, Place 3 (Unexpired Term)",,REP,Under Votes,145,111,34,0
Ector,409,"District Judge, 161st Judicial District",,REP,Justin Low,504,330,174,0
Ector,409,"District Judge, 161st Judicial District",,REP,Over Votes,0,0,0,0
Ector,409,"District Judge, 161st Judicial District",,REP,Under Votes,154,118,36,0
Ector,409,"District Judge, 446th Judicial District",,REP,Sara Kate Billingsley,503,328,175,0
Ector,409,"District Judge, 446th Judicial District",,REP,Over Votes,0,0,0,0
Ector,409,"District Judge, 446th Judicial District",,REP,Under Votes,155,120,35,0
Ector,409,"District Attorney, 70th Judicial District",,REP,Dusty Gallivan,512,337,175,0
Ector,409,"District Attorney, 70th Judicial District",,REP,Over Votes,0,0,0,0
Ector,409,"District Attorney, 70th Judicial District",,REP,Under Votes,146,111,35,0
Ector,412,President,,REP,Donald J. Trump / Michael R. Pence,211,128,83,0
Ector,412,President,,REP,Over Votes,0,0,0,0
Ector,412,President,,REP,Under Votes,6,4,2,0
Ector,412,President,,DEM,Joseph R. Biden / Kamala D. Harris,136,110,26,0
Ector,412,President,,LIB,"Jo Jorgensen / Jeremy ""Spike"" Cohen",7,3,4,0
Ector,412,President,,GRN,Howie Hawkins / Angela Walker,0,0,0,0
Ector,412,President,,,President R. Boddie/Eric C. Stoneham,0,0,0,0
Ector,412,President,,,Brian Carroll/Amar Patel,0,0,0,0
Ector,412,President,,,Todd Cella/Tim Cella,1,1,0,0
Ector,412,President,,,Jesse Cuellar/Jimmy Monreal,0,0,0,0
Ector,412,President,,,Tom Hoefling/Andy Prior,0,0,0,0
Ector,412,President,,,Gloria La Riva/Leonard Peltier,0,0,0,0
Ector,412,President,,,Abram Loeb/Jennifer Jairala,0,0,0,0
Ector,412,President,,,Robert Morrow/Anne Beckett,0,0,0,0
Ector,412,President,,,Kasey Wells/Rachel Wells,0,0,0,0
Ector,412,U.S. Senate,,REP,John Cornyn,199,125,74,0
Ector,412,U.S. Senate,,REP,Over Votes,0,0,0,0
Ector,412,U.S. Senate,,REP,Under Votes,29,16,13,0
Ector,412,U.S. Senate,,DEM,"Mary ""MJ"" Hegar",125,103,22,0
Ector,412,U.S. Senate,,LIB,Kerry Douglas McKennon,4,0,4,0
Ector,412,U.S. Senate,,GRN,David B. Collins,4,2,2,0
Ector,412,U.S. Senate,,,Ricardo Turullols-Bonilla,0,0,0,0
Ector,412,U.S. House,11,REP,August Pfluger,203,124,79,0
Ector,412,U.S. House,11,REP,Over Votes,0,0,0,0
Ector,412,U.S. House,11,REP,Under Votes,27,17,10,0
Ector,412,U.S. House,11,DEM,Jon Mark Hogg,122,102,20,0
Ector,412,U.S. House,11,LIB,Wacey Alpha Cody,9,3,6,0
Ector,412,Railroad Commissioner,,REP,"James ""Jim"" Wright",191,116,75,0
Ector,412,Railroad Commissioner,,REP,Over Votes,0,0,0,0
Ector,412,Railroad Commissioner,,REP,Under Votes,31,18,13,0
Ector,412,Railroad Commissioner,,DEM,Chrysta Castañeda,129,106,23,0
Ector,412,Railroad Commissioner,,LIB,Matt Sterett,9,5,4,0
Ector,412,Railroad Commissioner,,GRN,"Katija ""Kat"" Gruene",1,1,0,0
Ector,412,"Chief Justice, Supreme Court",,REP,Nathan Hecht,191,119,72,0
Ector,412,"Chief Justice, Supreme Court",,REP,Over Votes,0,0,0,0
Ector,412,"Chief Justice, Supreme Court",,REP,Under Votes,29,18,11,0
Ector,412,"Chief Justice, Supreme Court",,DEM,Amy Clark Meachum,131,104,27,0
Ector,412,"Chief Justice, Supreme Court",,LIB,Mark Ash,10,5,5,0
Ector,412,"Justice, Supreme Court, Place 6, (Unexpired Term)",,REP,Jane Bland,206,125,81,0
Ector,412,"Justice, Supreme Court, Place 6, (Unexpired Term)",,REP,Over Votes,0,0,0,0
Ector,412,"Justice, Supreme Court, Place 6, (Unexpired Term)",,REP,Under Votes,27,17,10,0
Ector,412,"Justice, Supreme Court, Place 6, (Unexpired Term)",,DEM,Kathy Cheng,128,104,24,0
Ector,412,"Justice, Supreme Court, Place 7",,REP,Jeff Boyd,196,118,78,0
Ector,412,"Justice, Supreme Court, Place 7",,REP,Over Votes,0,0,0,0
Ector,412,"Justice, Supreme Court, Place 7",,REP,Under Votes,29,18,11,0
Ector,412,"Justice, Supreme Court, Place 7",,DEM,Staci Williams,128,106,22,0
Ector,412,"Justice, Supreme Court, Place 7",,LIB,William Bryan Strange III,8,4,4,0
Ector,412,"Justice, Supreme Court, Place 8",,REP,Brett Busby,194,119,75,0
Ector,412,"Justice, Supreme Court, Place 8",,REP,Over Votes,0,0,0,0
Ector,412,"Justice, Supreme Court, Place 8",,REP,Under Votes,32,18,14,0
Ector,412,"Justice, Supreme Court, Place 8",,DEM,Gisela D. Triana,131,108,23,0
Ector,412,"Justice, Supreme Court, Place 8",,LIB,Tom Oxford,4,1,3,0
Ector,412,"Judge, Court of Criminal Appeals, Place 3",,REP,Bert Richardson,200,122,78,0
Ector,412,"Judge, Court of Criminal Appeals, Place 3",,REP,Over Votes,0,0,0,0
Ector,412,"Judge, Court of Criminal Appeals, Place 3",,REP,Under Votes,33,18,15,0
Ector,412,"Judge, Court of Criminal Appeals, Place 3",,DEM,Elizabeth Davis Frizell,128,106,22,0
Ector,412,"Judge, Court of Criminal Appeals, Place 4",,REP,Kevin Patrick Yeary,198,120,78,0
Ector,412,"Judge, Court of Criminal Appeals, Place 4",,REP,Over Votes,0,0,0,0
Ector,412,"Judge, Court of Criminal Appeals, Place 4",,REP,Under Votes,33,19,14,0
Ector,412,"Judge, Court of Criminal Appeals, Place 4",,DEM,Tina Clinton,130,107,23,0
Ector,412,"Judge, Court of Criminal Appeals, Place 9",,REP,David Newell,199,121,78,0
Ector,412,"Judge, Court of Criminal Appeals, Place 9",,REP,Over Votes,0,0,0,0
Ector,412,"Judge, Court of Criminal Appeals, Place 9",,REP,Under Votes,33,19,14,0
Ector,412,"Judge, Court of Criminal Appeals, Place 9",,DEM,Brandon Birmingham,129,106,23,0
Ector,412,"Member, State Board of Education, District 1",,REP,Jennifer Ivey,202,125,77,0
Ector,412,"Member, State Board of Education, District 1",,REP,Over Votes,0,0,0,0
Ector,412,"Member, State Board of Education, District 1",,REP,Under Votes,26,15,11,0
Ector,412,"Member, State Board of Education, District 1",,DEM,Georgina Perez,133,106,27,0
Ector,412,State Representative,81,REP,Brooks Landgraf,258,168,90,0
Ector,412,State Representative,81,REP,Over Votes,0,0,0,0
Ector,412,State Representative,81,REP,Under Votes,103,78,25,0
Ector,412,"Justice, 11th Court of Appeals District, Place 2",,REP,Bruce Williams,251,161,90,0
Ector,412,"Justice, 11th Court of Appeals District, Place 2",,REP,Over Votes,0,0,0,0
Ector,412,"Justice, 11th Court of Appeals District, Place 2",,REP,Under Votes,110,85,25,0
Ector,412,"Justice, 11th Court of Appeals District, Place 3 (Unexpired Term)",,REP,W. Stacy Trotter,250,160,90,0
Ector,412,"Justice, 11th Court of Appeals District, Place 3 (Unexpired Term)",,REP,Over Votes,0,0,0,0
Ector,412,"Justice, 11th Court of Appeals District, Place 3 (Unexpired Term)",,REP,Under Votes,111,86,25,0
Ector,412,"District Judge, 161st Judicial District",,REP,Justin Low,246,158,88,0
Ector,412,"District Judge, 161st Judicial District",,REP,Over Votes,0,0,0,0
Ector,412,"District Judge, 161st Judicial District",,REP,Under Votes,115,88,27,0
Ector,412,"District Judge, 446th Judicial District",,REP,Sara Kate Billingsley,253,162,91,0
Ector,412,"District Judge, 446th Judicial District",,REP,Over Votes,0,0,0,0
Ector,412,"District Judge, 446th Judicial District",,REP,Under Votes,108,84,24,0
Ector,412,"District Attorney, 70th Judicial District",,REP,Dusty Gallivan,254,161,93,0
Ector,412,"District Attorney, 70th Judicial District",,REP,Over Votes,0,0,0,0
Ector,412,"District Attorney, 70th Judicial District",,REP,Under Votes,107,85,22,0
Ector,412,Mayor,,,Dewey Bryant,113,75,38,0
Ector,412,Mayor,,,Over Votes,0,0,0,0
Ector,412,Mayor,,,Under Votes,66,51,15,0
Ector,412,Mayor,,,Javier Joven,115,75,40,0
Ector,412,Mayor,,,Gloria G. Apolinario,67,45,22,0
Ector,412,"Council Member, District 1",,,Mark Matta,132,88,44,0
Ector,412,"Council Member, District 1",,,Over Votes,0,0,0,0
Ector,412,"Council Member, District 1",,,Under Votes,92,70,22,0
Ector,412,"Council Member, District 1",,,Michael K. Shelton Sr.,51,36,15,0
Ector,412,"Council Member, District 1",,,Tiki Davis,48,33,15,0
Ector,412,"Council Member, District 1",,,Eddie Mitchell,38,19,19,0
Ector,412,"Council Member, At-Large",,,David R. Turner,137,84,53,0
Ector,412,"Council Member, At-Large",,,Over Votes,0,0,0,0
Ector,412,"Council Member, At-Large",,,Under Votes,77,56,21,0
Ector,412,"Council Member, At-Large",,,La-Tasha Gentry,47,35,12,0
Ector,412,"Council Member, At-Large",,,Jo Ann Davenport Littleton,40,30,10,0
Ector,412,"Council Member, At-Large",,,Denise Swanner,60,41,19,0
