county,precinct,office,district,party,candidate,election_day,mail,early_voting,votes
DeWitt,101,President,,DEM,Amy Klobuchar,0,1,0,1
DeWitt,101,President,,DEM,Joseph R. Biden,21,6,3,30
DeWitt,101,President,,DEM,Michael Bennet,0,0,0,0
DeWitt,101,President,,DEM,Marianne Williamson,0,0,0,0
DeWitt,101,President,,DEM,Michael R. Bloomberg,1,1,5,7
DeWitt,101,President,,DEM,Elizabeth Warren,4,0,3,7
DeWitt,101,President,,DEM,Andrew Yang,1,0,0,1
DeWitt,101,President,,DEM,Tom Steyer,0,0,0,0
DeWitt,101,President,,DEM,Pete Buttigieg,1,0,1,2
DeWitt,101,President,,DEM,Tulsi Gabbard,0,0,0,0
DeWitt,101,President,,DEM,Robby Wells,0,0,0,0
DeWitt,101,President,,DEM,Deval Patrick,0,0,0,0
DeWitt,101,President,,DEM,Bernie Sanders,6,2,8,16
DeWitt,101,President,,DEM,"Roque ""Rocky"" De La Fuente Guerra",0,0,0,0
DeWitt,101,President,,DEM,John K. Delaney,0,0,0,0
DeWitt,101,President,,DEM,Cory Booker,0,0,0,0
DeWitt,101,President,,DEM,Julián Castro,0,2,0,2
DeWitt,101,Ballots Cast,,DEM,,34,12,20,66
DeWitt,101,President,,DEM,Under Votes,0,0,0,0
DeWitt,101,President,,DEM,Over Votes,0,0,0,0
DeWitt,101,U.S. Senate,,DEM,Victor Hugo Harris,1,0,0,1
DeWitt,101,U.S. Senate,,DEM,"Annie ""Mamá"" Garcia",10,0,2,12
DeWitt,101,U.S. Senate,,DEM,Amanda K. Edwards,2,0,4,6
DeWitt,101,U.S. Senate,,DEM,Royce West,1,0,0,1
DeWitt,101,U.S. Senate,,DEM,Adrian Ocegueda,2,0,1,3
DeWitt,101,U.S. Senate,,DEM,D.R. Hunter,1,0,0,1
DeWitt,101,U.S. Senate,,DEM,Michael Cooper,3,1,0,4
DeWitt,101,U.S. Senate,,DEM,Chris Bell,2,0,6,8
DeWitt,101,U.S. Senate,,DEM,Cristina Tzintzun Ramirez,2,3,0,5
DeWitt,101,U.S. Senate,,DEM,Sema Hernandez,2,0,1,3
DeWitt,101,U.S. Senate,,DEM,Jack Daniel Foster Jr,0,0,0,0
DeWitt,101,U.S. Senate,,DEM,"Mary ""MJ"" Hegar",1,4,3,8
DeWitt,101,Ballots Cast,,DEM,,27,8,17,52
DeWitt,101,U.S. Senate,,DEM,Under Votes,7,3,3,13
DeWitt,101,U.S. Senate,,DEM,Over Votes,0,1,0,1
DeWitt,101,U.S. House,34,DEM,Diego Zavala,11,1,4,16
DeWitt,101,U.S. House,34,DEM,Osbert Haro,2,1,0,3
DeWitt,101,U.S. House,34,DEM,Filemon B. Vela,16,8,13,37
DeWitt,101,Ballots Cast,,DEM,,29,10,17,56
DeWitt,101,U.S. House,34,DEM,Under Votes,5,2,3,10
DeWitt,101,U.S. House,34,DEM,Over Votes,0,0,0,0
DeWitt,101,Railroad Commissioner,,DEM,Chrysta Castañeda,8,6,4,18
DeWitt,101,Railroad Commissioner,,DEM,Kelly Stone,6,0,6,12
DeWitt,101,Railroad Commissioner,,DEM,Mark Watson,3,2,7,12
DeWitt,101,Railroad Commissioner,,DEM,"Roberto R. ""Beto"" Alonzo",14,2,0,16
DeWitt,101,Ballots Cast,,DEM,,31,10,17,58
DeWitt,101,Railroad Commissioner,,DEM,Under Votes,3,2,3,8
DeWitt,101,Railroad Commissioner,,DEM,Over Votes,0,0,0,0
DeWitt,101,"Chief Justice, Supreme Court",,DEM,Jerry Zimmerer,7,3,4,14
DeWitt,101,"Chief Justice, Supreme Court",,DEM,Amy Clark Meachum,22,5,13,40
DeWitt,101,Ballots Cast,,DEM,,29,8,17,54
DeWitt,101,"Chief Justice, Supreme Court",,DEM,Under Votes,5,4,3,12
DeWitt,101,"Chief Justice, Supreme Court",,DEM,Over Votes,0,0,0,0
DeWitt,101,"Justice, Supreme Court, Place 6 Unexpired Term",,DEM,Larry Praeger,8,1,6,15
DeWitt,101,"Justice, Supreme Court, Place 6 Unexpired Term",,DEM,Kathy Cheng,21,7,11,39
DeWitt,101,Ballots Cast,,DEM,,29,8,17,54
DeWitt,101,"Justice, Supreme Court, Place 6 Unexpired Term",,DEM,Under Votes,5,4,3,12
DeWitt,101,"Justice, Supreme Court, Place 6 Unexpired Term",,DEM,Over Votes,0,0,0,0
DeWitt,101,"Justice, Supreme Court, Place 7",,DEM,Staci Williams,17,4,11,32
DeWitt,101,"Justice, Supreme Court, Place 7",,DEM,Brandy Voss,12,4,5,21
DeWitt,101,Ballots Cast,,DEM,,29,8,16,53
DeWitt,101,"Justice, Supreme Court, Place 7",,DEM,Under Votes,5,4,4,13
DeWitt,101,"Justice, Supreme Court, Place 7",,DEM,Over Votes,0,0,0,0
DeWitt,101,"Justice, Supreme Court, Place 8",,DEM,Peter Kelly,10,3,9,22
DeWitt,101,"Justice, Supreme Court, Place 8",,DEM,Gisela D. Triana,20,7,8,35
DeWitt,101,Ballots Cast,,DEM,,30,10,17,57
DeWitt,101,"Justice, Supreme Court, Place 8",,DEM,Under Votes,4,2,3,9
DeWitt,101,"Justice, Supreme Court, Place 8",,DEM,Over Votes,0,0,0,0
DeWitt,101,"Judge, Court of Criminal Appeals, Place 3",,DEM,Dan Wood,7,4,5,16
DeWitt,101,"Judge, Court of Criminal Appeals, Place 3",,DEM,William Pieratt Demond,1,0,3,4
DeWitt,101,"Judge, Court of Criminal Appeals, Place 3",,DEM,Elizabeth Davis Frizell,20,5,9,34
DeWitt,101,Ballots Cast,,DEM,,28,9,17,54
DeWitt,101,"Judge, Court of Criminal Appeals, Place 3",,DEM,Under Votes,6,3,3,12
DeWitt,101,"Judge, Court of Criminal Appeals, Place 3",,DEM,Over Votes,0,0,0,0
DeWitt,101,"Judge, Court of Criminal Appeals, Place 4",,DEM,Steven Miears,5,1,4,10
DeWitt,101,"Judge, Court of Criminal Appeals, Place 4",,DEM,Tina Clinton,25,7,12,44
DeWitt,101,Ballots Cast,,DEM,,30,8,16,54
DeWitt,101,"Judge, Court of Criminal Appeals, Place 4",,DEM,Under Votes,4,4,4,12
DeWitt,101,"Judge, Court of Criminal Appeals, Place 4",,DEM,Over Votes,0,0,0,0
DeWitt,101,"Judge, Court of Criminal Appeals, Place 9",,DEM,Brandon Birmingham,27,7,16,50
DeWitt,101,Ballots Cast,,DEM,,27,7,16,50
DeWitt,101,"Judge, Court of Criminal Appeals, Place 9",,DEM,Under Votes,7,5,4,16
DeWitt,101,"Judge, Court of Criminal Appeals, Place 9",,DEM,Over Votes,0,0,0,0
DeWitt,101,State Senate,18,DEM,Michael Antalan,27,5,15,47
DeWitt,101,Ballots Cast,,DEM,,27,5,15,47
DeWitt,101,State Senate,18,DEM,Under Votes,7,7,5,19
DeWitt,101,State Senate,18,DEM,Over Votes,0,0,0,0
DeWitt,101,County Chairman,,DEM,Jospeh L. Sheppard,26,10,18,54
DeWitt,101,Ballots Cast,,DEM,,26,10,18,54
DeWitt,101,County Chairman,,DEM,Under Votes,8,2,2,12
DeWitt,101,County Chairman,,DEM,Over Votes,0,0,0,0
DeWitt,101,President,,REP,Zoltan G. Istvan,0,0,0,0
DeWitt,101,President,,REP,Donald J. Trump,156,35,200,391
DeWitt,101,President,,REP,Bill Weld,1,1,3,5
DeWitt,101,President,,REP,Joe Walsh,2,0,0,2
DeWitt,101,President,,REP,"Roque ""Rocky"" De La Fuente Guerra",1,0,1,2
DeWitt,101,President,,REP,Matthew John Matern,0,0,0,0
DeWitt,101,President,,REP,Bob Ely,0,0,2,2
DeWitt,101,President,,REP,Uncommitted,6,1,2,9
DeWitt,101,Ballots Cast,,REP,,166,37,208,411
DeWitt,101,President,,REP,Under Votes,1,0,2,3
DeWitt,101,President,,REP,Over Votes,0,0,0,0
DeWitt,101,U.S. Senate,,REP,Dwayne Stovall,40,6,44,90
DeWitt,101,U.S. Senate,,REP,Mark Yancey,7,1,8,16
DeWitt,101,U.S. Senate,,REP,Virgil Bierschwale,6,0,1,7
DeWitt,101,U.S. Senate,,REP,John Cornyn,94,28,138,260
DeWitt,101,U.S. Senate,,REP,John Anthony Castro,7,1,7,15
DeWitt,101,Ballots Cast,,REP,,154,36,198,388
DeWitt,101,U.S. Senate,,REP,Under Votes,13,1,12,26
DeWitt,101,U.S. Senate,,REP,Over Votes,0,0,0,0
DeWitt,101,U.S. House,34,REP,Rey Gonzalez,89,17,119,225
DeWitt,101,U.S. House,34,REP,Rod Lingsch,59,12,65,136
DeWitt,101,Ballots Cast,,REP,,148,29,184,361
DeWitt,101,U.S. House,34,REP,Under Votes,19,8,26,53
DeWitt,101,U.S. House,34,REP,Over Votes,0,0,0,0
DeWitt,101,Railroad Commissioner,,REP,Ryan Sitton,53,9,67,129
DeWitt,101,Railroad Commissioner,,REP,"James ""Jim"" Wright",88,20,120,228
DeWitt,101,Ballots Cast,,REP,,141,29,187,357
DeWitt,101,Railroad Commissioner,,REP,Under Votes,26,8,23,57
DeWitt,101,Railroad Commissioner,,REP,Over Votes,0,0,0,0
DeWitt,101,"Chief Justice, Supreme Court",,REP,Nathan Hecht,144,27,175,346
DeWitt,101,Ballots Cast,,REP,,144,27,175,346
DeWitt,101,"Chief Justice, Supreme Court",,REP,Under Votes,23,10,35,68
DeWitt,101,"Chief Justice, Supreme Court",,REP,Over Votes,0,0,0,0
DeWitt,101,"Justice, Supreme Court, Place 6 Unexpired Term",,REP,Jane Bland,145,27,169,341
DeWitt,101,Ballots Cast,,REP,,145,27,169,341
DeWitt,101,"Justice, Supreme Court, Place 6 Unexpired Term",,REP,Under Votes,22,10,41,73
DeWitt,101,"Justice, Supreme Court, Place 6 Unexpired Term",,REP,Over Votes,0,0,0,0
DeWitt,101,"Justice, Supreme Court, Place 7",,REP,Jeff Boyd,148,27,171,346
DeWitt,101,Ballots Cast,,REP,,148,27,171,346
DeWitt,101,"Justice, Supreme Court, Place 7",,REP,Under Votes,19,10,39,68
DeWitt,101,"Justice, Supreme Court, Place 7",,REP,Over Votes,0,0,0,0
DeWitt,101,"Justice, Supreme Court, Place 8",,REP,Brett Busby,146,27,169,342
DeWitt,101,Ballots Cast,,REP,,146,27,169,342
DeWitt,101,"Justice, Supreme Court, Place 8",,REP,Under Votes,21,10,41,72
DeWitt,101,"Justice, Supreme Court, Place 8",,REP,Over Votes,0,0,0,0
DeWitt,101,"Judge, Court of Criminal Appeals, Place 3",,REP,Gina Parker,80,13,111,204
DeWitt,101,"Judge, Court of Criminal Appeals, Place 3",,REP,Bert Richardson,62,17,65,144
DeWitt,101,Ballots Cast,,REP,,142,30,176,348
DeWitt,101,"Judge, Court of Criminal Appeals, Place 3",,REP,Under Votes,25,6,34,65
DeWitt,101,"Judge, Court of Criminal Appeals, Place 3",,REP,Over Votes,0,1,0,1
DeWitt,101,"Judge, Court of Criminal Appeals, Place 4",,REP,Kevin Patrick Yeary,145,27,167,339
DeWitt,101,Ballots Cast,,REP,,145,27,167,339
DeWitt,101,"Judge, Court of Criminal Appeals, Place 4",,REP,Under Votes,22,10,43,75
DeWitt,101,"Judge, Court of Criminal Appeals, Place 4",,REP,Over Votes,0,0,0,0
DeWitt,101,"Judge, Court of Criminal Appeals, Place 9",,REP,David Newell,143,27,167,337
DeWitt,101,Ballots Cast,,REP,,143,27,167,337
DeWitt,101,"Judge, Court of Criminal Appeals, Place 9",,REP,Under Votes,24,10,43,77
DeWitt,101,"Judge, Court of Criminal Appeals, Place 9",,REP,Over Votes,0,0,0,0
DeWitt,101,State Senate,18,REP,Lois W. Kolkhorst,158,31,181,370
DeWitt,101,Ballots Cast,,REP,,158,31,181,370
DeWitt,101,State Senate,18,REP,Under Votes,9,6,29,44
DeWitt,101,State Senate,18,REP,Over Votes,0,0,0,0
DeWitt,101,State Representative,30,REP,Geanie W. Morrison,135,34,179,348
DeWitt,101,State Representative,30,REP,Vanessa Hicks-Callaway,25,2,25,52
DeWitt,101,Ballots Cast,,REP,,160,36,204,400
DeWitt,101,State Representative,30,REP,Under Votes,7,1,6,14
DeWitt,101,State Representative,30,REP,Over Votes,0,0,0,0
DeWitt,101,"District Attorney, 24th Judicial District",,REP,"Robert C. ""Rob"" Lassman",155,32,178,365
DeWitt,101,Ballots Cast,,REP,,155,32,178,365
DeWitt,101,"District Attorney, 24th Judicial District",,REP,Under Votes,12,5,32,49
DeWitt,101,"District Attorney, 24th Judicial District",,REP,Over Votes,0,0,0,0
DeWitt,101,County Attorney,,REP,Jay Condie,152,32,185,369
DeWitt,101,Ballots Cast,,REP,,152,32,185,369
DeWitt,101,County Attorney,,REP,Under Votes,15,5,25,45
DeWitt,101,County Attorney,,REP,Over Votes,0,0,0,0
DeWitt,101,Sheriff,,REP,Carl R. Bowen,154,31,188,373
DeWitt,101,Ballots Cast,,REP,,154,31,188,373
DeWitt,101,Sheriff,,REP,Under Votes,13,6,22,41
DeWitt,101,Sheriff,,REP,Over Votes,0,0,0,0
DeWitt,101,County Tax Assessor-Collector,,REP,Ashley D. Mraz,141,33,183,357
DeWitt,101,County Tax Assessor-Collector,,REP,Guy Dolan,21,2,25,48
DeWitt,101,Ballots Cast,,REP,,162,35,208,405
DeWitt,101,County Tax Assessor-Collector,,REP,Under Votes,5,2,2,9
DeWitt,101,County Tax Assessor-Collector,,REP,Over Votes,0,0,0,0
DeWitt,101,"County Commissioner, Precinct 1",,REP,Curtis G. Afflerbach,155,31,184,370
DeWitt,101,Ballots Cast,,REP,,155,31,184,370
DeWitt,101,"County Commissioner, Precinct 1",,REP,Under Votes,12,6,26,44
DeWitt,101,"County Commissioner, Precinct 1",,REP,Over Votes,0,0,0,0
DeWitt,101,"Constable, Precinct 1",,REP,Kelly J. Phelps,149,29,176,354
DeWitt,101,Ballots Cast,,REP,,149,29,176,354
DeWitt,101,"Constable, Precinct 1",,REP,Under Votes,18,8,34,60
DeWitt,101,"Constable, Precinct 1",,REP,Over Votes,0,0,0,0
DeWitt,101,County Chairman,,REP,Paul Guidry,149,30,179,358
DeWitt,101,Ballots Cast,,REP,,149,30,179,358
DeWitt,101,County Chairman,,REP,Under Votes,18,7,31,56
DeWitt,101,County Chairman,,REP,Over Votes,0,0,0,0
DeWitt,101,Proposition #1,,DEM,Yes,29,9,16,54
DeWitt,101,Proposition #1,,DEM,No,3,3,3,9
DeWitt,101,Ballots Cast,,DEM,,32,12,19,63
DeWitt,101,Proposition #1,,DEM,Under Votes,2,0,1,3
DeWitt,101,Proposition #1,,DEM,Over Votes,0,0,0,0
DeWitt,101,Proposition #2,,DEM,Yes,28,12,17,57
DeWitt,101,Proposition #2,,DEM,No,2,0,2,4
DeWitt,101,Ballots Cast,,DEM,,30,12,19,61
DeWitt,101,Proposition #2,,DEM,Under Votes,4,0,1,5
DeWitt,101,Proposition #2,,DEM,Over Votes,0,0,0,0
DeWitt,101,Proposition #3,,DEM,Yes,26,12,19,57
DeWitt,101,Proposition #3,,DEM,No,3,0,0,3
DeWitt,101,Ballots Cast,,DEM,,29,12,19,60
DeWitt,101,Proposition #3,,DEM,Under Votes,5,0,1,6
DeWitt,101,Proposition #3,,DEM,Over Votes,0,0,0,0
DeWitt,101,Proposition #4,,DEM,Yes,27,11,16,54
DeWitt,101,Proposition #4,,DEM,No,5,1,3,9
DeWitt,101,Ballots Cast,,DEM,,32,12,19,63
DeWitt,101,Proposition #4,,DEM,Under Votes,2,0,1,3
DeWitt,101,Proposition #4,,DEM,Over Votes,0,0,0,0
DeWitt,101,Proposition #5,,DEM,Yes,29,12,19,60
DeWitt,101,Proposition #5,,DEM,No,2,0,0,2
DeWitt,101,Ballots Cast,,DEM,,31,12,19,62
DeWitt,101,Proposition #5,,DEM,Under Votes,3,0,1,4
DeWitt,101,Proposition #5,,DEM,Over Votes,0,0,0,0
DeWitt,101,Proposition #6,,DEM,Yes,30,11,19,60
DeWitt,101,Proposition #6,,DEM,No,2,1,0,3
DeWitt,101,Ballots Cast,,DEM,,32,12,19,63
DeWitt,101,Proposition #6,,DEM,Under Votes,2,0,1,3
DeWitt,101,Proposition #6,,DEM,Over Votes,0,0,0,0
DeWitt,101,Proposition #7,,DEM,Yes,27,11,18,56
DeWitt,101,Proposition #7,,DEM,No,4,1,0,5
DeWitt,101,Ballots Cast,,DEM,,31,12,18,61
DeWitt,101,Proposition #7,,DEM,Under Votes,3,0,2,5
DeWitt,101,Proposition #7,,DEM,Over Votes,0,0,0,0
DeWitt,101,Proposition #8,,DEM,Yes,27,12,17,56
DeWitt,101,Proposition #8,,DEM,No,2,0,2,4
DeWitt,101,Ballots Cast,,DEM,,29,12,19,60
DeWitt,101,Proposition #8,,DEM,Under Votes,5,0,1,6
DeWitt,101,Proposition #8,,DEM,Over Votes,0,0,0,0
DeWitt,101,Proposition #9,,DEM,Yes,26,12,17,55
DeWitt,101,Proposition #9,,DEM,No,4,0,2,6
DeWitt,101,Ballots Cast,,DEM,,30,12,19,61
DeWitt,101,Proposition #9,,DEM,Under Votes,4,0,1,5
DeWitt,101,Proposition #9,,DEM,Over Votes,0,0,0,0
DeWitt,101,Proposition #10,,DEM,Yes,27,12,19,58
DeWitt,101,Proposition #10,,DEM,No,4,0,0,4
DeWitt,101,Ballots Cast,,DEM,,31,12,19,62
DeWitt,101,Proposition #10,,DEM,Under Votes,3,0,1,4
DeWitt,101,Proposition #10,,DEM,Over Votes,0,0,0,0
DeWitt,101,Proposition #11,,DEM,Yes,25,10,18,53
DeWitt,101,Proposition #11,,DEM,No,4,2,0,6
DeWitt,101,Ballots Cast,,DEM,,29,12,18,59
DeWitt,101,Proposition #11,,DEM,Under Votes,5,0,2,7
DeWitt,101,Proposition #11,,DEM,Over Votes,0,0,0,0
DeWitt,101,Proposition 1,,REP,Yes,134,33,180,347
DeWitt,101,Proposition 1,,REP,No,29,4,23,56
DeWitt,101,Ballots Cast,,REP,,163,37,203,403
DeWitt,101,Proposition 1,,REP,Under Votes,4,0,7,11
DeWitt,101,Proposition 1,,REP,Over Votes,0,0,0,0
DeWitt,101,Proposition 2,,REP,Yes,135,33,174,342
DeWitt,101,Proposition 2,,REP,No,29,3,31,63
DeWitt,101,Ballots Cast,,REP,,164,36,205,405
DeWitt,101,Proposition 2,,REP,Under Votes,3,1,5,9
DeWitt,101,Proposition 2,,REP,Over Votes,0,0,0,0
DeWitt,101,Proposition 3,,REP,Yes,147,36,181,364
DeWitt,101,Proposition 3,,REP,No,15,1,16,32
DeWitt,101,Ballots Cast,,REP,,162,37,197,396
DeWitt,101,Proposition 3,,REP,Under Votes,5,0,13,18
DeWitt,101,Proposition 3,,REP,Over Votes,0,0,0,0
DeWitt,101,Proposition 4,,REP,Yes,148,35,186,369
DeWitt,101,Proposition 4,,REP,No,12,2,13,27
DeWitt,101,Ballots Cast,,REP,,160,37,199,396
DeWitt,101,Proposition 4,,REP,Under Votes,7,0,11,18
DeWitt,101,Proposition 4,,REP,Over Votes,0,0,0,0
DeWitt,101,Proposition 5,,REP,Yes,145,31,189,365
DeWitt,101,Proposition 5,,REP,No,18,4,14,36
DeWitt,101,Ballots Cast,,REP,,163,35,203,401
DeWitt,101,Proposition 5,,REP,Under Votes,4,2,7,13
DeWitt,101,Proposition 5,,REP,Over Votes,0,0,0,0
DeWitt,101,Proposition 6,,REP,Yes,154,33,186,373
DeWitt,101,Proposition 6,,REP,No,9,2,17,28
DeWitt,101,Ballots Cast,,REP,,163,35,203,401
DeWitt,101,Proposition 6,,REP,Under Votes,4,2,7,13
DeWitt,101,Proposition 6,,REP,Over Votes,0,0,0,0
DeWitt,101,Proposition 7,,REP,Yes,161,34,193,388
DeWitt,101,Proposition 7,,REP,No,2,0,7,9
DeWitt,101,Ballots Cast,,REP,,163,34,200,397
DeWitt,101,Proposition 7,,REP,Under Votes,4,3,10,17
DeWitt,101,Proposition 7,,REP,Over Votes,0,0,0,0
DeWitt,101,Proposition 8,,REP,Yes,162,35,193,390
DeWitt,101,Proposition 8,,REP,No,1,1,6,8
DeWitt,101,Ballots Cast,,REP,,163,36,199,398
DeWitt,101,Proposition 8,,REP,Under Votes,4,1,11,16
DeWitt,101,Proposition 8,,REP,Over Votes,0,0,0,0
DeWitt,101,Proposition 9,,REP,Yes,150,34,194,378
DeWitt,101,Proposition 9,,REP,No,12,0,7,19
DeWitt,101,Ballots Cast,,REP,,162,34,201,397
DeWitt,101,Proposition 9,,REP,Under Votes,5,3,9,17
DeWitt,101,Proposition 9,,REP,Over Votes,0,0,0,0
DeWitt,101,Proposition 10,,REP,Yes,153,33,174,360
DeWitt,101,Proposition 10,,REP,No,9,1,24,34
DeWitt,101,Ballots Cast,,REP,,162,34,198,394
DeWitt,101,Proposition 10,,REP,Under Votes,5,3,12,20
DeWitt,101,Proposition 10,,REP,Over Votes,0,0,0,0
DeWitt,102,President,,DEM,Amy Klobuchar,0,2,0,2
DeWitt,102,President,,DEM,Joseph R. Biden,33,8,8,49
DeWitt,102,President,,DEM,Michael Bennet,0,0,0,0
DeWitt,102,President,,DEM,Marianne Williamson,0,0,0,0
DeWitt,102,President,,DEM,Michael R. Bloomberg,2,6,5,13
DeWitt,102,President,,DEM,Elizabeth Warren,4,1,1,6
DeWitt,102,President,,DEM,Andrew Yang,0,0,0,0
DeWitt,102,President,,DEM,Tom Steyer,0,0,0,0
DeWitt,102,President,,DEM,Pete Buttigieg,0,0,0,0
DeWitt,102,President,,DEM,Tulsi Gabbard,0,0,0,0
DeWitt,102,President,,DEM,Robby Wells,0,0,0,0
DeWitt,102,President,,DEM,Deval Patrick,0,0,0,0
DeWitt,102,President,,DEM,Bernie Sanders,13,1,2,16
DeWitt,102,President,,DEM,"Roque ""Rocky"" De La Fuente Guerra",1,0,0,1
DeWitt,102,President,,DEM,John K. Delaney,0,0,0,0
DeWitt,102,President,,DEM,Cory Booker,0,0,0,0
DeWitt,102,President,,DEM,Julián Castro,0,1,0,1
DeWitt,102,Ballots Cast,,DEM,,53,19,16,88
DeWitt,102,President,,DEM,Under Votes,0,0,1,1
DeWitt,102,President,,DEM,Over Votes,0,1,0,1
DeWitt,102,U.S. Senate,,DEM,Victor Hugo Harris,5,1,2,8
DeWitt,102,U.S. Senate,,DEM,"Annie ""Mamá"" Garcia",13,0,1,14
DeWitt,102,U.S. Senate,,DEM,Amanda K. Edwards,3,3,1,7
DeWitt,102,U.S. Senate,,DEM,Royce West,4,1,1,6
DeWitt,102,U.S. Senate,,DEM,Adrian Ocegueda,1,1,4,6
DeWitt,102,U.S. Senate,,DEM,D.R. Hunter,0,0,0,0
DeWitt,102,U.S. Senate,,DEM,Michael Cooper,2,1,2,5
DeWitt,102,U.S. Senate,,DEM,Chris Bell,5,1,0,6
DeWitt,102,U.S. Senate,,DEM,Cristina Tzintzun Ramirez,1,0,1,2
DeWitt,102,U.S. Senate,,DEM,Sema Hernandez,2,4,1,7
DeWitt,102,U.S. Senate,,DEM,Jack Daniel Foster Jr,0,0,0,0
DeWitt,102,U.S. Senate,,DEM,"Mary ""MJ"" Hegar",2,2,1,5
DeWitt,102,Ballots Cast,,DEM,,38,14,14,66
DeWitt,102,U.S. Senate,,DEM,Under Votes,15,5,3,23
DeWitt,102,U.S. Senate,,DEM,Over Votes,0,1,0,1
DeWitt,102,U.S. House,34,DEM,Diego Zavala,18,5,7,30
DeWitt,102,U.S. House,34,DEM,Osbert Haro,2,1,1,4
DeWitt,102,U.S. House,34,DEM,Filemon B. Vela,20,9,7,36
DeWitt,102,Ballots Cast,,DEM,,40,15,15,70
DeWitt,102,U.S. House,34,DEM,Under Votes,13,5,2,20
DeWitt,102,U.S. House,34,DEM,Over Votes,0,0,0,0
DeWitt,102,Railroad Commissioner,,DEM,Chrysta Castañeda,7,4,4,15
DeWitt,102,Railroad Commissioner,,DEM,Kelly Stone,5,1,3,9
DeWitt,102,Railroad Commissioner,,DEM,Mark Watson,11,5,1,17
DeWitt,102,Railroad Commissioner,,DEM,"Roberto R. ""Beto"" Alonzo",19,5,6,30
DeWitt,102,Ballots Cast,,DEM,,42,15,14,71
DeWitt,102,Railroad Commissioner,,DEM,Under Votes,11,5,3,19
DeWitt,102,Railroad Commissioner,,DEM,Over Votes,0,0,0,0
DeWitt,102,"Chief Justice, Supreme Court",,DEM,Jerry Zimmerer,11,2,5,18
DeWitt,102,"Chief Justice, Supreme Court",,DEM,Amy Clark Meachum,31,12,9,52
DeWitt,102,Ballots Cast,,DEM,,42,14,14,70
DeWitt,102,"Chief Justice, Supreme Court",,DEM,Under Votes,11,6,3,20
DeWitt,102,"Chief Justice, Supreme Court",,DEM,Over Votes,0,0,0,0
DeWitt,102,"Justice, Supreme Court, Place 6 Unexpired Term",,DEM,Larry Praeger,10,3,4,17
DeWitt,102,"Justice, Supreme Court, Place 6 Unexpired Term",,DEM,Kathy Cheng,26,12,10,48
DeWitt,102,Ballots Cast,,DEM,,36,15,14,65
DeWitt,102,"Justice, Supreme Court, Place 6 Unexpired Term",,DEM,Under Votes,17,5,3,25
DeWitt,102,"Justice, Supreme Court, Place 6 Unexpired Term",,DEM,Over Votes,0,0,0,0
DeWitt,102,"Justice, Supreme Court, Place 7",,DEM,Staci Williams,29,10,9,48
DeWitt,102,"Justice, Supreme Court, Place 7",,DEM,Brandy Voss,9,3,5,17
DeWitt,102,Ballots Cast,,DEM,,38,13,14,65
DeWitt,102,"Justice, Supreme Court, Place 7",,DEM,Under Votes,15,7,3,25
DeWitt,102,"Justice, Supreme Court, Place 7",,DEM,Over Votes,0,0,0,0
DeWitt,102,"Justice, Supreme Court, Place 8",,DEM,Peter Kelly,16,5,5,26
DeWitt,102,"Justice, Supreme Court, Place 8",,DEM,Gisela D. Triana,24,9,8,41
DeWitt,102,Ballots Cast,,DEM,,40,14,13,67
DeWitt,102,"Justice, Supreme Court, Place 8",,DEM,Under Votes,13,6,4,23
DeWitt,102,"Justice, Supreme Court, Place 8",,DEM,Over Votes,0,0,0,0
DeWitt,102,"Judge, Court of Criminal Appeals, Place 3",,DEM,Dan Wood,7,2,6,15
DeWitt,102,"Judge, Court of Criminal Appeals, Place 3",,DEM,William Pieratt Demond,6,1,0,7
DeWitt,102,"Judge, Court of Criminal Appeals, Place 3",,DEM,Elizabeth Davis Frizell,24,11,8,43
DeWitt,102,Ballots Cast,,DEM,,37,14,14,65
DeWitt,102,"Judge, Court of Criminal Appeals, Place 3",,DEM,Under Votes,16,6,3,25
DeWitt,102,"Judge, Court of Criminal Appeals, Place 3",,DEM,Over Votes,0,0,0,0
DeWitt,102,"Judge, Court of Criminal Appeals, Place 4",,DEM,Steven Miears,11,4,3,18
DeWitt,102,"Judge, Court of Criminal Appeals, Place 4",,DEM,Tina Clinton,28,10,11,49
DeWitt,102,Ballots Cast,,DEM,,39,14,14,67
DeWitt,102,"Judge, Court of Criminal Appeals, Place 4",,DEM,Under Votes,14,6,3,23
DeWitt,102,"Judge, Court of Criminal Appeals, Place 4",,DEM,Over Votes,0,0,0,0
DeWitt,102,"Judge, Court of Criminal Appeals, Place 9",,DEM,Brandon Birmingham,34,13,14,61
DeWitt,102,Ballots Cast,,DEM,,34,13,14,61
DeWitt,102,"Judge, Court of Criminal Appeals, Place 9",,DEM,Under Votes,19,7,3,29
DeWitt,102,"Judge, Court of Criminal Appeals, Place 9",,DEM,Over Votes,0,0,0,0
DeWitt,102,State Senate,18,DEM,Michael Antalan,35,12,15,62
DeWitt,102,Ballots Cast,,DEM,,35,12,15,62
DeWitt,102,State Senate,18,DEM,Under Votes,18,8,2,28
DeWitt,102,State Senate,18,DEM,Over Votes,0,0,0,0
DeWitt,102,County Chairman,,DEM,Jospeh L. Sheppard,47,15,16,78
DeWitt,102,Ballots Cast,,DEM,,47,15,16,78
DeWitt,102,County Chairman,,DEM,Under Votes,6,5,1,12
DeWitt,102,County Chairman,,DEM,Over Votes,0,0,0,0
DeWitt,102,President,,REP,Zoltan G. Istvan,0,0,0,0
DeWitt,102,President,,REP,Donald J. Trump,23,6,47,76
DeWitt,102,President,,REP,Bill Weld,1,0,0,1
DeWitt,102,President,,REP,Joe Walsh,4,0,0,4
DeWitt,102,President,,REP,"Roque ""Rocky"" De La Fuente Guerra",0,0,0,0
DeWitt,102,President,,REP,Matthew John Matern,2,0,0,2
DeWitt,102,President,,REP,Bob Ely,0,0,0,0
DeWitt,102,President,,REP,Uncommitted,7,0,3,10
DeWitt,102,Ballots Cast,,REP,,37,6,50,93
DeWitt,102,President,,REP,Under Votes,1,0,0,1
DeWitt,102,President,,REP,Over Votes,0,0,0,0
DeWitt,102,U.S. Senate,,REP,Dwayne Stovall,7,0,19,26
DeWitt,102,U.S. Senate,,REP,Mark Yancey,4,0,0,4
DeWitt,102,U.S. Senate,,REP,Virgil Bierschwale,0,0,0,0
DeWitt,102,U.S. Senate,,REP,John Cornyn,12,6,19,37
DeWitt,102,U.S. Senate,,REP,John Anthony Castro,10,0,6,16
DeWitt,102,Ballots Cast,,REP,,33,6,44,83
DeWitt,102,U.S. Senate,,REP,Under Votes,5,0,6,11
DeWitt,102,U.S. Senate,,REP,Over Votes,0,0,0,0
DeWitt,102,U.S. House,34,REP,Rey Gonzalez,28,2,36,66
DeWitt,102,U.S. House,34,REP,Rod Lingsch,4,4,9,17
DeWitt,102,Ballots Cast,,REP,,32,6,45,83
DeWitt,102,U.S. House,34,REP,Under Votes,6,0,5,11
DeWitt,102,U.S. House,34,REP,Over Votes,0,0,0,0
DeWitt,102,Railroad Commissioner,,REP,Ryan Sitton,11,0,16,27
DeWitt,102,Railroad Commissioner,,REP,"James ""Jim"" Wright",19,4,30,53
DeWitt,102,Ballots Cast,,REP,,30,4,46,80
DeWitt,102,Railroad Commissioner,,REP,Under Votes,8,2,4,14
DeWitt,102,Railroad Commissioner,,REP,Over Votes,0,0,0,0
DeWitt,102,"Chief Justice, Supreme Court",,REP,Nathan Hecht,31,4,45,80
DeWitt,102,Ballots Cast,,REP,,31,4,45,80
DeWitt,102,"Chief Justice, Supreme Court",,REP,Under Votes,7,2,5,14
DeWitt,102,"Chief Justice, Supreme Court",,REP,Over Votes,0,0,0,0
DeWitt,102,"Justice, Supreme Court, Place 6 Unexpired Term",,REP,Jane Bland,30,4,46,80
DeWitt,102,Ballots Cast,,REP,,30,4,46,80
DeWitt,102,"Justice, Supreme Court, Place 6 Unexpired Term",,REP,Under Votes,8,2,4,14
DeWitt,102,"Justice, Supreme Court, Place 6 Unexpired Term",,REP,Over Votes,0,0,0,0
DeWitt,102,"Justice, Supreme Court, Place 7",,REP,Jeff Boyd,27,4,45,76
DeWitt,102,Ballots Cast,,REP,,27,4,45,76
DeWitt,102,"Justice, Supreme Court, Place 7",,REP,Under Votes,11,2,5,18
DeWitt,102,"Justice, Supreme Court, Place 7",,REP,Over Votes,0,0,0,0
DeWitt,102,"Justice, Supreme Court, Place 8",,REP,Brett Busby,28,4,46,78
DeWitt,102,Ballots Cast,,REP,,28,4,46,78
DeWitt,102,"Justice, Supreme Court, Place 8",,REP,Under Votes,10,2,4,16
DeWitt,102,"Justice, Supreme Court, Place 8",,REP,Over Votes,0,0,0,0
DeWitt,102,"Judge, Court of Criminal Appeals, Place 3",,REP,Gina Parker,20,1,34,55
DeWitt,102,"Judge, Court of Criminal Appeals, Place 3",,REP,Bert Richardson,12,3,11,26
DeWitt,102,Ballots Cast,,REP,,32,4,45,81
DeWitt,102,"Judge, Court of Criminal Appeals, Place 3",,REP,Under Votes,6,2,5,13
DeWitt,102,"Judge, Court of Criminal Appeals, Place 3",,REP,Over Votes,0,0,0,0
DeWitt,102,"Judge, Court of Criminal Appeals, Place 4",,REP,Kevin Patrick Yeary,30,4,45,79
DeWitt,102,Ballots Cast,,REP,,30,4,45,79
DeWitt,102,"Judge, Court of Criminal Appeals, Place 4",,REP,Under Votes,8,2,5,15
DeWitt,102,"Judge, Court of Criminal Appeals, Place 4",,REP,Over Votes,0,0,0,0
DeWitt,102,"Judge, Court of Criminal Appeals, Place 9",,REP,David Newell,30,4,46,80
DeWitt,102,Ballots Cast,,REP,,30,4,46,80
DeWitt,102,"Judge, Court of Criminal Appeals, Place 9",,REP,Under Votes,8,2,4,14
DeWitt,102,"Judge, Court of Criminal Appeals, Place 9",,REP,Over Votes,0,0,0,0
DeWitt,102,State Senate,18,REP,Lois W. Kolkhorst,28,4,45,77
DeWitt,102,Ballots Cast,,REP,,28,4,45,77
DeWitt,102,State Senate,18,REP,Under Votes,10,2,5,17
DeWitt,102,State Senate,18,REP,Over Votes,0,0,0,0
DeWitt,102,State Representative,30,REP,Geanie W. Morrison,23,4,31,58
DeWitt,102,State Representative,30,REP,Vanessa Hicks-Callaway,10,0,17,27
DeWitt,102,Ballots Cast,,REP,,33,4,48,85
DeWitt,102,State Representative,30,REP,Under Votes,5,2,2,9
DeWitt,102,State Representative,30,REP,Over Votes,0,0,0,0
DeWitt,102,"District Attorney, 24th Judicial District",,REP,"Robert C. ""Rob"" Lassman",35,4,43,82
DeWitt,102,Ballots Cast,,REP,,35,4,43,82
DeWitt,102,"District Attorney, 24th Judicial District",,REP,Under Votes,3,2,7,12
DeWitt,102,"District Attorney, 24th Judicial District",,REP,Over Votes,0,0,0,0
DeWitt,102,County Attorney,,REP,Jay Condie,31,4,45,80
DeWitt,102,Ballots Cast,,REP,,31,4,45,80
DeWitt,102,County Attorney,,REP,Under Votes,7,2,5,14
DeWitt,102,County Attorney,,REP,Over Votes,0,0,0,0
DeWitt,102,Sheriff,,REP,Carl R. Bowen,34,4,44,82
DeWitt,102,Ballots Cast,,REP,,34,4,44,82
DeWitt,102,Sheriff,,REP,Under Votes,4,2,6,12
DeWitt,102,Sheriff,,REP,Over Votes,0,0,0,0
DeWitt,102,County Tax Assessor-Collector,,REP,Ashley D. Mraz,27,4,41,72
DeWitt,102,County Tax Assessor-Collector,,REP,Guy Dolan,10,0,9,19
DeWitt,102,Ballots Cast,,REP,,37,4,50,91
DeWitt,102,County Tax Assessor-Collector,,REP,Under Votes,1,2,0,3
DeWitt,102,County Tax Assessor-Collector,,REP,Over Votes,0,0,0,0
DeWitt,102,"County Commissioner, Precinct 1",,REP,Curtis G. Afflerbach,34,4,50,88
DeWitt,102,Ballots Cast,,REP,,34,4,50,88
DeWitt,102,"County Commissioner, Precinct 1",,REP,Under Votes,4,2,0,6
DeWitt,102,"County Commissioner, Precinct 1",,REP,Over Votes,0,0,0,0
DeWitt,102,"Constable, Precinct 1",,REP,Kelly J. Phelps,30,4,45,79
DeWitt,102,Ballots Cast,,REP,,30,4,45,79
DeWitt,102,"Constable, Precinct 1",,REP,Under Votes,8,2,5,15
DeWitt,102,"Constable, Precinct 1",,REP,Over Votes,0,0,0,0
DeWitt,102,County Chairman,,REP,Paul Guidry,30,4,46,80
DeWitt,102,Ballots Cast,,REP,,30,4,46,80
DeWitt,102,County Chairman,,REP,Under Votes,8,2,4,14
DeWitt,102,County Chairman,,REP,Over Votes,0,0,0,0
DeWitt,102,Proposition #1,,DEM,Yes,45,19,17,81
DeWitt,102,Proposition #1,,DEM,No,0,0,0,0
DeWitt,102,Ballots Cast,,DEM,,45,19,17,81
DeWitt,102,Proposition #1,,DEM,Under Votes,8,1,0,9
DeWitt,102,Proposition #1,,DEM,Over Votes,0,0,0,0
DeWitt,102,Proposition #2,,DEM,Yes,42,19,15,76
DeWitt,102,Proposition #2,,DEM,No,0,0,1,1
DeWitt,102,Ballots Cast,,DEM,,42,19,16,77
DeWitt,102,Proposition #2,,DEM,Under Votes,11,1,1,13
DeWitt,102,Proposition #2,,DEM,Over Votes,0,0,0,0
DeWitt,102,Proposition #3,,DEM,Yes,44,19,15,78
DeWitt,102,Proposition #3,,DEM,No,0,0,0,0
DeWitt,102,Ballots Cast,,DEM,,44,19,15,78
DeWitt,102,Proposition #3,,DEM,Under Votes,9,1,2,12
DeWitt,102,Proposition #3,,DEM,Over Votes,0,0,0,0
DeWitt,102,Proposition #4,,DEM,Yes,44,19,16,79
DeWitt,102,Proposition #4,,DEM,No,0,0,0,0
DeWitt,102,Ballots Cast,,DEM,,44,19,16,79
DeWitt,102,Proposition #4,,DEM,Under Votes,9,1,1,11
DeWitt,102,Proposition #4,,DEM,Over Votes,0,0,0,0
DeWitt,102,Proposition #5,,DEM,Yes,44,19,16,79
DeWitt,102,Proposition #5,,DEM,No,1,0,0,1
DeWitt,102,Ballots Cast,,DEM,,45,19,16,80
DeWitt,102,Proposition #5,,DEM,Under Votes,8,1,1,10
DeWitt,102,Proposition #5,,DEM,Over Votes,0,0,0,0
DeWitt,102,Proposition #6,,DEM,Yes,43,19,16,78
DeWitt,102,Proposition #6,,DEM,No,0,0,0,0
DeWitt,102,Ballots Cast,,DEM,,43,19,16,78
DeWitt,102,Proposition #6,,DEM,Under Votes,10,1,1,12
DeWitt,102,Proposition #6,,DEM,Over Votes,0,0,0,0
DeWitt,102,Proposition #7,,DEM,Yes,47,19,16,82
DeWitt,102,Proposition #7,,DEM,No,0,0,0,0
DeWitt,102,Ballots Cast,,DEM,,47,19,16,82
DeWitt,102,Proposition #7,,DEM,Under Votes,6,1,1,8
DeWitt,102,Proposition #7,,DEM,Over Votes,0,0,0,0
DeWitt,102,Proposition #8,,DEM,Yes,45,18,16,79
DeWitt,102,Proposition #8,,DEM,No,0,0,0,0
DeWitt,102,Ballots Cast,,DEM,,45,18,16,79
DeWitt,102,Proposition #8,,DEM,Under Votes,8,2,1,11
DeWitt,102,Proposition #8,,DEM,Over Votes,0,0,0,0
DeWitt,102,Proposition #9,,DEM,Yes,45,19,16,80
DeWitt,102,Proposition #9,,DEM,No,0,0,0,0
DeWitt,102,Ballots Cast,,DEM,,45,19,16,80
DeWitt,102,Proposition #9,,DEM,Under Votes,8,1,1,10
DeWitt,102,Proposition #9,,DEM,Over Votes,0,0,0,0
DeWitt,102,Proposition #10,,DEM,Yes,43,18,13,74
DeWitt,102,Proposition #10,,DEM,No,2,0,1,3
DeWitt,102,Ballots Cast,,DEM,,45,18,14,77
DeWitt,102,Proposition #10,,DEM,Under Votes,8,2,3,13
DeWitt,102,Proposition #10,,DEM,Over Votes,0,0,0,0
DeWitt,102,Proposition #11,,DEM,Yes,44,19,16,79
DeWitt,102,Proposition #11,,DEM,No,2,0,0,2
DeWitt,102,Ballots Cast,,DEM,,46,19,16,81
DeWitt,102,Proposition #11,,DEM,Under Votes,7,1,1,9
DeWitt,102,Proposition #11,,DEM,Over Votes,0,0,0,0
DeWitt,102,Proposition 1,,REP,Yes,26,6,40,72
DeWitt,102,Proposition 1,,REP,No,11,0,8,19
DeWitt,102,Ballots Cast,,REP,,37,6,48,91
DeWitt,102,Proposition 1,,REP,Under Votes,1,0,2,3
DeWitt,102,Proposition 1,,REP,Over Votes,0,0,0,0
DeWitt,102,Proposition 2,,REP,Yes,24,5,40,69
DeWitt,102,Proposition 2,,REP,No,13,1,10,24
DeWitt,102,Ballots Cast,,REP,,37,6,50,93
DeWitt,102,Proposition 2,,REP,Under Votes,1,0,0,1
DeWitt,102,Proposition 2,,REP,Over Votes,0,0,0,0
DeWitt,102,Proposition 3,,REP,Yes,28,6,43,77
DeWitt,102,Proposition 3,,REP,No,5,0,5,10
DeWitt,102,Ballots Cast,,REP,,33,6,48,87
DeWitt,102,Proposition 3,,REP,Under Votes,5,0,2,7
DeWitt,102,Proposition 3,,REP,Over Votes,0,0,0,0
DeWitt,102,Proposition 4,,REP,Yes,26,6,43,75
DeWitt,102,Proposition 4,,REP,No,10,0,5,15
DeWitt,102,Ballots Cast,,REP,,36,6,48,90
DeWitt,102,Proposition 4,,REP,Under Votes,2,0,2,4
DeWitt,102,Proposition 4,,REP,Over Votes,0,0,0,0
DeWitt,102,Proposition 5,,REP,Yes,32,6,44,82
DeWitt,102,Proposition 5,,REP,No,3,0,3,6
DeWitt,102,Ballots Cast,,REP,,35,6,47,88
DeWitt,102,Proposition 5,,REP,Under Votes,3,0,3,6
DeWitt,102,Proposition 5,,REP,Over Votes,0,0,0,0
DeWitt,102,Proposition 6,,REP,Yes,29,6,47,82
DeWitt,102,Proposition 6,,REP,No,6,0,1,7
DeWitt,102,Ballots Cast,,REP,,35,6,48,89
DeWitt,102,Proposition 6,,REP,Under Votes,3,0,2,5
DeWitt,102,Proposition 6,,REP,Over Votes,0,0,0,0
DeWitt,102,Proposition 7,,REP,Yes,34,6,48,88
DeWitt,102,Proposition 7,,REP,No,2,0,1,3
DeWitt,102,Ballots Cast,,REP,,36,6,49,91
DeWitt,102,Proposition 7,,REP,Under Votes,2,0,1,3
DeWitt,102,Proposition 7,,REP,Over Votes,0,0,0,0
DeWitt,102,Proposition 8,,REP,Yes,32,5,46,83
DeWitt,102,Proposition 8,,REP,No,3,1,1,5
DeWitt,102,Ballots Cast,,REP,,35,6,47,88
DeWitt,102,Proposition 8,,REP,Under Votes,3,0,3,6
DeWitt,102,Proposition 8,,REP,Over Votes,0,0,0,0
DeWitt,102,Proposition 9,,REP,Yes,31,5,44,80
DeWitt,102,Proposition 9,,REP,No,5,1,3,9
DeWitt,102,Ballots Cast,,REP,,36,6,47,89
DeWitt,102,Proposition 9,,REP,Under Votes,2,0,3,5
DeWitt,102,Proposition 9,,REP,Over Votes,0,0,0,0
DeWitt,102,Proposition 10,,REP,Yes,29,5,42,76
DeWitt,102,Proposition 10,,REP,No,6,1,6,13
DeWitt,102,Ballots Cast,,REP,,35,6,48,89
DeWitt,102,Proposition 10,,REP,Under Votes,3,0,2,5
DeWitt,102,Proposition 10,,REP,Over Votes,0,0,0,0
DeWitt,201,President,,DEM,Amy Klobuchar,0,0,0,0
DeWitt,201,President,,DEM,Joseph R. Biden,2,2,0,4
DeWitt,201,President,,DEM,Michael Bennet,0,0,0,0
DeWitt,201,President,,DEM,Marianne Williamson,0,0,0,0
DeWitt,201,President,,DEM,Michael R. Bloomberg,2,3,2,7
DeWitt,201,President,,DEM,Elizabeth Warren,0,0,1,1
DeWitt,201,President,,DEM,Andrew Yang,0,0,0,0
DeWitt,201,President,,DEM,Tom Steyer,0,0,0,0
DeWitt,201,President,,DEM,Pete Buttigieg,0,0,0,0
DeWitt,201,President,,DEM,Tulsi Gabbard,0,0,0,0
DeWitt,201,President,,DEM,Robby Wells,0,0,0,0
DeWitt,201,President,,DEM,Deval Patrick,0,0,0,0
DeWitt,201,President,,DEM,Bernie Sanders,4,0,0,4
DeWitt,201,President,,DEM,"Roque ""Rocky"" De La Fuente Guerra",1,0,0,1
DeWitt,201,President,,DEM,John K. Delaney,0,0,0,0
DeWitt,201,President,,DEM,Cory Booker,0,0,0,0
DeWitt,201,President,,DEM,Julián Castro,0,0,0,0
DeWitt,201,Ballots Cast,,DEM,,9,5,3,17
DeWitt,201,President,,DEM,Under Votes,0,0,0,0
DeWitt,201,President,,DEM,Over Votes,0,0,0,0
DeWitt,201,U.S. Senate,,DEM,Victor Hugo Harris,0,0,0,0
DeWitt,201,U.S. Senate,,DEM,"Annie ""Mamá"" Garcia",0,0,0,0
DeWitt,201,U.S. Senate,,DEM,Amanda K. Edwards,3,0,0,3
DeWitt,201,U.S. Senate,,DEM,Royce West,0,0,2,2
DeWitt,201,U.S. Senate,,DEM,Adrian Ocegueda,0,0,0,0
DeWitt,201,U.S. Senate,,DEM,D.R. Hunter,0,1,0,1
DeWitt,201,U.S. Senate,,DEM,Michael Cooper,0,0,0,0
DeWitt,201,U.S. Senate,,DEM,Chris Bell,2,2,0,4
DeWitt,201,U.S. Senate,,DEM,Cristina Tzintzun Ramirez,0,0,0,0
DeWitt,201,U.S. Senate,,DEM,Sema Hernandez,1,0,0,1
DeWitt,201,U.S. Senate,,DEM,Jack Daniel Foster Jr,1,0,0,1
DeWitt,201,U.S. Senate,,DEM,"Mary ""MJ"" Hegar",1,2,1,4
DeWitt,201,Ballots Cast,,DEM,,8,5,3,16
DeWitt,201,U.S. Senate,,DEM,Under Votes,1,0,0,1
DeWitt,201,U.S. Senate,,DEM,Over Votes,0,0,0,0
DeWitt,201,U.S. House,34,DEM,Diego Zavala,1,1,1,3
DeWitt,201,U.S. House,34,DEM,Osbert Haro,2,0,1,3
DeWitt,201,U.S. House,34,DEM,Filemon B. Vela,3,4,1,8
DeWitt,201,Ballots Cast,,DEM,,6,5,3,14
DeWitt,201,U.S. House,34,DEM,Under Votes,3,0,0,3
DeWitt,201,U.S. House,34,DEM,Over Votes,0,0,0,0
DeWitt,201,Railroad Commissioner,,DEM,Chrysta Castañeda,0,2,0,2
DeWitt,201,Railroad Commissioner,,DEM,Kelly Stone,3,0,1,4
DeWitt,201,Railroad Commissioner,,DEM,Mark Watson,1,2,2,5
DeWitt,201,Railroad Commissioner,,DEM,"Roberto R. ""Beto"" Alonzo",3,1,0,4
DeWitt,201,Ballots Cast,,DEM,,7,5,3,15
DeWitt,201,Railroad Commissioner,,DEM,Under Votes,2,0,0,2
DeWitt,201,Railroad Commissioner,,DEM,Over Votes,0,0,0,0
DeWitt,201,"Chief Justice, Supreme Court",,DEM,Jerry Zimmerer,4,1,1,6
DeWitt,201,"Chief Justice, Supreme Court",,DEM,Amy Clark Meachum,2,4,2,8
DeWitt,201,Ballots Cast,,DEM,,6,5,3,14
DeWitt,201,"Chief Justice, Supreme Court",,DEM,Under Votes,3,0,0,3
DeWitt,201,"Chief Justice, Supreme Court",,DEM,Over Votes,0,0,0,0
DeWitt,201,"Justice, Supreme Court, Place 6 Unexpired Term",,DEM,Larry Praeger,1,0,1,2
DeWitt,201,"Justice, Supreme Court, Place 6 Unexpired Term",,DEM,Kathy Cheng,5,5,2,12
DeWitt,201,Ballots Cast,,DEM,,6,5,3,14
DeWitt,201,"Justice, Supreme Court, Place 6 Unexpired Term",,DEM,Under Votes,3,0,0,3
DeWitt,201,"Justice, Supreme Court, Place 6 Unexpired Term",,DEM,Over Votes,0,0,0,0
DeWitt,201,"Justice, Supreme Court, Place 7",,DEM,Staci Williams,6,1,2,9
DeWitt,201,"Justice, Supreme Court, Place 7",,DEM,Brandy Voss,0,4,1,5
DeWitt,201,Ballots Cast,,DEM,,6,5,3,14
DeWitt,201,"Justice, Supreme Court, Place 7",,DEM,Under Votes,3,0,0,3
DeWitt,201,"Justice, Supreme Court, Place 7",,DEM,Over Votes,0,0,0,0
DeWitt,201,"Justice, Supreme Court, Place 8",,DEM,Peter Kelly,2,0,2,4
DeWitt,201,"Justice, Supreme Court, Place 8",,DEM,Gisela D. Triana,4,5,1,10
DeWitt,201,Ballots Cast,,DEM,,6,5,3,14
DeWitt,201,"Justice, Supreme Court, Place 8",,DEM,Under Votes,3,0,0,3
DeWitt,201,"Justice, Supreme Court, Place 8",,DEM,Over Votes,0,0,0,0
DeWitt,201,"Judge, Court of Criminal Appeals, Place 3",,DEM,Dan Wood,2,0,1,3
DeWitt,201,"Judge, Court of Criminal Appeals, Place 3",,DEM,William Pieratt Demond,1,1,1,3
DeWitt,201,"Judge, Court of Criminal Appeals, Place 3",,DEM,Elizabeth Davis Frizell,3,4,1,8
DeWitt,201,Ballots Cast,,DEM,,6,5,3,14
DeWitt,201,"Judge, Court of Criminal Appeals, Place 3",,DEM,Under Votes,3,0,0,3
DeWitt,201,"Judge, Court of Criminal Appeals, Place 3",,DEM,Over Votes,0,0,0,0
DeWitt,201,"Judge, Court of Criminal Appeals, Place 4",,DEM,Steven Miears,2,1,2,5
DeWitt,201,"Judge, Court of Criminal Appeals, Place 4",,DEM,Tina Clinton,4,4,1,9
DeWitt,201,Ballots Cast,,DEM,,6,5,3,14
DeWitt,201,"Judge, Court of Criminal Appeals, Place 4",,DEM,Under Votes,3,0,0,3
DeWitt,201,"Judge, Court of Criminal Appeals, Place 4",,DEM,Over Votes,0,0,0,0
DeWitt,201,"Judge, Court of Criminal Appeals, Place 9",,DEM,Brandon Birmingham,6,5,3,14
DeWitt,201,Ballots Cast,,DEM,,6,5,3,14
DeWitt,201,"Judge, Court of Criminal Appeals, Place 9",,DEM,Under Votes,3,0,0,3
DeWitt,201,"Judge, Court of Criminal Appeals, Place 9",,DEM,Over Votes,0,0,0,0
DeWitt,201,State Senate,18,DEM,Michael Antalan,6,5,3,14
DeWitt,201,Ballots Cast,,DEM,,6,5,3,14
DeWitt,201,State Senate,18,DEM,Under Votes,3,0,0,3
DeWitt,201,State Senate,18,DEM,Over Votes,0,0,0,0
DeWitt,201,County Chairman,,DEM,Jospeh L. Sheppard,6,5,3,14
DeWitt,201,Ballots Cast,,DEM,,6,5,3,14
DeWitt,201,County Chairman,,DEM,Under Votes,3,0,0,3
DeWitt,201,County Chairman,,DEM,Over Votes,0,0,0,0
DeWitt,201,President,,REP,Zoltan G. Istvan,0,0,0,0
DeWitt,201,President,,REP,Donald J. Trump,62,18,62,142
DeWitt,201,President,,REP,Bill Weld,0,0,0,0
DeWitt,201,President,,REP,Joe Walsh,0,0,0,0
DeWitt,201,President,,REP,"Roque ""Rocky"" De La Fuente Guerra",0,0,0,0
DeWitt,201,President,,REP,Matthew John Matern,0,0,0,0
DeWitt,201,President,,REP,Bob Ely,0,0,0,0
DeWitt,201,President,,REP,Uncommitted,0,0,1,1
DeWitt,201,Ballots Cast,,REP,,62,18,63,143
DeWitt,201,President,,REP,Under Votes,0,0,1,1
DeWitt,201,President,,REP,Over Votes,0,0,0,0
DeWitt,201,U.S. Senate,,REP,Dwayne Stovall,16,2,24,42
DeWitt,201,U.S. Senate,,REP,Mark Yancey,4,0,3,7
DeWitt,201,U.S. Senate,,REP,Virgil Bierschwale,0,0,0,0
DeWitt,201,U.S. Senate,,REP,John Cornyn,37,16,30,83
DeWitt,201,U.S. Senate,,REP,John Anthony Castro,2,0,1,3
DeWitt,201,Ballots Cast,,REP,,59,18,58,135
DeWitt,201,U.S. Senate,,REP,Under Votes,3,0,6,9
DeWitt,201,U.S. Senate,,REP,Over Votes,0,0,0,0
DeWitt,201,U.S. House,34,REP,Rey Gonzalez,27,7,32,66
DeWitt,201,U.S. House,34,REP,Rod Lingsch,29,9,17,55
DeWitt,201,Ballots Cast,,REP,,56,16,49,121
DeWitt,201,U.S. House,34,REP,Under Votes,6,2,15,23
DeWitt,201,U.S. House,34,REP,Over Votes,0,0,0,0
DeWitt,201,Railroad Commissioner,,REP,Ryan Sitton,20,8,22,50
DeWitt,201,Railroad Commissioner,,REP,"James ""Jim"" Wright",33,7,30,70
DeWitt,201,Ballots Cast,,REP,,53,15,52,120
DeWitt,201,Railroad Commissioner,,REP,Under Votes,9,2,12,23
DeWitt,201,Railroad Commissioner,,REP,Over Votes,0,1,0,1
DeWitt,201,"Chief Justice, Supreme Court",,REP,Nathan Hecht,53,17,54,124
DeWitt,201,Ballots Cast,,REP,,53,17,54,124
DeWitt,201,"Chief Justice, Supreme Court",,REP,Under Votes,9,1,10,20
DeWitt,201,"Chief Justice, Supreme Court",,REP,Over Votes,0,0,0,0
DeWitt,201,"Justice, Supreme Court, Place 6 Unexpired Term",,REP,Jane Bland,54,16,52,122
DeWitt,201,Ballots Cast,,REP,,54,16,52,122
DeWitt,201,"Justice, Supreme Court, Place 6 Unexpired Term",,REP,Under Votes,8,2,12,22
DeWitt,201,"Justice, Supreme Court, Place 6 Unexpired Term",,REP,Over Votes,0,0,0,0
DeWitt,201,"Justice, Supreme Court, Place 7",,REP,Jeff Boyd,51,16,51,118
DeWitt,201,Ballots Cast,,REP,,51,16,51,118
DeWitt,201,"Justice, Supreme Court, Place 7",,REP,Under Votes,11,2,13,26
DeWitt,201,"Justice, Supreme Court, Place 7",,REP,Over Votes,0,0,0,0
DeWitt,201,"Justice, Supreme Court, Place 8",,REP,Brett Busby,50,16,51,117
DeWitt,201,Ballots Cast,,REP,,50,16,51,117
DeWitt,201,"Justice, Supreme Court, Place 8",,REP,Under Votes,12,2,13,27
DeWitt,201,"Justice, Supreme Court, Place 8",,REP,Over Votes,0,0,0,0
DeWitt,201,"Judge, Court of Criminal Appeals, Place 3",,REP,Gina Parker,24,7,29,60
DeWitt,201,"Judge, Court of Criminal Appeals, Place 3",,REP,Bert Richardson,27,6,21,54
DeWitt,201,Ballots Cast,,REP,,51,13,50,114
DeWitt,201,"Judge, Court of Criminal Appeals, Place 3",,REP,Under Votes,11,5,14,30
DeWitt,201,"Judge, Court of Criminal Appeals, Place 3",,REP,Over Votes,0,0,0,0
DeWitt,201,"Judge, Court of Criminal Appeals, Place 4",,REP,Kevin Patrick Yeary,50,16,52,118
DeWitt,201,Ballots Cast,,REP,,50,16,52,118
DeWitt,201,"Judge, Court of Criminal Appeals, Place 4",,REP,Under Votes,12,2,12,26
DeWitt,201,"Judge, Court of Criminal Appeals, Place 4",,REP,Over Votes,0,0,0,0
DeWitt,201,"Judge, Court of Criminal Appeals, Place 9",,REP,David Newell,51,16,52,119
DeWitt,201,Ballots Cast,,REP,,51,16,52,119
DeWitt,201,"Judge, Court of Criminal Appeals, Place 9",,REP,Under Votes,11,2,12,25
DeWitt,201,"Judge, Court of Criminal Appeals, Place 9",,REP,Over Votes,0,0,0,0
DeWitt,201,State Senate,18,REP,Lois W. Kolkhorst,57,16,53,126
DeWitt,201,Ballots Cast,,REP,,57,16,53,126
DeWitt,201,State Senate,18,REP,Under Votes,5,2,11,18
DeWitt,201,State Senate,18,REP,Over Votes,0,0,0,0
DeWitt,201,State Representative,30,REP,Geanie W. Morrison,51,15,51,117
DeWitt,201,State Representative,30,REP,Vanessa Hicks-Callaway,8,3,10,21
DeWitt,201,Ballots Cast,,REP,,59,18,61,138
DeWitt,201,State Representative,30,REP,Under Votes,3,0,3,6
DeWitt,201,State Representative,30,REP,Over Votes,0,0,0,0
DeWitt,201,"District Attorney, 24th Judicial District",,REP,"Robert C. ""Rob"" Lassman",52,15,56,123
DeWitt,201,Ballots Cast,,REP,,52,15,56,123
DeWitt,201,"District Attorney, 24th Judicial District",,REP,Under Votes,10,3,8,21
DeWitt,201,"District Attorney, 24th Judicial District",,REP,Over Votes,0,0,0,0
DeWitt,201,County Attorney,,REP,Jay Condie,48,18,60,126
DeWitt,201,Ballots Cast,,REP,,48,18,60,126
DeWitt,201,County Attorney,,REP,Under Votes,14,0,4,18
DeWitt,201,County Attorney,,REP,Over Votes,0,0,0,0
DeWitt,201,Sheriff,,REP,Carl R. Bowen,52,17,61,130
DeWitt,201,Ballots Cast,,REP,,52,17,61,130
DeWitt,201,Sheriff,,REP,Under Votes,10,1,3,14
DeWitt,201,Sheriff,,REP,Over Votes,0,0,0,0
DeWitt,201,County Tax Assessor-Collector,,REP,Ashley D. Mraz,48,16,55,119
DeWitt,201,County Tax Assessor-Collector,,REP,Guy Dolan,12,2,8,22
DeWitt,201,Ballots Cast,,REP,,60,18,63,141
DeWitt,201,County Tax Assessor-Collector,,REP,Under Votes,2,0,1,3
DeWitt,201,County Tax Assessor-Collector,,REP,Over Votes,0,0,0,0
DeWitt,201,"Constable, Precinct 1",,REP,Kelly J. Phelps,55,16,54,125
DeWitt,201,Ballots Cast,,REP,,55,16,54,125
DeWitt,201,"Constable, Precinct 1",,REP,Under Votes,7,2,10,19
DeWitt,201,"Constable, Precinct 1",,REP,Over Votes,0,0,0,0
DeWitt,201,County Chairman,,REP,Paul Guidry,52,18,53,123
DeWitt,201,Ballots Cast,,REP,,52,18,53,123
DeWitt,201,County Chairman,,REP,Under Votes,10,0,11,21
DeWitt,201,County Chairman,,REP,Over Votes,0,0,0,0
DeWitt,201,Proposition #1,,DEM,Yes,8,5,3,16
DeWitt,201,Proposition #1,,DEM,No,1,0,0,1
DeWitt,201,Ballots Cast,,DEM,,9,5,3,17
DeWitt,201,Proposition #1,,DEM,Under Votes,0,0,0,0
DeWitt,201,Proposition #1,,DEM,Over Votes,0,0,0,0
DeWitt,201,Proposition #2,,DEM,Yes,8,5,3,16
DeWitt,201,Proposition #2,,DEM,No,1,0,0,1
DeWitt,201,Ballots Cast,,DEM,,9,5,3,17
DeWitt,201,Proposition #2,,DEM,Under Votes,0,0,0,0
DeWitt,201,Proposition #2,,DEM,Over Votes,0,0,0,0
DeWitt,201,Proposition #3,,DEM,Yes,8,5,3,16
DeWitt,201,Proposition #3,,DEM,No,1,0,0,1
DeWitt,201,Ballots Cast,,DEM,,9,5,3,17
DeWitt,201,Proposition #3,,DEM,Under Votes,0,0,0,0
DeWitt,201,Proposition #3,,DEM,Over Votes,0,0,0,0
DeWitt,201,Proposition #4,,DEM,Yes,7,5,3,15
DeWitt,201,Proposition #4,,DEM,No,2,0,0,2
DeWitt,201,Ballots Cast,,DEM,,9,5,3,17
DeWitt,201,Proposition #4,,DEM,Under Votes,0,0,0,0
DeWitt,201,Proposition #4,,DEM,Over Votes,0,0,0,0
DeWitt,201,Proposition #5,,DEM,Yes,8,5,3,16
DeWitt,201,Proposition #5,,DEM,No,1,0,0,1
DeWitt,201,Ballots Cast,,DEM,,9,5,3,17
DeWitt,201,Proposition #5,,DEM,Under Votes,0,0,0,0
DeWitt,201,Proposition #5,,DEM,Over Votes,0,0,0,0
DeWitt,201,Proposition #6,,DEM,Yes,8,5,3,16
DeWitt,201,Proposition #6,,DEM,No,1,0,0,1
DeWitt,201,Ballots Cast,,DEM,,9,5,3,17
DeWitt,201,Proposition #6,,DEM,Under Votes,0,0,0,0
DeWitt,201,Proposition #6,,DEM,Over Votes,0,0,0,0
DeWitt,201,Proposition #7,,DEM,Yes,7,5,3,15
DeWitt,201,Proposition #7,,DEM,No,2,0,0,2
DeWitt,201,Ballots Cast,,DEM,,9,5,3,17
DeWitt,201,Proposition #7,,DEM,Under Votes,0,0,0,0
DeWitt,201,Proposition #7,,DEM,Over Votes,0,0,0,0
DeWitt,201,Proposition #8,,DEM,Yes,8,5,3,16
DeWitt,201,Proposition #8,,DEM,No,1,0,0,1
DeWitt,201,Ballots Cast,,DEM,,9,5,3,17
DeWitt,201,Proposition #8,,DEM,Under Votes,0,0,0,0
DeWitt,201,Proposition #8,,DEM,Over Votes,0,0,0,0
DeWitt,201,Proposition #9,,DEM,Yes,7,5,3,15
DeWitt,201,Proposition #9,,DEM,No,2,0,0,2
DeWitt,201,Ballots Cast,,DEM,,9,5,3,17
DeWitt,201,Proposition #9,,DEM,Under Votes,0,0,0,0
DeWitt,201,Proposition #9,,DEM,Over Votes,0,0,0,0
DeWitt,201,Proposition #10,,DEM,Yes,7,5,2,14
DeWitt,201,Proposition #10,,DEM,No,2,0,1,3
DeWitt,201,Ballots Cast,,DEM,,9,5,3,17
DeWitt,201,Proposition #10,,DEM,Under Votes,0,0,0,0
DeWitt,201,Proposition #10,,DEM,Over Votes,0,0,0,0
DeWitt,201,Proposition #11,,DEM,Yes,6,5,2,13
DeWitt,201,Proposition #11,,DEM,No,3,0,1,4
DeWitt,201,Ballots Cast,,DEM,,9,5,3,17
DeWitt,201,Proposition #11,,DEM,Under Votes,0,0,0,0
DeWitt,201,Proposition #11,,DEM,Over Votes,0,0,0,0
DeWitt,201,Proposition 1,,REP,Yes,51,17,59,127
DeWitt,201,Proposition 1,,REP,No,10,1,3,14
DeWitt,201,Ballots Cast,,REP,,61,18,62,141
DeWitt,201,Proposition 1,,REP,Under Votes,1,0,2,3
DeWitt,201,Proposition 1,,REP,Over Votes,0,0,0,0
DeWitt,201,Proposition 2,,REP,Yes,49,18,53,120
DeWitt,201,Proposition 2,,REP,No,12,0,9,21
DeWitt,201,Ballots Cast,,REP,,61,18,62,141
DeWitt,201,Proposition 2,,REP,Under Votes,1,0,2,3
DeWitt,201,Proposition 2,,REP,Over Votes,0,0,0,0
DeWitt,201,Proposition 3,,REP,Yes,54,18,52,124
DeWitt,201,Proposition 3,,REP,No,6,0,6,12
DeWitt,201,Ballots Cast,,REP,,60,18,58,136
DeWitt,201,Proposition 3,,REP,Under Votes,2,0,6,8
DeWitt,201,Proposition 3,,REP,Over Votes,0,0,0,0
DeWitt,201,Proposition 4,,REP,Yes,59,18,58,135
DeWitt,201,Proposition 4,,REP,No,2,0,2,4
DeWitt,201,Ballots Cast,,REP,,61,18,60,139
DeWitt,201,Proposition 4,,REP,Under Votes,1,0,4,5
DeWitt,201,Proposition 4,,REP,Over Votes,0,0,0,0
DeWitt,201,Proposition 5,,REP,Yes,53,17,56,126
DeWitt,201,Proposition 5,,REP,No,7,1,2,10
DeWitt,201,Ballots Cast,,REP,,60,18,58,136
DeWitt,201,Proposition 5,,REP,Under Votes,2,0,6,8
DeWitt,201,Proposition 5,,REP,Over Votes,0,0,0,0
DeWitt,201,Proposition 6,,REP,Yes,60,18,56,134
DeWitt,201,Proposition 6,,REP,No,0,0,5,5
DeWitt,201,Ballots Cast,,REP,,60,18,61,139
DeWitt,201,Proposition 6,,REP,Under Votes,2,0,3,5
DeWitt,201,Proposition 6,,REP,Over Votes,0,0,0,0
DeWitt,201,Proposition 7,,REP,Yes,60,18,61,139
DeWitt,201,Proposition 7,,REP,No,0,0,0,0
DeWitt,201,Ballots Cast,,REP,,60,18,61,139
DeWitt,201,Proposition 7,,REP,Under Votes,2,0,3,5
DeWitt,201,Proposition 7,,REP,Over Votes,0,0,0,0
DeWitt,201,Proposition 8,,REP,Yes,60,18,60,138
DeWitt,201,Proposition 8,,REP,No,1,0,0,1
DeWitt,201,Ballots Cast,,REP,,61,18,60,139
DeWitt,201,Proposition 8,,REP,Under Votes,1,0,4,5
DeWitt,201,Proposition 8,,REP,Over Votes,0,0,0,0
DeWitt,201,Proposition 9,,REP,Yes,58,18,59,135
DeWitt,201,Proposition 9,,REP,No,3,0,3,6
DeWitt,201,Ballots Cast,,REP,,61,18,62,141
DeWitt,201,Proposition 9,,REP,Under Votes,1,0,2,3
DeWitt,201,Proposition 9,,REP,Over Votes,0,0,0,0
DeWitt,201,Proposition 10,,REP,Yes,56,12,57,125
DeWitt,201,Proposition 10,,REP,No,2,6,3,11
DeWitt,201,Ballots Cast,,REP,,58,18,60,136
DeWitt,201,Proposition 10,,REP,Under Votes,4,0,4,8
DeWitt,201,Proposition 10,,REP,Over Votes,0,0,0,0
DeWitt,202,President,,DEM,Amy Klobuchar,1,0,1,2
DeWitt,202,President,,DEM,Joseph R. Biden,15,6,5,26
DeWitt,202,President,,DEM,Michael Bennet,1,0,0,1
DeWitt,202,President,,DEM,Marianne Williamson,0,0,0,0
DeWitt,202,President,,DEM,Michael R. Bloomberg,5,2,0,7
DeWitt,202,President,,DEM,Elizabeth Warren,4,0,1,5
DeWitt,202,President,,DEM,Andrew Yang,0,0,0,0
DeWitt,202,President,,DEM,Tom Steyer,2,0,0,2
DeWitt,202,President,,DEM,Pete Buttigieg,0,3,1,4
DeWitt,202,President,,DEM,Tulsi Gabbard,0,0,0,0
DeWitt,202,President,,DEM,Robby Wells,0,0,0,0
DeWitt,202,President,,DEM,Deval Patrick,0,0,0,0
DeWitt,202,President,,DEM,Bernie Sanders,4,1,3,8
DeWitt,202,President,,DEM,"Roque ""Rocky"" De La Fuente Guerra",0,0,0,0
DeWitt,202,President,,DEM,John K. Delaney,0,0,0,0
DeWitt,202,President,,DEM,Cory Booker,0,0,0,0
DeWitt,202,President,,DEM,Julián Castro,0,0,0,0
DeWitt,202,Ballots Cast,,DEM,,32,12,11,55
DeWitt,202,President,,DEM,Under Votes,0,0,0,0
DeWitt,202,President,,DEM,Over Votes,0,0,0,0
DeWitt,202,U.S. Senate,,DEM,Victor Hugo Harris,2,0,0,2
DeWitt,202,U.S. Senate,,DEM,"Annie ""Mamá"" Garcia",9,0,2,11
DeWitt,202,U.S. Senate,,DEM,Amanda K. Edwards,6,1,1,8
DeWitt,202,U.S. Senate,,DEM,Royce West,0,0,0,0
DeWitt,202,U.S. Senate,,DEM,Adrian Ocegueda,0,0,1,1
DeWitt,202,U.S. Senate,,DEM,D.R. Hunter,0,0,0,0
DeWitt,202,U.S. Senate,,DEM,Michael Cooper,1,5,0,6
DeWitt,202,U.S. Senate,,DEM,Chris Bell,1,2,0,3
DeWitt,202,U.S. Senate,,DEM,Cristina Tzintzun Ramirez,3,1,0,4
DeWitt,202,U.S. Senate,,DEM,Sema Hernandez,0,0,1,1
DeWitt,202,U.S. Senate,,DEM,Jack Daniel Foster Jr,0,0,0,0
DeWitt,202,U.S. Senate,,DEM,"Mary ""MJ"" Hegar",7,3,3,13
DeWitt,202,Ballots Cast,,DEM,,29,12,8,49
DeWitt,202,U.S. Senate,,DEM,Under Votes,3,0,3,6
DeWitt,202,U.S. Senate,,DEM,Over Votes,0,0,0,0
DeWitt,202,U.S. House,34,DEM,Diego Zavala,18,2,1,21
DeWitt,202,U.S. House,34,DEM,Osbert Haro,4,1,0,5
DeWitt,202,U.S. House,34,DEM,Filemon B. Vela,5,9,6,20
DeWitt,202,Ballots Cast,,DEM,,27,12,7,46
DeWitt,202,U.S. House,34,DEM,Under Votes,5,0,4,9
DeWitt,202,U.S. House,34,DEM,Over Votes,0,0,0,0
DeWitt,202,Railroad Commissioner,,DEM,Chrysta Castañeda,9,2,0,11
DeWitt,202,Railroad Commissioner,,DEM,Kelly Stone,8,3,4,15
DeWitt,202,Railroad Commissioner,,DEM,Mark Watson,4,4,2,10
DeWitt,202,Railroad Commissioner,,DEM,"Roberto R. ""Beto"" Alonzo",7,1,2,10
DeWitt,202,Ballots Cast,,DEM,,28,10,8,46
DeWitt,202,Railroad Commissioner,,DEM,Under Votes,4,2,3,9
DeWitt,202,Railroad Commissioner,,DEM,Over Votes,0,0,0,0
DeWitt,202,"Chief Justice, Supreme Court",,DEM,Jerry Zimmerer,7,2,2,11
DeWitt,202,"Chief Justice, Supreme Court",,DEM,Amy Clark Meachum,20,8,5,33
DeWitt,202,Ballots Cast,,DEM,,27,10,7,44
DeWitt,202,"Chief Justice, Supreme Court",,DEM,Under Votes,5,2,4,11
DeWitt,202,"Chief Justice, Supreme Court",,DEM,Over Votes,0,0,0,0
DeWitt,202,"Justice, Supreme Court, Place 6 Unexpired Term",,DEM,Larry Praeger,9,1,2,12
DeWitt,202,"Justice, Supreme Court, Place 6 Unexpired Term",,DEM,Kathy Cheng,19,9,6,34
DeWitt,202,Ballots Cast,,DEM,,28,10,8,46
DeWitt,202,"Justice, Supreme Court, Place 6 Unexpired Term",,DEM,Under Votes,4,2,3,9
DeWitt,202,"Justice, Supreme Court, Place 6 Unexpired Term",,DEM,Over Votes,0,0,0,0
DeWitt,202,"Justice, Supreme Court, Place 7",,DEM,Staci Williams,18,5,4,27
DeWitt,202,"Justice, Supreme Court, Place 7",,DEM,Brandy Voss,9,5,2,16
DeWitt,202,Ballots Cast,,DEM,,27,10,6,43
DeWitt,202,"Justice, Supreme Court, Place 7",,DEM,Under Votes,5,2,5,12
DeWitt,202,"Justice, Supreme Court, Place 7",,DEM,Over Votes,0,0,0,0
DeWitt,202,"Justice, Supreme Court, Place 8",,DEM,Peter Kelly,11,6,2,19
DeWitt,202,"Justice, Supreme Court, Place 8",,DEM,Gisela D. Triana,18,4,6,28
DeWitt,202,Ballots Cast,,DEM,,29,10,8,47
DeWitt,202,"Justice, Supreme Court, Place 8",,DEM,Under Votes,3,2,3,8
DeWitt,202,"Justice, Supreme Court, Place 8",,DEM,Over Votes,0,0,0,0
DeWitt,202,"Judge, Court of Criminal Appeals, Place 3",,DEM,Dan Wood,5,2,1,8
DeWitt,202,"Judge, Court of Criminal Appeals, Place 3",,DEM,William Pieratt Demond,2,1,0,3
DeWitt,202,"Judge, Court of Criminal Appeals, Place 3",,DEM,Elizabeth Davis Frizell,22,7,6,35
DeWitt,202,Ballots Cast,,DEM,,29,10,7,46
DeWitt,202,"Judge, Court of Criminal Appeals, Place 3",,DEM,Under Votes,3,2,4,9
DeWitt,202,"Judge, Court of Criminal Appeals, Place 3",,DEM,Over Votes,0,0,0,0
DeWitt,202,"Judge, Court of Criminal Appeals, Place 4",,DEM,Steven Miears,9,2,3,14
DeWitt,202,"Judge, Court of Criminal Appeals, Place 4",,DEM,Tina Clinton,20,8,5,33
DeWitt,202,Ballots Cast,,DEM,,29,10,8,47
DeWitt,202,"Judge, Court of Criminal Appeals, Place 4",,DEM,Under Votes,3,2,3,8
DeWitt,202,"Judge, Court of Criminal Appeals, Place 4",,DEM,Over Votes,0,0,0,0
DeWitt,202,"Judge, Court of Criminal Appeals, Place 9",,DEM,Brandon Birmingham,24,10,5,39
DeWitt,202,Ballots Cast,,DEM,,24,10,5,39
DeWitt,202,"Judge, Court of Criminal Appeals, Place 9",,DEM,Under Votes,8,2,6,16
DeWitt,202,"Judge, Court of Criminal Appeals, Place 9",,DEM,Over Votes,0,0,0,0
DeWitt,202,State Senate,18,DEM,Michael Antalan,26,10,4,40
DeWitt,202,Ballots Cast,,DEM,,26,10,4,40
DeWitt,202,State Senate,18,DEM,Under Votes,6,2,7,15
DeWitt,202,State Senate,18,DEM,Over Votes,0,0,0,0
DeWitt,202,County Chairman,,DEM,Jospeh L. Sheppard,26,9,6,41
DeWitt,202,Ballots Cast,,DEM,,26,9,6,41
DeWitt,202,County Chairman,,DEM,Under Votes,6,3,5,14
DeWitt,202,County Chairman,,DEM,Over Votes,0,0,0,0
DeWitt,202,President,,REP,Zoltan G. Istvan,0,0,0,0
DeWitt,202,President,,REP,Donald J. Trump,127,27,53,207
DeWitt,202,President,,REP,Bill Weld,1,0,0,1
DeWitt,202,President,,REP,Joe Walsh,0,0,0,0
DeWitt,202,President,,REP,"Roque ""Rocky"" De La Fuente Guerra",1,0,0,1
DeWitt,202,President,,REP,Matthew John Matern,0,0,0,0
DeWitt,202,President,,REP,Bob Ely,0,0,0,0
DeWitt,202,President,,REP,Uncommitted,2,2,1,5
DeWitt,202,Ballots Cast,,REP,,131,29,54,214
DeWitt,202,President,,REP,Under Votes,2,1,0,3
DeWitt,202,President,,REP,Over Votes,0,0,0,0
DeWitt,202,U.S. Senate,,REP,Dwayne Stovall,33,5,12,50
DeWitt,202,U.S. Senate,,REP,Mark Yancey,5,0,4,9
DeWitt,202,U.S. Senate,,REP,Virgil Bierschwale,1,0,0,1
DeWitt,202,U.S. Senate,,REP,John Cornyn,80,24,36,140
DeWitt,202,U.S. Senate,,REP,John Anthony Castro,8,1,0,9
DeWitt,202,Ballots Cast,,REP,,127,30,52,209
DeWitt,202,U.S. Senate,,REP,Under Votes,6,0,2,8
DeWitt,202,U.S. Senate,,REP,Over Votes,0,0,0,0
DeWitt,202,U.S. House,34,REP,Rey Gonzalez,65,12,30,107
DeWitt,202,U.S. House,34,REP,Rod Lingsch,48,12,16,76
DeWitt,202,Ballots Cast,,REP,,113,24,46,183
DeWitt,202,U.S. House,34,REP,Under Votes,20,6,8,34
DeWitt,202,U.S. House,34,REP,Over Votes,0,0,0,0
DeWitt,202,Railroad Commissioner,,REP,Ryan Sitton,47,9,26,82
DeWitt,202,Railroad Commissioner,,REP,"James ""Jim"" Wright",70,14,24,108
DeWitt,202,Ballots Cast,,REP,,117,23,50,190
DeWitt,202,Railroad Commissioner,,REP,Under Votes,16,7,4,27
DeWitt,202,Railroad Commissioner,,REP,Over Votes,0,0,0,0
DeWitt,202,"Chief Justice, Supreme Court",,REP,Nathan Hecht,118,25,48,191
DeWitt,202,Ballots Cast,,REP,,118,25,48,191
DeWitt,202,"Chief Justice, Supreme Court",,REP,Under Votes,15,5,6,26
DeWitt,202,"Chief Justice, Supreme Court",,REP,Over Votes,0,0,0,0
DeWitt,202,"Justice, Supreme Court, Place 6 Unexpired Term",,REP,Jane Bland,117,24,50,191
DeWitt,202,Ballots Cast,,REP,,117,24,50,191
DeWitt,202,"Justice, Supreme Court, Place 6 Unexpired Term",,REP,Under Votes,16,6,4,26
DeWitt,202,"Justice, Supreme Court, Place 6 Unexpired Term",,REP,Over Votes,0,0,0,0
DeWitt,202,"Justice, Supreme Court, Place 7",,REP,Jeff Boyd,118,23,50,191
DeWitt,202,Ballots Cast,,REP,,118,23,50,191
DeWitt,202,"Justice, Supreme Court, Place 7",,REP,Under Votes,15,7,4,26
DeWitt,202,"Justice, Supreme Court, Place 7",,REP,Over Votes,0,0,0,0
DeWitt,202,"Justice, Supreme Court, Place 8",,REP,Brett Busby,117,23,49,189
DeWitt,202,Ballots Cast,,REP,,117,23,49,189
DeWitt,202,"Justice, Supreme Court, Place 8",,REP,Under Votes,16,7,5,28
DeWitt,202,"Justice, Supreme Court, Place 8",,REP,Over Votes,0,0,0,0
DeWitt,202,"Judge, Court of Criminal Appeals, Place 3",,REP,Gina Parker,63,11,33,107
DeWitt,202,"Judge, Court of Criminal Appeals, Place 3",,REP,Bert Richardson,52,13,18,83
DeWitt,202,Ballots Cast,,REP,,115,24,51,190
DeWitt,202,"Judge, Court of Criminal Appeals, Place 3",,REP,Under Votes,18,6,3,27
DeWitt,202,"Judge, Court of Criminal Appeals, Place 3",,REP,Over Votes,0,0,0,0
DeWitt,202,"Judge, Court of Criminal Appeals, Place 4",,REP,Kevin Patrick Yeary,117,23,48,188
DeWitt,202,Ballots Cast,,REP,,117,23,48,188
DeWitt,202,"Judge, Court of Criminal Appeals, Place 4",,REP,Under Votes,16,7,6,29
DeWitt,202,"Judge, Court of Criminal Appeals, Place 4",,REP,Over Votes,0,0,0,0
DeWitt,202,"Judge, Court of Criminal Appeals, Place 9",,REP,David Newell,116,23,49,188
DeWitt,202,Ballots Cast,,REP,,116,23,49,188
DeWitt,202,"Judge, Court of Criminal Appeals, Place 9",,REP,Under Votes,17,7,5,29
DeWitt,202,"Judge, Court of Criminal Appeals, Place 9",,REP,Over Votes,0,0,0,0
DeWitt,202,State Senate,18,REP,Lois W. Kolkhorst,120,26,51,197
DeWitt,202,Ballots Cast,,REP,,120,26,51,197
DeWitt,202,State Senate,18,REP,Under Votes,13,4,3,20
DeWitt,202,State Senate,18,REP,Over Votes,0,0,0,0
DeWitt,202,State Representative,30,REP,Geanie W. Morrison,104,28,46,178
DeWitt,202,State Representative,30,REP,Vanessa Hicks-Callaway,26,1,5,32
DeWitt,202,Ballots Cast,,REP,,130,29,51,210
DeWitt,202,State Representative,30,REP,Under Votes,3,1,3,7
DeWitt,202,State Representative,30,REP,Over Votes,0,0,0,0
DeWitt,202,"District Attorney, 24th Judicial District",,REP,"Robert C. ""Rob"" Lassman",119,26,49,194
DeWitt,202,Ballots Cast,,REP,,119,26,49,194
DeWitt,202,"District Attorney, 24th Judicial District",,REP,Under Votes,14,4,5,23
DeWitt,202,"District Attorney, 24th Judicial District",,REP,Over Votes,0,0,0,0
DeWitt,202,County Attorney,,REP,Jay Condie,116,28,49,193
DeWitt,202,Ballots Cast,,REP,,116,28,49,193
DeWitt,202,County Attorney,,REP,Under Votes,17,2,5,24
DeWitt,202,County Attorney,,REP,Over Votes,0,0,0,0
DeWitt,202,Sheriff,,REP,Carl R. Bowen,124,26,49,199
DeWitt,202,Ballots Cast,,REP,,124,26,49,199
DeWitt,202,Sheriff,,REP,Under Votes,9,4,5,18
DeWitt,202,Sheriff,,REP,Over Votes,0,0,0,0
DeWitt,202,County Tax Assessor-Collector,,REP,Ashley D. Mraz,100,23,46,169
DeWitt,202,County Tax Assessor-Collector,,REP,Guy Dolan,25,5,5,35
DeWitt,202,Ballots Cast,,REP,,125,28,51,204
DeWitt,202,County Tax Assessor-Collector,,REP,Under Votes,8,1,3,12
DeWitt,202,County Tax Assessor-Collector,,REP,Over Votes,0,1,0,1
DeWitt,202,"Constable, Precinct 1",,REP,Kelly J. Phelps,114,23,49,186
DeWitt,202,Ballots Cast,,REP,,114,23,49,186
DeWitt,202,"Constable, Precinct 1",,REP,Under Votes,19,7,5,31
DeWitt,202,"Constable, Precinct 1",,REP,Over Votes,0,0,0,0
DeWitt,202,County Chairman,,REP,Paul Guidry,118,26,50,194
DeWitt,202,Ballots Cast,,REP,,118,26,50,194
DeWitt,202,County Chairman,,REP,Under Votes,15,4,4,23
DeWitt,202,County Chairman,,REP,Over Votes,0,0,0,0
DeWitt,202,Proposition #1,,DEM,Yes,32,11,8,51
DeWitt,202,Proposition #1,,DEM,No,0,1,3,4
DeWitt,202,Ballots Cast,,DEM,,32,12,11,55
DeWitt,202,Proposition #1,,DEM,Under Votes,0,0,0,0
DeWitt,202,Proposition #1,,DEM,Over Votes,0,0,0,0
DeWitt,202,Proposition #2,,DEM,Yes,31,11,8,50
DeWitt,202,Proposition #2,,DEM,No,0,1,3,4
DeWitt,202,Ballots Cast,,DEM,,31,12,11,54
DeWitt,202,Proposition #2,,DEM,Under Votes,1,0,0,1
DeWitt,202,Proposition #2,,DEM,Over Votes,0,0,0,0
DeWitt,202,Proposition #3,,DEM,Yes,32,11,9,52
DeWitt,202,Proposition #3,,DEM,No,0,1,2,3
DeWitt,202,Ballots Cast,,DEM,,32,12,11,55
DeWitt,202,Proposition #3,,DEM,Under Votes,0,0,0,0
DeWitt,202,Proposition #3,,DEM,Over Votes,0,0,0,0
DeWitt,202,Proposition #4,,DEM,Yes,29,11,8,48
DeWitt,202,Proposition #4,,DEM,No,2,1,3,6
DeWitt,202,Ballots Cast,,DEM,,31,12,11,54
DeWitt,202,Proposition #4,,DEM,Under Votes,1,0,0,1
DeWitt,202,Proposition #4,,DEM,Over Votes,0,0,0,0
DeWitt,202,Proposition #5,,DEM,Yes,31,12,8,51
DeWitt,202,Proposition #5,,DEM,No,1,0,2,3
DeWitt,202,Ballots Cast,,DEM,,32,12,10,54
DeWitt,202,Proposition #5,,DEM,Under Votes,0,0,1,1
DeWitt,202,Proposition #5,,DEM,Over Votes,0,0,0,0
DeWitt,202,Proposition #6,,DEM,Yes,31,12,9,52
DeWitt,202,Proposition #6,,DEM,No,0,0,2,2
DeWitt,202,Ballots Cast,,DEM,,31,12,11,54
DeWitt,202,Proposition #6,,DEM,Under Votes,1,0,0,1
DeWitt,202,Proposition #6,,DEM,Over Votes,0,0,0,0
DeWitt,202,Proposition #7,,DEM,Yes,27,11,8,46
DeWitt,202,Proposition #7,,DEM,No,3,1,3,7
DeWitt,202,Ballots Cast,,DEM,,30,12,11,53
DeWitt,202,Proposition #7,,DEM,Under Votes,2,0,0,2
DeWitt,202,Proposition #7,,DEM,Over Votes,0,0,0,0
DeWitt,202,Proposition #8,,DEM,Yes,31,12,7,50
DeWitt,202,Proposition #8,,DEM,No,1,0,3,4
DeWitt,202,Ballots Cast,,DEM,,32,12,10,54
DeWitt,202,Proposition #8,,DEM,Under Votes,0,0,1,1
DeWitt,202,Proposition #8,,DEM,Over Votes,0,0,0,0
DeWitt,202,Proposition #9,,DEM,Yes,30,12,8,50
DeWitt,202,Proposition #9,,DEM,No,1,0,2,3
DeWitt,202,Ballots Cast,,DEM,,31,12,10,53
DeWitt,202,Proposition #9,,DEM,Under Votes,1,0,1,2
DeWitt,202,Proposition #9,,DEM,Over Votes,0,0,0,0
DeWitt,202,Proposition #10,,DEM,Yes,28,11,9,48
DeWitt,202,Proposition #10,,DEM,No,1,1,2,4
DeWitt,202,Ballots Cast,,DEM,,29,12,11,52
DeWitt,202,Proposition #10,,DEM,Under Votes,3,0,0,3
DeWitt,202,Proposition #10,,DEM,Over Votes,0,0,0,0
DeWitt,202,Proposition #11,,DEM,Yes,27,12,9,48
DeWitt,202,Proposition #11,,DEM,No,5,0,2,7
DeWitt,202,Ballots Cast,,DEM,,32,12,11,55
DeWitt,202,Proposition #11,,DEM,Under Votes,0,0,0,0
DeWitt,202,Proposition #11,,DEM,Over Votes,0,0,0,0
DeWitt,202,Proposition 1,,REP,Yes,115,23,48,186
DeWitt,202,Proposition 1,,REP,No,15,6,6,27
DeWitt,202,Ballots Cast,,REP,,130,29,54,213
DeWitt,202,Proposition 1,,REP,Under Votes,3,1,0,4
DeWitt,202,Proposition 1,,REP,Over Votes,0,0,0,0
DeWitt,202,Proposition 2,,REP,Yes,110,25,47,182
DeWitt,202,Proposition 2,,REP,No,20,5,7,32
DeWitt,202,Ballots Cast,,REP,,130,30,54,214
DeWitt,202,Proposition 2,,REP,Under Votes,3,0,0,3
DeWitt,202,Proposition 2,,REP,Over Votes,0,0,0,0
DeWitt,202,Proposition 3,,REP,Yes,118,27,47,192
DeWitt,202,Proposition 3,,REP,No,11,1,3,15
DeWitt,202,Ballots Cast,,REP,,129,28,50,207
DeWitt,202,Proposition 3,,REP,Under Votes,4,2,4,10
DeWitt,202,Proposition 3,,REP,Over Votes,0,0,0,0
DeWitt,202,Proposition 4,,REP,Yes,123,29,53,205
DeWitt,202,Proposition 4,,REP,No,7,1,0,8
DeWitt,202,Ballots Cast,,REP,,130,30,53,213
DeWitt,202,Proposition 4,,REP,Under Votes,3,0,1,4
DeWitt,202,Proposition 4,,REP,Over Votes,0,0,0,0
DeWitt,202,Proposition 5,,REP,Yes,120,25,47,192
DeWitt,202,Proposition 5,,REP,No,9,2,4,15
DeWitt,202,Ballots Cast,,REP,,129,27,51,207
DeWitt,202,Proposition 5,,REP,Under Votes,4,3,3,10
DeWitt,202,Proposition 5,,REP,Over Votes,0,0,0,0
DeWitt,202,Proposition 6,,REP,Yes,124,27,51,202
DeWitt,202,Proposition 6,,REP,No,3,0,0,3
DeWitt,202,Ballots Cast,,REP,,127,27,51,205
DeWitt,202,Proposition 6,,REP,Under Votes,6,3,3,12
DeWitt,202,Proposition 6,,REP,Over Votes,0,0,0,0
DeWitt,202,Proposition 7,,REP,Yes,130,25,51,206
DeWitt,202,Proposition 7,,REP,No,1,0,0,1
DeWitt,202,Ballots Cast,,REP,,131,25,51,207
DeWitt,202,Proposition 7,,REP,Under Votes,2,5,3,10
DeWitt,202,Proposition 7,,REP,Over Votes,0,0,0,0
DeWitt,202,Proposition 8,,REP,Yes,128,29,51,208
DeWitt,202,Proposition 8,,REP,No,1,0,1,2
DeWitt,202,Ballots Cast,,REP,,129,29,52,210
DeWitt,202,Proposition 8,,REP,Under Votes,4,1,2,7
DeWitt,202,Proposition 8,,REP,Over Votes,0,0,0,0
DeWitt,202,Proposition 9,,REP,Yes,128,26,50,204
DeWitt,202,Proposition 9,,REP,No,3,2,1,6
DeWitt,202,Ballots Cast,,REP,,131,28,51,210
DeWitt,202,Proposition 9,,REP,Under Votes,2,2,3,7
DeWitt,202,Proposition 9,,REP,Over Votes,0,0,0,0
DeWitt,202,Proposition 10,,REP,Yes,121,26,43,190
DeWitt,202,Proposition 10,,REP,No,10,2,9,21
DeWitt,202,Ballots Cast,,REP,,131,28,52,211
DeWitt,202,Proposition 10,,REP,Under Votes,2,2,2,6
DeWitt,202,Proposition 10,,REP,Over Votes,0,0,0,0
DeWitt,203,President,,DEM,Amy Klobuchar,0,1,1,2
DeWitt,203,President,,DEM,Joseph R. Biden,8,3,0,11
DeWitt,203,President,,DEM,Michael Bennet,0,0,0,0
DeWitt,203,President,,DEM,Marianne Williamson,0,0,0,0
DeWitt,203,President,,DEM,Michael R. Bloomberg,6,1,1,8
DeWitt,203,President,,DEM,Elizabeth Warren,2,0,0,2
DeWitt,203,President,,DEM,Andrew Yang,0,0,0,0
DeWitt,203,President,,DEM,Tom Steyer,0,0,1,1
DeWitt,203,President,,DEM,Pete Buttigieg,0,3,3,6
DeWitt,203,President,,DEM,Tulsi Gabbard,0,0,0,0
DeWitt,203,President,,DEM,Robby Wells,0,0,0,0
DeWitt,203,President,,DEM,Deval Patrick,0,0,0,0
DeWitt,203,President,,DEM,Bernie Sanders,2,1,2,5
DeWitt,203,President,,DEM,"Roque ""Rocky"" De La Fuente Guerra",0,0,0,0
DeWitt,203,President,,DEM,John K. Delaney,0,0,0,0
DeWitt,203,President,,DEM,Cory Booker,0,0,0,0
DeWitt,203,President,,DEM,Julián Castro,0,0,0,0
DeWitt,203,Ballots Cast,,DEM,,18,9,8,35
DeWitt,203,President,,DEM,Under Votes,0,0,0,0
DeWitt,203,President,,DEM,Over Votes,0,0,0,0
DeWitt,203,U.S. Senate,,DEM,Victor Hugo Harris,0,0,1,1
DeWitt,203,U.S. Senate,,DEM,"Annie ""Mamá"" Garcia",5,1,1,7
DeWitt,203,U.S. Senate,,DEM,Amanda K. Edwards,2,0,1,3
DeWitt,203,U.S. Senate,,DEM,Royce West,0,0,0,0
DeWitt,203,U.S. Senate,,DEM,Adrian Ocegueda,0,0,1,1
DeWitt,203,U.S. Senate,,DEM,D.R. Hunter,1,0,0,1
DeWitt,203,U.S. Senate,,DEM,Michael Cooper,2,4,0,6
DeWitt,203,U.S. Senate,,DEM,Chris Bell,3,1,0,4
DeWitt,203,U.S. Senate,,DEM,Cristina Tzintzun Ramirez,0,0,1,1
DeWitt,203,U.S. Senate,,DEM,Sema Hernandez,0,0,0,0
DeWitt,203,U.S. Senate,,DEM,Jack Daniel Foster Jr,0,0,0,0
DeWitt,203,U.S. Senate,,DEM,"Mary ""MJ"" Hegar",3,3,3,9
DeWitt,203,Ballots Cast,,DEM,,16,9,8,33
DeWitt,203,U.S. Senate,,DEM,Under Votes,2,0,0,2
DeWitt,203,U.S. Senate,,DEM,Over Votes,0,0,0,0
DeWitt,203,U.S. House,34,DEM,Diego Zavala,5,1,1,7
DeWitt,203,U.S. House,34,DEM,Osbert Haro,3,3,1,7
DeWitt,203,U.S. House,34,DEM,Filemon B. Vela,9,5,5,19
DeWitt,203,Ballots Cast,,DEM,,17,9,7,33
DeWitt,203,U.S. House,34,DEM,Under Votes,1,0,1,2
DeWitt,203,U.S. House,34,DEM,Over Votes,0,0,0,0
DeWitt,203,Railroad Commissioner,,DEM,Chrysta Castañeda,3,1,4,8
DeWitt,203,Railroad Commissioner,,DEM,Kelly Stone,4,2,2,8
DeWitt,203,Railroad Commissioner,,DEM,Mark Watson,6,4,2,12
DeWitt,203,Railroad Commissioner,,DEM,"Roberto R. ""Beto"" Alonzo",4,2,0,6
DeWitt,203,Ballots Cast,,DEM,,17,9,8,34
DeWitt,203,Railroad Commissioner,,DEM,Under Votes,1,0,0,1
DeWitt,203,Railroad Commissioner,,DEM,Over Votes,0,0,0,0
DeWitt,203,"Chief Justice, Supreme Court",,DEM,Jerry Zimmerer,2,3,1,6
DeWitt,203,"Chief Justice, Supreme Court",,DEM,Amy Clark Meachum,15,6,7,28
DeWitt,203,Ballots Cast,,DEM,,17,9,8,34
DeWitt,203,"Chief Justice, Supreme Court",,DEM,Under Votes,1,0,0,1
DeWitt,203,"Chief Justice, Supreme Court",,DEM,Over Votes,0,0,0,0
DeWitt,203,"Justice, Supreme Court, Place 6 Unexpired Term",,DEM,Larry Praeger,7,7,2,16
DeWitt,203,"Justice, Supreme Court, Place 6 Unexpired Term",,DEM,Kathy Cheng,10,2,6,18
DeWitt,203,Ballots Cast,,DEM,,17,9,8,34
DeWitt,203,"Justice, Supreme Court, Place 6 Unexpired Term",,DEM,Under Votes,1,0,0,1
DeWitt,203,"Justice, Supreme Court, Place 6 Unexpired Term",,DEM,Over Votes,0,0,0,0
DeWitt,203,"Justice, Supreme Court, Place 7",,DEM,Staci Williams,12,7,6,25
DeWitt,203,"Justice, Supreme Court, Place 7",,DEM,Brandy Voss,4,2,2,8
DeWitt,203,Ballots Cast,,DEM,,16,9,8,33
DeWitt,203,"Justice, Supreme Court, Place 7",,DEM,Under Votes,2,0,0,2
DeWitt,203,"Justice, Supreme Court, Place 7",,DEM,Over Votes,0,0,0,0
DeWitt,203,"Justice, Supreme Court, Place 8",,DEM,Peter Kelly,5,5,2,12
DeWitt,203,"Justice, Supreme Court, Place 8",,DEM,Gisela D. Triana,11,4,6,21
DeWitt,203,Ballots Cast,,DEM,,16,9,8,33
DeWitt,203,"Justice, Supreme Court, Place 8",,DEM,Under Votes,2,0,0,2
DeWitt,203,"Justice, Supreme Court, Place 8",,DEM,Over Votes,0,0,0,0
DeWitt,203,"Judge, Court of Criminal Appeals, Place 3",,DEM,Dan Wood,4,4,2,10
DeWitt,203,"Judge, Court of Criminal Appeals, Place 3",,DEM,William Pieratt Demond,0,2,0,2
DeWitt,203,"Judge, Court of Criminal Appeals, Place 3",,DEM,Elizabeth Davis Frizell,10,3,5,18
DeWitt,203,Ballots Cast,,DEM,,14,9,7,30
DeWitt,203,"Judge, Court of Criminal Appeals, Place 3",,DEM,Under Votes,4,0,1,5
DeWitt,203,"Judge, Court of Criminal Appeals, Place 3",,DEM,Over Votes,0,0,0,0
DeWitt,203,"Judge, Court of Criminal Appeals, Place 4",,DEM,Steven Miears,4,6,2,12
DeWitt,203,"Judge, Court of Criminal Appeals, Place 4",,DEM,Tina Clinton,10,3,4,17
DeWitt,203,Ballots Cast,,DEM,,14,9,6,29
DeWitt,203,"Judge, Court of Criminal Appeals, Place 4",,DEM,Under Votes,4,0,2,6
DeWitt,203,"Judge, Court of Criminal Appeals, Place 4",,DEM,Over Votes,0,0,0,0
DeWitt,203,"Judge, Court of Criminal Appeals, Place 9",,DEM,Brandon Birmingham,13,8,7,28
DeWitt,203,Ballots Cast,,DEM,,13,8,7,28
DeWitt,203,"Judge, Court of Criminal Appeals, Place 9",,DEM,Under Votes,5,1,1,7
DeWitt,203,"Judge, Court of Criminal Appeals, Place 9",,DEM,Over Votes,0,0,0,0
DeWitt,203,State Senate,18,DEM,Michael Antalan,13,8,8,29
DeWitt,203,Ballots Cast,,DEM,,13,8,8,29
DeWitt,203,State Senate,18,DEM,Under Votes,5,1,0,6
DeWitt,203,State Senate,18,DEM,Over Votes,0,0,0,0
DeWitt,203,County Chairman,,DEM,Jospeh L. Sheppard,12,9,7,28
DeWitt,203,Ballots Cast,,DEM,,12,9,7,28
DeWitt,203,County Chairman,,DEM,Under Votes,6,0,1,7
DeWitt,203,County Chairman,,DEM,Over Votes,0,0,0,0
DeWitt,203,President,,REP,Zoltan G. Istvan,0,0,0,0
DeWitt,203,President,,REP,Donald J. Trump,118,24,61,203
DeWitt,203,President,,REP,Bill Weld,0,0,0,0
DeWitt,203,President,,REP,Joe Walsh,1,0,0,1
DeWitt,203,President,,REP,"Roque ""Rocky"" De La Fuente Guerra",0,0,0,0
DeWitt,203,President,,REP,Matthew John Matern,0,0,0,0
DeWitt,203,President,,REP,Bob Ely,0,0,0,0
DeWitt,203,President,,REP,Uncommitted,1,2,1,4
DeWitt,203,Ballots Cast,,REP,,120,26,62,208
DeWitt,203,President,,REP,Under Votes,1,1,0,2
DeWitt,203,President,,REP,Over Votes,0,0,0,0
DeWitt,203,U.S. Senate,,REP,Dwayne Stovall,31,4,10,45
DeWitt,203,U.S. Senate,,REP,Mark Yancey,6,0,3,9
DeWitt,203,U.S. Senate,,REP,Virgil Bierschwale,1,0,0,1
DeWitt,203,U.S. Senate,,REP,John Cornyn,65,21,42,128
DeWitt,203,U.S. Senate,,REP,John Anthony Castro,5,0,0,5
DeWitt,203,Ballots Cast,,REP,,108,25,55,188
DeWitt,203,U.S. Senate,,REP,Under Votes,13,2,7,22
DeWitt,203,U.S. Senate,,REP,Over Votes,0,0,0,0
DeWitt,203,U.S. House,34,REP,Rey Gonzalez,48,3,20,71
DeWitt,203,U.S. House,34,REP,Rod Lingsch,46,18,34,98
DeWitt,203,Ballots Cast,,REP,,94,21,54,169
DeWitt,203,U.S. House,34,REP,Under Votes,27,6,8,41
DeWitt,203,U.S. House,34,REP,Over Votes,0,0,0,0
DeWitt,203,Railroad Commissioner,,REP,Ryan Sitton,38,7,20,65
DeWitt,203,Railroad Commissioner,,REP,"James ""Jim"" Wright",60,16,35,111
DeWitt,203,Ballots Cast,,REP,,98,23,55,176
DeWitt,203,Railroad Commissioner,,REP,Under Votes,23,4,7,34
DeWitt,203,Railroad Commissioner,,REP,Over Votes,0,0,0,0
DeWitt,203,"Chief Justice, Supreme Court",,REP,Nathan Hecht,98,18,53,169
DeWitt,203,Ballots Cast,,REP,,98,18,53,169
DeWitt,203,"Chief Justice, Supreme Court",,REP,Under Votes,23,9,9,41
DeWitt,203,"Chief Justice, Supreme Court",,REP,Over Votes,0,0,0,0
DeWitt,203,"Justice, Supreme Court, Place 6 Unexpired Term",,REP,Jane Bland,99,20,53,172
DeWitt,203,Ballots Cast,,REP,,99,20,53,172
DeWitt,203,"Justice, Supreme Court, Place 6 Unexpired Term",,REP,Under Votes,22,7,9,38
DeWitt,203,"Justice, Supreme Court, Place 6 Unexpired Term",,REP,Over Votes,0,0,0,0
DeWitt,203,"Justice, Supreme Court, Place 7",,REP,Jeff Boyd,99,20,52,171
DeWitt,203,Ballots Cast,,REP,,99,20,52,171
DeWitt,203,"Justice, Supreme Court, Place 7",,REP,Under Votes,22,7,10,39
DeWitt,203,"Justice, Supreme Court, Place 7",,REP,Over Votes,0,0,0,0
DeWitt,203,"Justice, Supreme Court, Place 8",,REP,Brett Busby,97,20,53,170
DeWitt,203,Ballots Cast,,REP,,97,20,53,170
DeWitt,203,"Justice, Supreme Court, Place 8",,REP,Under Votes,24,7,9,40
DeWitt,203,"Justice, Supreme Court, Place 8",,REP,Over Votes,0,0,0,0
DeWitt,203,"Judge, Court of Criminal Appeals, Place 3",,REP,Gina Parker,57,14,29,100
DeWitt,203,"Judge, Court of Criminal Appeals, Place 3",,REP,Bert Richardson,37,10,24,71
DeWitt,203,Ballots Cast,,REP,,94,24,53,171
DeWitt,203,"Judge, Court of Criminal Appeals, Place 3",,REP,Under Votes,27,3,9,39
DeWitt,203,"Judge, Court of Criminal Appeals, Place 3",,REP,Over Votes,0,0,0,0
DeWitt,203,"Judge, Court of Criminal Appeals, Place 4",,REP,Kevin Patrick Yeary,93,19,54,166
DeWitt,203,Ballots Cast,,REP,,93,19,54,166
DeWitt,203,"Judge, Court of Criminal Appeals, Place 4",,REP,Under Votes,28,8,8,44
DeWitt,203,"Judge, Court of Criminal Appeals, Place 4",,REP,Over Votes,0,0,0,0
DeWitt,203,"Judge, Court of Criminal Appeals, Place 9",,REP,David Newell,93,20,52,165
DeWitt,203,Ballots Cast,,REP,,93,20,52,165
DeWitt,203,"Judge, Court of Criminal Appeals, Place 9",,REP,Under Votes,28,7,10,45
DeWitt,203,"Judge, Court of Criminal Appeals, Place 9",,REP,Over Votes,0,0,0,0
DeWitt,203,State Senate,18,REP,Lois W. Kolkhorst,103,19,58,180
DeWitt,203,Ballots Cast,,REP,,103,19,58,180
DeWitt,203,State Senate,18,REP,Under Votes,18,8,4,30
DeWitt,203,State Senate,18,REP,Over Votes,0,0,0,0
DeWitt,203,State Representative,30,REP,Geanie W. Morrison,88,24,54,166
DeWitt,203,State Representative,30,REP,Vanessa Hicks-Callaway,22,3,4,29
DeWitt,203,Ballots Cast,,REP,,110,27,58,195
DeWitt,203,State Representative,30,REP,Under Votes,11,0,4,15
DeWitt,203,State Representative,30,REP,Over Votes,0,0,0,0
DeWitt,203,"District Attorney, 24th Judicial District",,REP,"Robert C. ""Rob"" Lassman",97,18,59,174
DeWitt,203,Ballots Cast,,REP,,97,18,59,174
DeWitt,203,"District Attorney, 24th Judicial District",,REP,Under Votes,24,9,3,36
DeWitt,203,"District Attorney, 24th Judicial District",,REP,Over Votes,0,0,0,0
DeWitt,203,County Attorney,,REP,Jay Condie,99,18,57,174
DeWitt,203,Ballots Cast,,REP,,99,18,57,174
DeWitt,203,County Attorney,,REP,Under Votes,22,9,5,36
DeWitt,203,County Attorney,,REP,Over Votes,0,0,0,0
DeWitt,203,Sheriff,,REP,Carl R. Bowen,101,18,58,177
DeWitt,203,Ballots Cast,,REP,,101,18,58,177
DeWitt,203,Sheriff,,REP,Under Votes,20,9,4,33
DeWitt,203,Sheriff,,REP,Over Votes,0,0,0,0
DeWitt,203,County Tax Assessor-Collector,,REP,Ashley D. Mraz,83,19,47,149
DeWitt,203,County Tax Assessor-Collector,,REP,Guy Dolan,28,5,10,43
DeWitt,203,Ballots Cast,,REP,,111,24,57,192
DeWitt,203,County Tax Assessor-Collector,,REP,Under Votes,10,3,5,18
DeWitt,203,County Tax Assessor-Collector,,REP,Over Votes,0,0,0,0
DeWitt,203,"Constable, Precinct 1",,REP,Kelly J. Phelps,97,18,55,170
DeWitt,203,Ballots Cast,,REP,,97,18,55,170
DeWitt,203,"Constable, Precinct 1",,REP,Under Votes,24,9,7,40
DeWitt,203,"Constable, Precinct 1",,REP,Over Votes,0,0,0,0
DeWitt,203,County Chairman,,REP,Paul Guidry,98,18,53,169
DeWitt,203,Ballots Cast,,REP,,98,18,53,169
DeWitt,203,County Chairman,,REP,Under Votes,23,9,9,41
DeWitt,203,County Chairman,,REP,Over Votes,0,0,0,0
DeWitt,203,Proposition #1,,DEM,Yes,15,7,6,28
DeWitt,203,Proposition #1,,DEM,No,2,1,1,4
DeWitt,203,Ballots Cast,,DEM,,17,8,7,32
DeWitt,203,Proposition #1,,DEM,Under Votes,1,0,1,2
DeWitt,203,Proposition #1,,DEM,Over Votes,0,1,0,1
DeWitt,203,Proposition #2,,DEM,Yes,13,9,6,28
DeWitt,203,Proposition #2,,DEM,No,2,0,1,3
DeWitt,203,Ballots Cast,,DEM,,15,9,7,31
DeWitt,203,Proposition #2,,DEM,Under Votes,3,0,1,4
DeWitt,203,Proposition #2,,DEM,Over Votes,0,0,0,0
DeWitt,203,Proposition #3,,DEM,Yes,14,9,6,29
DeWitt,203,Proposition #3,,DEM,No,1,0,1,2
DeWitt,203,Ballots Cast,,DEM,,15,9,7,31
DeWitt,203,Proposition #3,,DEM,Under Votes,3,0,1,4
DeWitt,203,Proposition #3,,DEM,Over Votes,0,0,0,0
DeWitt,203,Proposition #4,,DEM,Yes,12,8,6,26
DeWitt,203,Proposition #4,,DEM,No,2,0,1,3
DeWitt,203,Ballots Cast,,DEM,,14,8,7,29
DeWitt,203,Proposition #4,,DEM,Under Votes,4,0,1,5
DeWitt,203,Proposition #4,,DEM,Over Votes,0,1,0,1
DeWitt,203,Proposition #5,,DEM,Yes,12,9,6,27
DeWitt,203,Proposition #5,,DEM,No,1,0,1,2
DeWitt,203,Ballots Cast,,DEM,,13,9,7,29
DeWitt,203,Proposition #5,,DEM,Under Votes,5,0,1,6
DeWitt,203,Proposition #5,,DEM,Over Votes,0,0,0,0
DeWitt,203,Proposition #6,,DEM,Yes,14,9,6,29
DeWitt,203,Proposition #6,,DEM,No,1,0,1,2
DeWitt,203,Ballots Cast,,DEM,,15,9,7,31
DeWitt,203,Proposition #6,,DEM,Under Votes,3,0,1,4
DeWitt,203,Proposition #6,,DEM,Over Votes,0,0,0,0
DeWitt,203,Proposition #7,,DEM,Yes,13,9,6,28
DeWitt,203,Proposition #7,,DEM,No,2,0,1,3
DeWitt,203,Ballots Cast,,DEM,,15,9,7,31
DeWitt,203,Proposition #7,,DEM,Under Votes,3,0,1,4
DeWitt,203,Proposition #7,,DEM,Over Votes,0,0,0,0
DeWitt,203,Proposition #8,,DEM,Yes,14,9,7,30
DeWitt,203,Proposition #8,,DEM,No,1,0,0,1
DeWitt,203,Ballots Cast,,DEM,,15,9,7,31
DeWitt,203,Proposition #8,,DEM,Under Votes,3,0,1,4
DeWitt,203,Proposition #8,,DEM,Over Votes,0,0,0,0
DeWitt,203,Proposition #9,,DEM,Yes,14,9,6,29
DeWitt,203,Proposition #9,,DEM,No,1,0,1,2
DeWitt,203,Ballots Cast,,DEM,,15,9,7,31
DeWitt,203,Proposition #9,,DEM,Under Votes,3,0,1,4
DeWitt,203,Proposition #9,,DEM,Over Votes,0,0,0,0
DeWitt,203,Proposition #10,,DEM,Yes,13,8,7,28
DeWitt,203,Proposition #10,,DEM,No,2,0,0,2
DeWitt,203,Ballots Cast,,DEM,,15,8,7,30
DeWitt,203,Proposition #10,,DEM,Under Votes,3,0,1,4
DeWitt,203,Proposition #10,,DEM,Over Votes,0,1,0,1
DeWitt,203,Proposition #11,,DEM,Yes,13,7,6,26
DeWitt,203,Proposition #11,,DEM,No,2,2,1,5
DeWitt,203,Ballots Cast,,DEM,,15,9,7,31
DeWitt,203,Proposition #11,,DEM,Under Votes,3,0,1,4
DeWitt,203,Proposition #11,,DEM,Over Votes,0,0,0,0
DeWitt,203,Proposition 1,,REP,Yes,106,25,54,185
DeWitt,203,Proposition 1,,REP,No,12,2,7,21
DeWitt,203,Ballots Cast,,REP,,118,27,61,206
DeWitt,203,Proposition 1,,REP,Under Votes,3,0,1,4
DeWitt,203,Proposition 1,,REP,Over Votes,0,0,0,0
DeWitt,203,Proposition 2,,REP,Yes,107,23,54,184
DeWitt,203,Proposition 2,,REP,No,13,3,8,24
DeWitt,203,Ballots Cast,,REP,,120,26,62,208
DeWitt,203,Proposition 2,,REP,Under Votes,1,1,0,2
DeWitt,203,Proposition 2,,REP,Over Votes,0,0,0,0
DeWitt,203,Proposition 3,,REP,Yes,107,27,55,189
DeWitt,203,Proposition 3,,REP,No,8,0,2,10
DeWitt,203,Ballots Cast,,REP,,115,27,57,199
DeWitt,203,Proposition 3,,REP,Under Votes,6,0,5,11
DeWitt,203,Proposition 3,,REP,Over Votes,0,0,0,0
DeWitt,203,Proposition 4,,REP,Yes,113,26,55,194
DeWitt,203,Proposition 4,,REP,No,3,0,2,5
DeWitt,203,Ballots Cast,,REP,,116,26,57,199
DeWitt,203,Proposition 4,,REP,Under Votes,5,1,5,11
DeWitt,203,Proposition 4,,REP,Over Votes,0,0,0,0
DeWitt,203,Proposition 5,,REP,Yes,111,23,57,191
DeWitt,203,Proposition 5,,REP,No,7,2,4,13
DeWitt,203,Ballots Cast,,REP,,118,25,61,204
DeWitt,203,Proposition 5,,REP,Under Votes,3,2,1,6
DeWitt,203,Proposition 5,,REP,Over Votes,0,0,0,0
DeWitt,203,Proposition 6,,REP,Yes,112,26,54,192
DeWitt,203,Proposition 6,,REP,No,4,1,3,8
DeWitt,203,Ballots Cast,,REP,,116,27,57,200
DeWitt,203,Proposition 6,,REP,Under Votes,5,0,5,10
DeWitt,203,Proposition 6,,REP,Over Votes,0,0,0,0
DeWitt,203,Proposition 7,,REP,Yes,110,26,60,196
DeWitt,203,Proposition 7,,REP,No,3,0,0,3
DeWitt,203,Ballots Cast,,REP,,113,26,60,199
DeWitt,203,Proposition 7,,REP,Under Votes,8,1,2,11
DeWitt,203,Proposition 7,,REP,Over Votes,0,0,0,0
DeWitt,203,Proposition 8,,REP,Yes,116,27,60,203
DeWitt,203,Proposition 8,,REP,No,1,0,1,2
DeWitt,203,Ballots Cast,,REP,,117,27,61,205
DeWitt,203,Proposition 8,,REP,Under Votes,4,0,1,5
DeWitt,203,Proposition 8,,REP,Over Votes,0,0,0,0
DeWitt,203,Proposition 9,,REP,Yes,114,27,54,195
DeWitt,203,Proposition 9,,REP,No,5,0,2,7
DeWitt,203,Ballots Cast,,REP,,119,27,56,202
DeWitt,203,Proposition 9,,REP,Under Votes,2,0,6,8
DeWitt,203,Proposition 9,,REP,Over Votes,0,0,0,0
DeWitt,203,Proposition 10,,REP,Yes,102,19,49,170
DeWitt,203,Proposition 10,,REP,No,7,6,7,20
DeWitt,203,Ballots Cast,,REP,,109,25,56,190
DeWitt,203,Proposition 10,,REP,Under Votes,12,2,6,20
DeWitt,203,Proposition 10,,REP,Over Votes,0,0,0,0
DeWitt,301,President,,DEM,Amy Klobuchar,0,1,1,2
DeWitt,301,President,,DEM,Joseph R. Biden,11,6,4,21
DeWitt,301,President,,DEM,Michael Bennet,0,0,0,0
DeWitt,301,President,,DEM,Marianne Williamson,0,0,0,0
DeWitt,301,President,,DEM,Michael R. Bloomberg,3,4,2,9
DeWitt,301,President,,DEM,Elizabeth Warren,2,0,0,2
DeWitt,301,President,,DEM,Andrew Yang,0,0,0,0
DeWitt,301,President,,DEM,Tom Steyer,0,0,0,0
DeWitt,301,President,,DEM,Pete Buttigieg,0,2,0,2
DeWitt,301,President,,DEM,Tulsi Gabbard,0,0,0,0
DeWitt,301,President,,DEM,Robby Wells,0,0,0,0
DeWitt,301,President,,DEM,Deval Patrick,0,0,0,0
DeWitt,301,President,,DEM,Bernie Sanders,6,2,3,11
DeWitt,301,President,,DEM,"Roque ""Rocky"" De La Fuente Guerra",0,0,0,0
DeWitt,301,President,,DEM,John K. Delaney,0,0,0,0
DeWitt,301,President,,DEM,Cory Booker,0,0,0,0
DeWitt,301,President,,DEM,Julián Castro,0,1,0,1
DeWitt,301,Ballots Cast,,DEM,,22,16,10,48
DeWitt,301,President,,DEM,Under Votes,0,0,0,0
DeWitt,301,President,,DEM,Over Votes,0,0,0,0
DeWitt,301,U.S. Senate,,DEM,Victor Hugo Harris,2,0,0,2
DeWitt,301,U.S. Senate,,DEM,"Annie ""Mamá"" Garcia",3,1,0,4
DeWitt,301,U.S. Senate,,DEM,Amanda K. Edwards,2,2,1,5
DeWitt,301,U.S. Senate,,DEM,Royce West,2,1,0,3
DeWitt,301,U.S. Senate,,DEM,Adrian Ocegueda,1,1,1,3
DeWitt,301,U.S. Senate,,DEM,D.R. Hunter,1,0,0,1
DeWitt,301,U.S. Senate,,DEM,Michael Cooper,0,1,0,1
DeWitt,301,U.S. Senate,,DEM,Chris Bell,2,0,2,4
DeWitt,301,U.S. Senate,,DEM,Cristina Tzintzun Ramirez,1,3,2,6
DeWitt,301,U.S. Senate,,DEM,Sema Hernandez,1,1,0,2
DeWitt,301,U.S. Senate,,DEM,Jack Daniel Foster Jr,0,1,0,1
DeWitt,301,U.S. Senate,,DEM,"Mary ""MJ"" Hegar",5,3,4,12
DeWitt,301,Ballots Cast,,DEM,,20,14,10,44
DeWitt,301,U.S. Senate,,DEM,Under Votes,2,2,0,4
DeWitt,301,U.S. Senate,,DEM,Over Votes,0,0,0,0
DeWitt,301,U.S. House,34,DEM,Diego Zavala,7,2,1,10
DeWitt,301,U.S. House,34,DEM,Osbert Haro,3,2,1,6
DeWitt,301,U.S. House,34,DEM,Filemon B. Vela,11,10,8,29
DeWitt,301,Ballots Cast,,DEM,,21,14,10,45
DeWitt,301,U.S. House,34,DEM,Under Votes,1,2,0,3
DeWitt,301,U.S. House,34,DEM,Over Votes,0,0,0,0
DeWitt,301,Railroad Commissioner,,DEM,Chrysta Castañeda,5,4,1,10
DeWitt,301,Railroad Commissioner,,DEM,Kelly Stone,5,2,3,10
DeWitt,301,Railroad Commissioner,,DEM,Mark Watson,8,4,3,15
DeWitt,301,Railroad Commissioner,,DEM,"Roberto R. ""Beto"" Alonzo",3,2,3,8
DeWitt,301,Ballots Cast,,DEM,,21,12,10,43
DeWitt,301,Railroad Commissioner,,DEM,Under Votes,1,4,0,5
DeWitt,301,Railroad Commissioner,,DEM,Over Votes,0,0,0,0
DeWitt,301,"Chief Justice, Supreme Court",,DEM,Jerry Zimmerer,4,3,2,9
DeWitt,301,"Chief Justice, Supreme Court",,DEM,Amy Clark Meachum,16,9,8,33
DeWitt,301,Ballots Cast,,DEM,,20,12,10,42
DeWitt,301,"Chief Justice, Supreme Court",,DEM,Under Votes,2,4,0,6
DeWitt,301,"Chief Justice, Supreme Court",,DEM,Over Votes,0,0,0,0
DeWitt,301,"Justice, Supreme Court, Place 6 Unexpired Term",,DEM,Larry Praeger,8,2,1,11
DeWitt,301,"Justice, Supreme Court, Place 6 Unexpired Term",,DEM,Kathy Cheng,13,9,9,31
DeWitt,301,Ballots Cast,,DEM,,21,11,10,42
DeWitt,301,"Justice, Supreme Court, Place 6 Unexpired Term",,DEM,Under Votes,1,5,0,6
DeWitt,301,"Justice, Supreme Court, Place 6 Unexpired Term",,DEM,Over Votes,0,0,0,0
DeWitt,301,"Justice, Supreme Court, Place 7",,DEM,Staci Williams,14,5,7,26
DeWitt,301,"Justice, Supreme Court, Place 7",,DEM,Brandy Voss,8,7,3,18
DeWitt,301,Ballots Cast,,DEM,,22,12,10,44
DeWitt,301,"Justice, Supreme Court, Place 7",,DEM,Under Votes,0,4,0,4
DeWitt,301,"Justice, Supreme Court, Place 7",,DEM,Over Votes,0,0,0,0
DeWitt,301,"Justice, Supreme Court, Place 8",,DEM,Peter Kelly,9,4,5,18
DeWitt,301,"Justice, Supreme Court, Place 8",,DEM,Gisela D. Triana,12,8,4,24
DeWitt,301,Ballots Cast,,DEM,,21,12,9,42
DeWitt,301,"Justice, Supreme Court, Place 8",,DEM,Under Votes,1,4,1,6
DeWitt,301,"Justice, Supreme Court, Place 8",,DEM,Over Votes,0,0,0,0
DeWitt,301,"Judge, Court of Criminal Appeals, Place 3",,DEM,Dan Wood,7,1,1,9
DeWitt,301,"Judge, Court of Criminal Appeals, Place 3",,DEM,William Pieratt Demond,1,0,0,1
DeWitt,301,"Judge, Court of Criminal Appeals, Place 3",,DEM,Elizabeth Davis Frizell,14,11,8,33
DeWitt,301,Ballots Cast,,DEM,,22,12,9,43
DeWitt,301,"Judge, Court of Criminal Appeals, Place 3",,DEM,Under Votes,0,4,1,5
DeWitt,301,"Judge, Court of Criminal Appeals, Place 3",,DEM,Over Votes,0,0,0,0
DeWitt,301,"Judge, Court of Criminal Appeals, Place 4",,DEM,Steven Miears,4,1,1,6
DeWitt,301,"Judge, Court of Criminal Appeals, Place 4",,DEM,Tina Clinton,17,11,9,37
DeWitt,301,Ballots Cast,,DEM,,21,12,10,43
DeWitt,301,"Judge, Court of Criminal Appeals, Place 4",,DEM,Under Votes,1,4,0,5
DeWitt,301,"Judge, Court of Criminal Appeals, Place 4",,DEM,Over Votes,0,0,0,0
DeWitt,301,"Judge, Court of Criminal Appeals, Place 9",,DEM,Brandon Birmingham,20,10,9,39
DeWitt,301,Ballots Cast,,DEM,,20,10,9,39
DeWitt,301,"Judge, Court of Criminal Appeals, Place 9",,DEM,Under Votes,2,6,1,9
DeWitt,301,"Judge, Court of Criminal Appeals, Place 9",,DEM,Over Votes,0,0,0,0
DeWitt,301,State Senate,18,DEM,Michael Antalan,19,10,9,38
DeWitt,301,Ballots Cast,,DEM,,19,10,9,38
DeWitt,301,State Senate,18,DEM,Under Votes,3,6,1,10
DeWitt,301,State Senate,18,DEM,Over Votes,0,0,0,0
DeWitt,301,County Chairman,,DEM,Jospeh L. Sheppard,20,11,9,40
DeWitt,301,Ballots Cast,,DEM,,20,11,9,40
DeWitt,301,County Chairman,,DEM,Under Votes,2,5,1,8
DeWitt,301,County Chairman,,DEM,Over Votes,0,0,0,0
DeWitt,301,President,,REP,Zoltan G. Istvan,0,0,0,0
DeWitt,301,President,,REP,Donald J. Trump,215,57,62,334
DeWitt,301,President,,REP,Bill Weld,0,0,0,0
DeWitt,301,President,,REP,Joe Walsh,1,0,0,1
DeWitt,301,President,,REP,"Roque ""Rocky"" De La Fuente Guerra",0,0,0,0
DeWitt,301,President,,REP,Matthew John Matern,0,1,0,1
DeWitt,301,President,,REP,Bob Ely,0,0,0,0
DeWitt,301,President,,REP,Uncommitted,4,3,0,7
DeWitt,301,Ballots Cast,,REP,,220,61,62,343
DeWitt,301,President,,REP,Under Votes,2,0,1,3
DeWitt,301,President,,REP,Over Votes,0,1,0,1
DeWitt,301,U.S. Senate,,REP,Dwayne Stovall,27,3,14,44
DeWitt,301,U.S. Senate,,REP,Mark Yancey,15,1,2,18
DeWitt,301,U.S. Senate,,REP,Virgil Bierschwale,1,0,1,2
DeWitt,301,U.S. Senate,,REP,John Cornyn,155,55,42,252
DeWitt,301,U.S. Senate,,REP,John Anthony Castro,9,0,1,10
DeWitt,301,Ballots Cast,,REP,,207,59,60,326
DeWitt,301,U.S. Senate,,REP,Under Votes,15,2,3,20
DeWitt,301,U.S. Senate,,REP,Over Votes,0,1,0,1
DeWitt,301,U.S. House,34,REP,Rey Gonzalez,111,25,28,164
DeWitt,301,U.S. House,34,REP,Rod Lingsch,84,25,30,139
DeWitt,301,Ballots Cast,,REP,,195,50,58,303
DeWitt,301,U.S. House,34,REP,Under Votes,27,12,5,44
DeWitt,301,U.S. House,34,REP,Over Votes,0,0,0,0
DeWitt,301,Railroad Commissioner,,REP,Ryan Sitton,85,27,26,138
DeWitt,301,Railroad Commissioner,,REP,"James ""Jim"" Wright",114,27,29,170
DeWitt,301,Ballots Cast,,REP,,199,54,55,308
DeWitt,301,Railroad Commissioner,,REP,Under Votes,23,8,8,39
DeWitt,301,Railroad Commissioner,,REP,Over Votes,0,0,0,0
DeWitt,301,"Chief Justice, Supreme Court",,REP,Nathan Hecht,192,46,53,291
DeWitt,301,Ballots Cast,,REP,,192,46,53,291
DeWitt,301,"Chief Justice, Supreme Court",,REP,Under Votes,30,16,10,56
DeWitt,301,"Chief Justice, Supreme Court",,REP,Over Votes,0,0,0,0
DeWitt,301,"Justice, Supreme Court, Place 6 Unexpired Term",,REP,Jane Bland,190,44,52,286
DeWitt,301,Ballots Cast,,REP,,190,44,52,286
DeWitt,301,"Justice, Supreme Court, Place 6 Unexpired Term",,REP,Under Votes,32,18,11,61
DeWitt,301,"Justice, Supreme Court, Place 6 Unexpired Term",,REP,Over Votes,0,0,0,0
DeWitt,301,"Justice, Supreme Court, Place 7",,REP,Jeff Boyd,189,44,53,286
DeWitt,301,Ballots Cast,,REP,,189,44,53,286
DeWitt,301,"Justice, Supreme Court, Place 7",,REP,Under Votes,33,18,10,61
DeWitt,301,"Justice, Supreme Court, Place 7",,REP,Over Votes,0,0,0,0
DeWitt,301,"Justice, Supreme Court, Place 8",,REP,Brett Busby,193,44,54,291
DeWitt,301,Ballots Cast,,REP,,193,44,54,291
DeWitt,301,"Justice, Supreme Court, Place 8",,REP,Under Votes,29,18,9,56
DeWitt,301,"Justice, Supreme Court, Place 8",,REP,Over Votes,0,0,0,0
DeWitt,301,"Judge, Court of Criminal Appeals, Place 3",,REP,Gina Parker,105,19,28,152
DeWitt,301,"Judge, Court of Criminal Appeals, Place 3",,REP,Bert Richardson,90,25,29,144
DeWitt,301,Ballots Cast,,REP,,195,44,57,296
DeWitt,301,"Judge, Court of Criminal Appeals, Place 3",,REP,Under Votes,27,18,6,51
DeWitt,301,"Judge, Court of Criminal Appeals, Place 3",,REP,Over Votes,0,0,0,0
DeWitt,301,"Judge, Court of Criminal Appeals, Place 4",,REP,Kevin Patrick Yeary,194,45,57,296
DeWitt,301,Ballots Cast,,REP,,194,45,57,296
DeWitt,301,"Judge, Court of Criminal Appeals, Place 4",,REP,Under Votes,28,17,6,51
DeWitt,301,"Judge, Court of Criminal Appeals, Place 4",,REP,Over Votes,0,0,0,0
DeWitt,301,"Judge, Court of Criminal Appeals, Place 9",,REP,David Newell,191,45,53,289
DeWitt,301,Ballots Cast,,REP,,191,45,53,289
DeWitt,301,"Judge, Court of Criminal Appeals, Place 9",,REP,Under Votes,31,17,10,58
DeWitt,301,"Judge, Court of Criminal Appeals, Place 9",,REP,Over Votes,0,0,0,0
DeWitt,301,State Senate,18,REP,Lois W. Kolkhorst,194,48,56,298
DeWitt,301,Ballots Cast,,REP,,194,48,56,298
DeWitt,301,State Senate,18,REP,Under Votes,28,14,7,49
DeWitt,301,State Senate,18,REP,Over Votes,0,0,0,0
DeWitt,301,State Representative,30,REP,Geanie W. Morrison,174,58,48,280
DeWitt,301,State Representative,30,REP,Vanessa Hicks-Callaway,40,2,13,55
DeWitt,301,Ballots Cast,,REP,,214,60,61,335
DeWitt,301,State Representative,30,REP,Under Votes,8,2,2,12
DeWitt,301,State Representative,30,REP,Over Votes,0,0,0,0
DeWitt,301,"District Attorney, 24th Judicial District",,REP,"Robert C. ""Rob"" Lassman",194,48,57,299
DeWitt,301,Ballots Cast,,REP,,194,48,57,299
DeWitt,301,"District Attorney, 24th Judicial District",,REP,Under Votes,28,14,6,48
DeWitt,301,"District Attorney, 24th Judicial District",,REP,Over Votes,0,0,0,0
DeWitt,301,County Attorney,,REP,Jay Condie,193,47,57,297
DeWitt,301,Ballots Cast,,REP,,193,47,57,297
DeWitt,301,County Attorney,,REP,Under Votes,29,15,6,50
DeWitt,301,County Attorney,,REP,Over Votes,0,0,0,0
DeWitt,301,Sheriff,,REP,Carl R. Bowen,195,53,59,307
DeWitt,301,Ballots Cast,,REP,,195,53,59,307
DeWitt,301,Sheriff,,REP,Under Votes,27,9,4,40
DeWitt,301,Sheriff,,REP,Over Votes,0,0,0,0
DeWitt,301,County Tax Assessor-Collector,,REP,Ashley D. Mraz,162,47,48,257
DeWitt,301,County Tax Assessor-Collector,,REP,Guy Dolan,52,8,15,75
DeWitt,301,Ballots Cast,,REP,,214,55,63,332
DeWitt,301,County Tax Assessor-Collector,,REP,Under Votes,8,6,0,14
DeWitt,301,County Tax Assessor-Collector,,REP,Over Votes,0,1,0,1
DeWitt,301,"County Commissioner, Precinct 3",,REP,James Kaiser,202,51,57,310
DeWitt,301,Ballots Cast,,REP,,202,51,57,310
DeWitt,301,"County Commissioner, Precinct 3",,REP,Under Votes,20,11,6,37
DeWitt,301,"County Commissioner, Precinct 3",,REP,Over Votes,0,0,0,0
DeWitt,301,"Constable, Precinct 2",,REP,Jefferson Hobbs,116,32,37,185
DeWitt,301,"Constable, Precinct 2",,REP,Jeff Abbott,95,21,26,142
DeWitt,301,Ballots Cast,,REP,,211,53,63,327
DeWitt,301,"Constable, Precinct 2",,REP,Under Votes,11,9,0,20
DeWitt,301,"Constable, Precinct 2",,REP,Over Votes,0,0,0,0
DeWitt,301,County Chairman,,REP,Paul Guidry,188,48,54,290
DeWitt,301,Ballots Cast,,REP,,188,48,54,290
DeWitt,301,County Chairman,,REP,Under Votes,34,14,9,57
DeWitt,301,County Chairman,,REP,Over Votes,0,0,0,0
DeWitt,301,Proposition #1,,DEM,Yes,17,14,10,41
DeWitt,301,Proposition #1,,DEM,No,2,0,0,2
DeWitt,301,Ballots Cast,,DEM,,19,14,10,43
DeWitt,301,Proposition #1,,DEM,Under Votes,3,2,0,5
DeWitt,301,Proposition #1,,DEM,Over Votes,0,0,0,0
DeWitt,301,Proposition #2,,DEM,Yes,19,13,10,42
DeWitt,301,Proposition #2,,DEM,No,2,2,0,4
DeWitt,301,Ballots Cast,,DEM,,21,15,10,46
DeWitt,301,Proposition #2,,DEM,Under Votes,1,1,0,2
DeWitt,301,Proposition #2,,DEM,Over Votes,0,0,0,0
DeWitt,301,Proposition #3,,DEM,Yes,21,14,10,45
DeWitt,301,Proposition #3,,DEM,No,1,0,0,1
DeWitt,301,Ballots Cast,,DEM,,22,14,10,46
DeWitt,301,Proposition #3,,DEM,Under Votes,0,2,0,2
DeWitt,301,Proposition #3,,DEM,Over Votes,0,0,0,0
DeWitt,301,Proposition #4,,DEM,Yes,20,14,10,44
DeWitt,301,Proposition #4,,DEM,No,1,0,0,1
DeWitt,301,Ballots Cast,,DEM,,21,14,10,45
DeWitt,301,Proposition #4,,DEM,Under Votes,1,2,0,3
DeWitt,301,Proposition #4,,DEM,Over Votes,0,0,0,0
DeWitt,301,Proposition #5,,DEM,Yes,20,14,10,44
DeWitt,301,Proposition #5,,DEM,No,1,0,0,1
DeWitt,301,Ballots Cast,,DEM,,21,14,10,45
DeWitt,301,Proposition #5,,DEM,Under Votes,1,2,0,3
DeWitt,301,Proposition #5,,DEM,Over Votes,0,0,0,0
DeWitt,301,Proposition #6,,DEM,Yes,21,14,10,45
DeWitt,301,Proposition #6,,DEM,No,1,0,0,1
DeWitt,301,Ballots Cast,,DEM,,22,14,10,46
DeWitt,301,Proposition #6,,DEM,Under Votes,0,2,0,2
DeWitt,301,Proposition #6,,DEM,Over Votes,0,0,0,0
DeWitt,301,Proposition #7,,DEM,Yes,20,14,10,44
DeWitt,301,Proposition #7,,DEM,No,1,1,0,2
DeWitt,301,Ballots Cast,,DEM,,21,15,10,46
DeWitt,301,Proposition #7,,DEM,Under Votes,1,1,0,2
DeWitt,301,Proposition #7,,DEM,Over Votes,0,0,0,0
DeWitt,301,Proposition #8,,DEM,Yes,20,14,10,44
DeWitt,301,Proposition #8,,DEM,No,1,0,0,1
DeWitt,301,Ballots Cast,,DEM,,21,14,10,45
DeWitt,301,Proposition #8,,DEM,Under Votes,1,2,0,3
DeWitt,301,Proposition #8,,DEM,Over Votes,0,0,0,0
DeWitt,301,Proposition #9,,DEM,Yes,19,14,10,43
DeWitt,301,Proposition #9,,DEM,No,1,0,0,1
DeWitt,301,Ballots Cast,,DEM,,20,14,10,44
DeWitt,301,Proposition #9,,DEM,Under Votes,2,2,0,4
DeWitt,301,Proposition #9,,DEM,Over Votes,0,0,0,0
DeWitt,301,Proposition #10,,DEM,Yes,19,14,10,43
DeWitt,301,Proposition #10,,DEM,No,1,0,0,1
DeWitt,301,Ballots Cast,,DEM,,20,14,10,44
DeWitt,301,Proposition #10,,DEM,Under Votes,2,2,0,4
DeWitt,301,Proposition #10,,DEM,Over Votes,0,0,0,0
DeWitt,301,Proposition #11,,DEM,Yes,20,14,9,43
DeWitt,301,Proposition #11,,DEM,No,1,0,1,2
DeWitt,301,Ballots Cast,,DEM,,21,14,10,45
DeWitt,301,Proposition #11,,DEM,Under Votes,1,2,0,3
DeWitt,301,Proposition #11,,DEM,Over Votes,0,0,0,0
DeWitt,301,Proposition 1,,REP,Yes,193,57,52,302
DeWitt,301,Proposition 1,,REP,No,23,4,9,36
DeWitt,301,Ballots Cast,,REP,,216,61,61,338
DeWitt,301,Proposition 1,,REP,Under Votes,6,1,2,9
DeWitt,301,Proposition 1,,REP,Over Votes,0,0,0,0
DeWitt,301,Proposition 2,,REP,Yes,192,53,49,294
DeWitt,301,Proposition 2,,REP,No,25,8,12,45
DeWitt,301,Ballots Cast,,REP,,217,61,61,339
DeWitt,301,Proposition 2,,REP,Under Votes,5,1,2,8
DeWitt,301,Proposition 2,,REP,Over Votes,0,0,0,0
DeWitt,301,Proposition 3,,REP,Yes,197,55,53,305
DeWitt,301,Proposition 3,,REP,No,13,5,8,26
DeWitt,301,Ballots Cast,,REP,,210,60,61,331
DeWitt,301,Proposition 3,,REP,Under Votes,12,2,2,16
DeWitt,301,Proposition 3,,REP,Over Votes,0,0,0,0
DeWitt,301,Proposition 4,,REP,Yes,204,55,58,317
DeWitt,301,Proposition 4,,REP,No,10,2,3,15
DeWitt,301,Ballots Cast,,REP,,214,57,61,332
DeWitt,301,Proposition 4,,REP,Under Votes,8,5,2,15
DeWitt,301,Proposition 4,,REP,Over Votes,0,0,0,0
DeWitt,301,Proposition 5,,REP,Yes,189,54,51,294
DeWitt,301,Proposition 5,,REP,No,18,4,8,30
DeWitt,301,Ballots Cast,,REP,,207,58,59,324
DeWitt,301,Proposition 5,,REP,Under Votes,15,4,4,23
DeWitt,301,Proposition 5,,REP,Over Votes,0,0,0,0
DeWitt,301,Proposition 6,,REP,Yes,203,57,53,313
DeWitt,301,Proposition 6,,REP,No,5,2,8,15
DeWitt,301,Ballots Cast,,REP,,208,59,61,328
DeWitt,301,Proposition 6,,REP,Under Votes,14,3,2,19
DeWitt,301,Proposition 6,,REP,Over Votes,0,0,0,0
DeWitt,301,Proposition 7,,REP,Yes,212,56,61,329
DeWitt,301,Proposition 7,,REP,No,3,2,2,7
DeWitt,301,Ballots Cast,,REP,,215,58,63,336
DeWitt,301,Proposition 7,,REP,Under Votes,7,4,0,11
DeWitt,301,Proposition 7,,REP,Over Votes,0,0,0,0
DeWitt,301,Proposition 8,,REP,Yes,211,59,60,330
DeWitt,301,Proposition 8,,REP,No,3,0,1,4
DeWitt,301,Ballots Cast,,REP,,214,59,61,334
DeWitt,301,Proposition 8,,REP,Under Votes,8,3,2,13
DeWitt,301,Proposition 8,,REP,Over Votes,0,0,0,0
DeWitt,301,Proposition 9,,REP,Yes,204,60,59,323
DeWitt,301,Proposition 9,,REP,No,9,1,1,11
DeWitt,301,Ballots Cast,,REP,,213,61,60,334
DeWitt,301,Proposition 9,,REP,Under Votes,9,1,3,13
DeWitt,301,Proposition 9,,REP,Over Votes,0,0,0,0
DeWitt,301,Proposition 10,,REP,Yes,193,50,56,299
DeWitt,301,Proposition 10,,REP,No,19,8,4,31
DeWitt,301,Ballots Cast,,REP,,212,58,60,330
DeWitt,301,Proposition 10,,REP,Under Votes,10,4,3,17
DeWitt,301,Proposition 10,,REP,Over Votes,0,0,0,0
DeWitt,302,President,,DEM,Amy Klobuchar,1,0,0,1
DeWitt,302,President,,DEM,Joseph R. Biden,13,6,1,20
DeWitt,302,President,,DEM,Michael Bennet,1,0,0,1
DeWitt,302,President,,DEM,Marianne Williamson,0,0,0,0
DeWitt,302,President,,DEM,Michael R. Bloomberg,10,4,2,16
DeWitt,302,President,,DEM,Elizabeth Warren,1,0,1,2
DeWitt,302,President,,DEM,Andrew Yang,0,0,0,0
DeWitt,302,President,,DEM,Tom Steyer,0,0,0,0
DeWitt,302,President,,DEM,Pete Buttigieg,0,0,0,0
DeWitt,302,President,,DEM,Tulsi Gabbard,0,0,0,0
DeWitt,302,President,,DEM,Robby Wells,0,0,0,0
DeWitt,302,President,,DEM,Deval Patrick,0,0,0,0
DeWitt,302,President,,DEM,Bernie Sanders,3,0,2,5
DeWitt,302,President,,DEM,"Roque ""Rocky"" De La Fuente Guerra",0,0,0,0
DeWitt,302,President,,DEM,John K. Delaney,0,0,0,0
DeWitt,302,President,,DEM,Cory Booker,0,0,0,0
DeWitt,302,President,,DEM,Julián Castro,0,1,0,1
DeWitt,302,Ballots Cast,,DEM,,29,11,6,46
DeWitt,302,President,,DEM,Under Votes,0,1,0,1
DeWitt,302,President,,DEM,Over Votes,0,0,0,0
DeWitt,302,U.S. Senate,,DEM,Victor Hugo Harris,4,0,0,4
DeWitt,302,U.S. Senate,,DEM,"Annie ""Mamá"" Garcia",5,3,3,11
DeWitt,302,U.S. Senate,,DEM,Amanda K. Edwards,3,1,0,4
DeWitt,302,U.S. Senate,,DEM,Royce West,0,0,0,0
DeWitt,302,U.S. Senate,,DEM,Adrian Ocegueda,2,1,0,3
DeWitt,302,U.S. Senate,,DEM,D.R. Hunter,3,0,0,3
DeWitt,302,U.S. Senate,,DEM,Michael Cooper,4,0,0,4
DeWitt,302,U.S. Senate,,DEM,Chris Bell,2,2,1,5
DeWitt,302,U.S. Senate,,DEM,Cristina Tzintzun Ramirez,2,0,0,2
DeWitt,302,U.S. Senate,,DEM,Sema Hernandez,0,1,2,3
DeWitt,302,U.S. Senate,,DEM,Jack Daniel Foster Jr,0,1,0,1
DeWitt,302,U.S. Senate,,DEM,"Mary ""MJ"" Hegar",2,2,0,4
DeWitt,302,Ballots Cast,,DEM,,27,11,6,44
DeWitt,302,U.S. Senate,,DEM,Under Votes,2,1,0,3
DeWitt,302,U.S. Senate,,DEM,Over Votes,0,0,0,0
DeWitt,302,U.S. House,34,DEM,Diego Zavala,8,2,1,11
DeWitt,302,U.S. House,34,DEM,Osbert Haro,1,0,0,1
DeWitt,302,U.S. House,34,DEM,Filemon B. Vela,16,8,4,28
DeWitt,302,Ballots Cast,,DEM,,25,10,5,40
DeWitt,302,U.S. House,34,DEM,Under Votes,4,2,1,7
DeWitt,302,U.S. House,34,DEM,Over Votes,0,0,0,0
DeWitt,302,Railroad Commissioner,,DEM,Chrysta Castañeda,8,0,3,11
DeWitt,302,Railroad Commissioner,,DEM,Kelly Stone,3,2,0,5
DeWitt,302,Railroad Commissioner,,DEM,Mark Watson,5,2,0,7
DeWitt,302,Railroad Commissioner,,DEM,"Roberto R. ""Beto"" Alonzo",8,7,1,16
DeWitt,302,Ballots Cast,,DEM,,24,11,4,39
DeWitt,302,Railroad Commissioner,,DEM,Under Votes,5,1,2,8
DeWitt,302,Railroad Commissioner,,DEM,Over Votes,0,0,0,0
DeWitt,302,"Chief Justice, Supreme Court",,DEM,Jerry Zimmerer,12,4,0,16
DeWitt,302,"Chief Justice, Supreme Court",,DEM,Amy Clark Meachum,14,5,4,23
DeWitt,302,Ballots Cast,,DEM,,26,9,4,39
DeWitt,302,"Chief Justice, Supreme Court",,DEM,Under Votes,3,3,2,8
DeWitt,302,"Chief Justice, Supreme Court",,DEM,Over Votes,0,0,0,0
DeWitt,302,"Justice, Supreme Court, Place 6 Unexpired Term",,DEM,Larry Praeger,10,5,0,15
DeWitt,302,"Justice, Supreme Court, Place 6 Unexpired Term",,DEM,Kathy Cheng,15,5,5,25
DeWitt,302,Ballots Cast,,DEM,,25,10,5,40
DeWitt,302,"Justice, Supreme Court, Place 6 Unexpired Term",,DEM,Under Votes,4,2,1,7
DeWitt,302,"Justice, Supreme Court, Place 6 Unexpired Term",,DEM,Over Votes,0,0,0,0
DeWitt,302,"Justice, Supreme Court, Place 7",,DEM,Staci Williams,21,7,3,31
DeWitt,302,"Justice, Supreme Court, Place 7",,DEM,Brandy Voss,4,3,2,9
DeWitt,302,Ballots Cast,,DEM,,25,10,5,40
DeWitt,302,"Justice, Supreme Court, Place 7",,DEM,Under Votes,4,2,1,7
DeWitt,302,"Justice, Supreme Court, Place 7",,DEM,Over Votes,0,0,0,0
DeWitt,302,"Justice, Supreme Court, Place 8",,DEM,Peter Kelly,12,9,1,22
DeWitt,302,"Justice, Supreme Court, Place 8",,DEM,Gisela D. Triana,14,2,4,20
DeWitt,302,Ballots Cast,,DEM,,26,11,5,42
DeWitt,302,"Justice, Supreme Court, Place 8",,DEM,Under Votes,3,1,1,5
DeWitt,302,"Justice, Supreme Court, Place 8",,DEM,Over Votes,0,0,0,0
DeWitt,302,"Judge, Court of Criminal Appeals, Place 3",,DEM,Dan Wood,8,7,0,15
DeWitt,302,"Judge, Court of Criminal Appeals, Place 3",,DEM,William Pieratt Demond,4,1,0,5
DeWitt,302,"Judge, Court of Criminal Appeals, Place 3",,DEM,Elizabeth Davis Frizell,13,2,5,20
DeWitt,302,Ballots Cast,,DEM,,25,10,5,40
DeWitt,302,"Judge, Court of Criminal Appeals, Place 3",,DEM,Under Votes,4,2,1,7
DeWitt,302,"Judge, Court of Criminal Appeals, Place 3",,DEM,Over Votes,0,0,0,0
DeWitt,302,"Judge, Court of Criminal Appeals, Place 4",,DEM,Steven Miears,6,9,0,15
DeWitt,302,"Judge, Court of Criminal Appeals, Place 4",,DEM,Tina Clinton,18,2,5,25
DeWitt,302,Ballots Cast,,DEM,,24,11,5,40
DeWitt,302,"Judge, Court of Criminal Appeals, Place 4",,DEM,Under Votes,5,1,1,7
DeWitt,302,"Judge, Court of Criminal Appeals, Place 4",,DEM,Over Votes,0,0,0,0
DeWitt,302,"Judge, Court of Criminal Appeals, Place 9",,DEM,Brandon Birmingham,24,10,4,38
DeWitt,302,Ballots Cast,,DEM,,24,10,4,38
DeWitt,302,"Judge, Court of Criminal Appeals, Place 9",,DEM,Under Votes,5,2,2,9
DeWitt,302,"Judge, Court of Criminal Appeals, Place 9",,DEM,Over Votes,0,0,0,0
DeWitt,302,State Senate,18,DEM,Michael Antalan,23,9,4,36
DeWitt,302,Ballots Cast,,DEM,,23,9,4,36
DeWitt,302,State Senate,18,DEM,Under Votes,6,3,2,11
DeWitt,302,State Senate,18,DEM,Over Votes,0,0,0,0
DeWitt,302,County Chairman,,DEM,Jospeh L. Sheppard,26,9,4,39
DeWitt,302,Ballots Cast,,DEM,,26,9,4,39
DeWitt,302,County Chairman,,DEM,Under Votes,3,3,2,8
DeWitt,302,County Chairman,,DEM,Over Votes,0,0,0,0
DeWitt,302,President,,REP,Zoltan G. Istvan,0,0,0,0
DeWitt,302,President,,REP,Donald J. Trump,149,37,79,265
DeWitt,302,President,,REP,Bill Weld,0,0,0,0
DeWitt,302,President,,REP,Joe Walsh,2,0,0,2
DeWitt,302,President,,REP,"Roque ""Rocky"" De La Fuente Guerra",0,0,1,1
DeWitt,302,President,,REP,Matthew John Matern,0,0,0,0
DeWitt,302,President,,REP,Bob Ely,0,0,0,0
DeWitt,302,President,,REP,Uncommitted,5,1,4,10
DeWitt,302,Ballots Cast,,REP,,156,38,84,278
DeWitt,302,President,,REP,Under Votes,2,0,2,4
DeWitt,302,President,,REP,Over Votes,0,0,0,0
DeWitt,302,U.S. Senate,,REP,Dwayne Stovall,34,9,15,58
DeWitt,302,U.S. Senate,,REP,Mark Yancey,6,1,7,14
DeWitt,302,U.S. Senate,,REP,Virgil Bierschwale,2,0,1,3
DeWitt,302,U.S. Senate,,REP,John Cornyn,96,25,50,171
DeWitt,302,U.S. Senate,,REP,John Anthony Castro,9,1,2,12
DeWitt,302,Ballots Cast,,REP,,147,36,75,258
DeWitt,302,U.S. Senate,,REP,Under Votes,11,2,11,24
DeWitt,302,U.S. Senate,,REP,Over Votes,0,0,0,0
DeWitt,302,U.S. House,34,REP,Rey Gonzalez,84,20,38,142
DeWitt,302,U.S. House,34,REP,Rod Lingsch,56,11,32,99
DeWitt,302,Ballots Cast,,REP,,140,31,70,241
DeWitt,302,U.S. House,34,REP,Under Votes,18,6,16,40
DeWitt,302,U.S. House,34,REP,Over Votes,0,1,0,1
DeWitt,302,Railroad Commissioner,,REP,Ryan Sitton,57,13,22,92
DeWitt,302,Railroad Commissioner,,REP,"James ""Jim"" Wright",89,20,52,161
DeWitt,302,Ballots Cast,,REP,,146,33,74,253
DeWitt,302,Railroad Commissioner,,REP,Under Votes,12,5,12,29
DeWitt,302,Railroad Commissioner,,REP,Over Votes,0,0,0,0
DeWitt,302,"Chief Justice, Supreme Court",,REP,Nathan Hecht,140,33,70,243
DeWitt,302,Ballots Cast,,REP,,140,33,70,243
DeWitt,302,"Chief Justice, Supreme Court",,REP,Under Votes,18,5,16,39
DeWitt,302,"Chief Justice, Supreme Court",,REP,Over Votes,0,0,0,0
DeWitt,302,"Justice, Supreme Court, Place 6 Unexpired Term",,REP,Jane Bland,146,33,72,251
DeWitt,302,Ballots Cast,,REP,,146,33,72,251
DeWitt,302,"Justice, Supreme Court, Place 6 Unexpired Term",,REP,Under Votes,12,5,14,31
DeWitt,302,"Justice, Supreme Court, Place 6 Unexpired Term",,REP,Over Votes,0,0,0,0
DeWitt,302,"Justice, Supreme Court, Place 7",,REP,Jeff Boyd,142,33,72,247
DeWitt,302,Ballots Cast,,REP,,142,33,72,247
DeWitt,302,"Justice, Supreme Court, Place 7",,REP,Under Votes,16,5,14,35
DeWitt,302,"Justice, Supreme Court, Place 7",,REP,Over Votes,0,0,0,0
DeWitt,302,"Justice, Supreme Court, Place 8",,REP,Brett Busby,145,33,73,251
DeWitt,302,Ballots Cast,,REP,,145,33,73,251
DeWitt,302,"Justice, Supreme Court, Place 8",,REP,Under Votes,13,5,13,31
DeWitt,302,"Justice, Supreme Court, Place 8",,REP,Over Votes,0,0,0,0
DeWitt,302,"Judge, Court of Criminal Appeals, Place 3",,REP,Gina Parker,78,19,45,142
DeWitt,302,"Judge, Court of Criminal Appeals, Place 3",,REP,Bert Richardson,56,12,28,96
DeWitt,302,Ballots Cast,,REP,,134,31,73,238
DeWitt,302,"Judge, Court of Criminal Appeals, Place 3",,REP,Under Votes,24,7,13,44
DeWitt,302,"Judge, Court of Criminal Appeals, Place 3",,REP,Over Votes,0,0,0,0
DeWitt,302,"Judge, Court of Criminal Appeals, Place 4",,REP,Kevin Patrick Yeary,141,33,72,246
DeWitt,302,Ballots Cast,,REP,,141,33,72,246
DeWitt,302,"Judge, Court of Criminal Appeals, Place 4",,REP,Under Votes,17,5,14,36
DeWitt,302,"Judge, Court of Criminal Appeals, Place 4",,REP,Over Votes,0,0,0,0
DeWitt,302,"Judge, Court of Criminal Appeals, Place 9",,REP,David Newell,141,33,72,246
DeWitt,302,Ballots Cast,,REP,,141,33,72,246
DeWitt,302,"Judge, Court of Criminal Appeals, Place 9",,REP,Under Votes,17,5,14,36
DeWitt,302,"Judge, Court of Criminal Appeals, Place 9",,REP,Over Votes,0,0,0,0
DeWitt,302,State Senate,18,REP,Lois W. Kolkhorst,145,33,77,255
DeWitt,302,Ballots Cast,,REP,,145,33,77,255
DeWitt,302,State Senate,18,REP,Under Votes,13,5,9,27
DeWitt,302,State Senate,18,REP,Over Votes,0,0,0,0
DeWitt,302,State Representative,30,REP,Geanie W. Morrison,108,36,68,212
DeWitt,302,State Representative,30,REP,Vanessa Hicks-Callaway,39,1,12,52
DeWitt,302,Ballots Cast,,REP,,147,37,80,264
DeWitt,302,State Representative,30,REP,Under Votes,11,1,6,18
DeWitt,302,State Representative,30,REP,Over Votes,0,0,0,0
DeWitt,302,"District Attorney, 24th Judicial District",,REP,"Robert C. ""Rob"" Lassman",145,33,73,251
DeWitt,302,Ballots Cast,,REP,,145,33,73,251
DeWitt,302,"District Attorney, 24th Judicial District",,REP,Under Votes,13,5,13,31
DeWitt,302,"District Attorney, 24th Judicial District",,REP,Over Votes,0,0,0,0
DeWitt,302,County Attorney,,REP,Jay Condie,143,33,77,253
DeWitt,302,Ballots Cast,,REP,,143,33,77,253
DeWitt,302,County Attorney,,REP,Under Votes,15,5,9,29
DeWitt,302,County Attorney,,REP,Over Votes,0,0,0,0
DeWitt,302,Sheriff,,REP,Carl R. Bowen,147,34,77,258
DeWitt,302,Ballots Cast,,REP,,147,34,77,258
DeWitt,302,Sheriff,,REP,Under Votes,11,4,9,24
DeWitt,302,Sheriff,,REP,Over Votes,0,0,0,0
DeWitt,302,County Tax Assessor-Collector,,REP,Ashley D. Mraz,114,31,69,214
DeWitt,302,County Tax Assessor-Collector,,REP,Guy Dolan,36,4,14,54
DeWitt,302,Ballots Cast,,REP,,150,35,83,268
DeWitt,302,County Tax Assessor-Collector,,REP,Under Votes,8,3,3,14
DeWitt,302,County Tax Assessor-Collector,,REP,Over Votes,0,0,0,0
DeWitt,302,"County Commissioner, Precinct 3",,REP,James Kaiser,145,35,73,253
DeWitt,302,Ballots Cast,,REP,,145,35,73,253
DeWitt,302,"County Commissioner, Precinct 3",,REP,Under Votes,13,3,13,29
DeWitt,302,"County Commissioner, Precinct 3",,REP,Over Votes,0,0,0,0
DeWitt,302,"Constable, Precinct 2",,REP,Jefferson Hobbs,85,18,63,166
DeWitt,302,"Constable, Precinct 2",,REP,Jeff Abbott,64,16,17,97
DeWitt,302,Ballots Cast,,REP,,149,34,80,263
DeWitt,302,"Constable, Precinct 2",,REP,Under Votes,9,4,6,19
DeWitt,302,"Constable, Precinct 2",,REP,Over Votes,0,0,0,0
DeWitt,302,County Chairman,,REP,Paul Guidry,142,34,76,252
DeWitt,302,Ballots Cast,,REP,,142,34,76,252
DeWitt,302,County Chairman,,REP,Under Votes,16,4,10,30
DeWitt,302,County Chairman,,REP,Over Votes,0,0,0,0
DeWitt,302,Proposition #1,,DEM,Yes,27,9,5,41
DeWitt,302,Proposition #1,,DEM,No,1,3,0,4
DeWitt,302,Ballots Cast,,DEM,,28,12,5,45
DeWitt,302,Proposition #1,,DEM,Under Votes,1,0,1,2
DeWitt,302,Proposition #1,,DEM,Over Votes,0,0,0,0
DeWitt,302,Proposition #2,,DEM,Yes,27,8,5,40
DeWitt,302,Proposition #2,,DEM,No,0,3,0,3
DeWitt,302,Ballots Cast,,DEM,,27,11,5,43
DeWitt,302,Proposition #2,,DEM,Under Votes,2,1,1,4
DeWitt,302,Proposition #2,,DEM,Over Votes,0,0,0,0
DeWitt,302,Proposition #3,,DEM,Yes,28,11,5,44
DeWitt,302,Proposition #3,,DEM,No,0,0,0,0
DeWitt,302,Ballots Cast,,DEM,,28,11,5,44
DeWitt,302,Proposition #3,,DEM,Under Votes,1,1,1,3
DeWitt,302,Proposition #3,,DEM,Over Votes,0,0,0,0
DeWitt,302,Proposition #4,,DEM,Yes,28,10,5,43
DeWitt,302,Proposition #4,,DEM,No,1,1,0,2
DeWitt,302,Ballots Cast,,DEM,,29,11,5,45
DeWitt,302,Proposition #4,,DEM,Under Votes,0,1,1,2
DeWitt,302,Proposition #4,,DEM,Over Votes,0,0,0,0
DeWitt,302,Proposition #5,,DEM,Yes,28,11,5,44
DeWitt,302,Proposition #5,,DEM,No,0,0,0,0
DeWitt,302,Ballots Cast,,DEM,,28,11,5,44
DeWitt,302,Proposition #5,,DEM,Under Votes,1,1,1,3
DeWitt,302,Proposition #5,,DEM,Over Votes,0,0,0,0
DeWitt,302,Proposition #6,,DEM,Yes,28,10,5,43
DeWitt,302,Proposition #6,,DEM,No,0,1,0,1
DeWitt,302,Ballots Cast,,DEM,,28,11,5,44
DeWitt,302,Proposition #6,,DEM,Under Votes,1,1,1,3
DeWitt,302,Proposition #6,,DEM,Over Votes,0,0,0,0
DeWitt,302,Proposition #7,,DEM,Yes,25,11,5,41
DeWitt,302,Proposition #7,,DEM,No,2,0,0,2
DeWitt,302,Ballots Cast,,DEM,,27,11,5,43
DeWitt,302,Proposition #7,,DEM,Under Votes,2,1,1,4
DeWitt,302,Proposition #7,,DEM,Over Votes,0,0,0,0
DeWitt,302,Proposition #8,,DEM,Yes,28,10,5,43
DeWitt,302,Proposition #8,,DEM,No,0,1,0,1
DeWitt,302,Ballots Cast,,DEM,,28,11,5,44
DeWitt,302,Proposition #8,,DEM,Under Votes,1,1,1,3
DeWitt,302,Proposition #8,,DEM,Over Votes,0,0,0,0
DeWitt,302,Proposition #9,,DEM,Yes,28,9,5,42
DeWitt,302,Proposition #9,,DEM,No,0,2,0,2
DeWitt,302,Ballots Cast,,DEM,,28,11,5,44
DeWitt,302,Proposition #9,,DEM,Under Votes,1,1,1,3
DeWitt,302,Proposition #9,,DEM,Over Votes,0,0,0,0
DeWitt,302,Proposition #10,,DEM,Yes,26,9,5,40
DeWitt,302,Proposition #10,,DEM,No,2,2,0,4
DeWitt,302,Ballots Cast,,DEM,,28,11,5,44
DeWitt,302,Proposition #10,,DEM,Under Votes,1,1,1,3
DeWitt,302,Proposition #10,,DEM,Over Votes,0,0,0,0
DeWitt,302,Proposition #11,,DEM,Yes,25,8,5,38
DeWitt,302,Proposition #11,,DEM,No,2,3,0,5
DeWitt,302,Ballots Cast,,DEM,,27,11,5,43
DeWitt,302,Proposition #11,,DEM,Under Votes,2,1,1,4
DeWitt,302,Proposition #11,,DEM,Over Votes,0,0,0,0
DeWitt,302,Proposition 1,,REP,Yes,140,35,69,244
DeWitt,302,Proposition 1,,REP,No,13,2,13,28
DeWitt,302,Ballots Cast,,REP,,153,37,82,272
DeWitt,302,Proposition 1,,REP,Under Votes,5,1,4,10
DeWitt,302,Proposition 1,,REP,Over Votes,0,0,0,0
DeWitt,302,Proposition 2,,REP,Yes,134,34,69,237
DeWitt,302,Proposition 2,,REP,No,20,3,11,34
DeWitt,302,Ballots Cast,,REP,,154,37,80,271
DeWitt,302,Proposition 2,,REP,Under Votes,4,1,6,11
DeWitt,302,Proposition 2,,REP,Over Votes,0,0,0,0
DeWitt,302,Proposition 3,,REP,Yes,143,36,72,251
DeWitt,302,Proposition 3,,REP,No,9,0,9,18
DeWitt,302,Ballots Cast,,REP,,152,36,81,269
DeWitt,302,Proposition 3,,REP,Under Votes,6,1,5,12
DeWitt,302,Proposition 3,,REP,Over Votes,0,1,0,1
DeWitt,302,Proposition 4,,REP,Yes,148,35,78,261
DeWitt,302,Proposition 4,,REP,No,8,2,2,12
DeWitt,302,Ballots Cast,,REP,,156,37,80,273
DeWitt,302,Proposition 4,,REP,Under Votes,2,1,6,9
DeWitt,302,Proposition 4,,REP,Over Votes,0,0,0,0
DeWitt,302,Proposition 5,,REP,Yes,137,33,75,245
DeWitt,302,Proposition 5,,REP,No,13,4,5,22
DeWitt,302,Ballots Cast,,REP,,150,37,80,267
DeWitt,302,Proposition 5,,REP,Under Votes,8,1,6,15
DeWitt,302,Proposition 5,,REP,Over Votes,0,0,0,0
DeWitt,302,Proposition 6,,REP,Yes,141,33,77,251
DeWitt,302,Proposition 6,,REP,No,9,4,3,16
DeWitt,302,Ballots Cast,,REP,,150,37,80,267
DeWitt,302,Proposition 6,,REP,Under Votes,8,1,6,15
DeWitt,302,Proposition 6,,REP,Over Votes,0,0,0,0
DeWitt,302,Proposition 7,,REP,Yes,151,37,79,267
DeWitt,302,Proposition 7,,REP,No,2,0,3,5
DeWitt,302,Ballots Cast,,REP,,153,37,82,272
DeWitt,302,Proposition 7,,REP,Under Votes,5,1,4,10
DeWitt,302,Proposition 7,,REP,Over Votes,0,0,0,0
DeWitt,302,Proposition 8,,REP,Yes,150,37,80,267
DeWitt,302,Proposition 8,,REP,No,1,0,1,2
DeWitt,302,Ballots Cast,,REP,,151,37,81,269
DeWitt,302,Proposition 8,,REP,Under Votes,7,1,5,13
DeWitt,302,Proposition 8,,REP,Over Votes,0,0,0,0
DeWitt,302,Proposition 9,,REP,Yes,139,37,76,252
DeWitt,302,Proposition 9,,REP,No,11,0,4,15
DeWitt,302,Ballots Cast,,REP,,150,37,80,267
DeWitt,302,Proposition 9,,REP,Under Votes,8,1,6,15
DeWitt,302,Proposition 9,,REP,Over Votes,0,0,0,0
DeWitt,302,Proposition 10,,REP,Yes,135,35,76,246
DeWitt,302,Proposition 10,,REP,No,13,2,5,20
DeWitt,302,Ballots Cast,,REP,,148,37,81,266
DeWitt,302,Proposition 10,,REP,Under Votes,10,1,5,16
DeWitt,302,Proposition 10,,REP,Over Votes,0,0,0,0
DeWitt,303,President,,DEM,Amy Klobuchar,0,0,0,0
DeWitt,303,President,,DEM,Joseph R. Biden,7,1,0,8
DeWitt,303,President,,DEM,Michael Bennet,0,0,0,0
DeWitt,303,President,,DEM,Marianne Williamson,0,0,0,0
DeWitt,303,President,,DEM,Michael R. Bloomberg,0,2,0,2
DeWitt,303,President,,DEM,Elizabeth Warren,0,0,0,0
DeWitt,303,President,,DEM,Andrew Yang,0,0,0,0
DeWitt,303,President,,DEM,Tom Steyer,0,0,0,0
DeWitt,303,President,,DEM,Pete Buttigieg,0,0,0,0
DeWitt,303,President,,DEM,Tulsi Gabbard,0,0,0,0
DeWitt,303,President,,DEM,Robby Wells,0,0,0,0
DeWitt,303,President,,DEM,Deval Patrick,0,0,0,0
DeWitt,303,President,,DEM,Bernie Sanders,7,0,3,10
DeWitt,303,President,,DEM,"Roque ""Rocky"" De La Fuente Guerra",0,0,0,0
DeWitt,303,President,,DEM,John K. Delaney,0,0,0,0
DeWitt,303,President,,DEM,Cory Booker,0,0,0,0
DeWitt,303,President,,DEM,Julián Castro,0,0,0,0
DeWitt,303,Ballots Cast,,DEM,,14,3,3,20
DeWitt,303,President,,DEM,Under Votes,1,0,0,1
DeWitt,303,President,,DEM,Over Votes,0,0,0,0
DeWitt,303,U.S. Senate,,DEM,Victor Hugo Harris,1,0,0,1
DeWitt,303,U.S. Senate,,DEM,"Annie ""Mamá"" Garcia",5,1,1,7
DeWitt,303,U.S. Senate,,DEM,Amanda K. Edwards,0,1,0,1
DeWitt,303,U.S. Senate,,DEM,Royce West,0,0,0,0
DeWitt,303,U.S. Senate,,DEM,Adrian Ocegueda,0,0,0,0
DeWitt,303,U.S. Senate,,DEM,D.R. Hunter,1,0,0,1
DeWitt,303,U.S. Senate,,DEM,Michael Cooper,0,0,0,0
DeWitt,303,U.S. Senate,,DEM,Chris Bell,1,0,1,2
DeWitt,303,U.S. Senate,,DEM,Cristina Tzintzun Ramirez,2,0,1,3
DeWitt,303,U.S. Senate,,DEM,Sema Hernandez,2,0,0,2
DeWitt,303,U.S. Senate,,DEM,Jack Daniel Foster Jr,0,0,0,0
DeWitt,303,U.S. Senate,,DEM,"Mary ""MJ"" Hegar",0,0,0,0
DeWitt,303,Ballots Cast,,DEM,,12,2,3,17
DeWitt,303,U.S. Senate,,DEM,Under Votes,3,1,0,4
DeWitt,303,U.S. Senate,,DEM,Over Votes,0,0,0,0
DeWitt,303,U.S. House,34,DEM,Diego Zavala,7,0,0,7
DeWitt,303,U.S. House,34,DEM,Osbert Haro,1,0,0,1
DeWitt,303,U.S. House,34,DEM,Filemon B. Vela,4,2,3,9
DeWitt,303,Ballots Cast,,DEM,,12,2,3,17
DeWitt,303,U.S. House,34,DEM,Under Votes,3,1,0,4
DeWitt,303,U.S. House,34,DEM,Over Votes,0,0,0,0
DeWitt,303,Railroad Commissioner,,DEM,Chrysta Castañeda,5,2,1,8
DeWitt,303,Railroad Commissioner,,DEM,Kelly Stone,2,0,0,2
DeWitt,303,Railroad Commissioner,,DEM,Mark Watson,2,0,1,3
DeWitt,303,Railroad Commissioner,,DEM,"Roberto R. ""Beto"" Alonzo",3,0,1,4
DeWitt,303,Ballots Cast,,DEM,,12,2,3,17
DeWitt,303,Railroad Commissioner,,DEM,Under Votes,3,1,0,4
DeWitt,303,Railroad Commissioner,,DEM,Over Votes,0,0,0,0
DeWitt,303,"Chief Justice, Supreme Court",,DEM,Jerry Zimmerer,4,0,1,5
DeWitt,303,"Chief Justice, Supreme Court",,DEM,Amy Clark Meachum,8,2,2,12
DeWitt,303,Ballots Cast,,DEM,,12,2,3,17
DeWitt,303,"Chief Justice, Supreme Court",,DEM,Under Votes,3,1,0,4
DeWitt,303,"Chief Justice, Supreme Court",,DEM,Over Votes,0,0,0,0
DeWitt,303,"Justice, Supreme Court, Place 6 Unexpired Term",,DEM,Larry Praeger,4,1,1,6
DeWitt,303,"Justice, Supreme Court, Place 6 Unexpired Term",,DEM,Kathy Cheng,8,1,2,11
DeWitt,303,Ballots Cast,,DEM,,12,2,3,17
DeWitt,303,"Justice, Supreme Court, Place 6 Unexpired Term",,DEM,Under Votes,3,1,0,4
DeWitt,303,"Justice, Supreme Court, Place 6 Unexpired Term",,DEM,Over Votes,0,0,0,0
DeWitt,303,"Justice, Supreme Court, Place 7",,DEM,Staci Williams,9,0,2,11
DeWitt,303,"Justice, Supreme Court, Place 7",,DEM,Brandy Voss,2,2,1,5
DeWitt,303,Ballots Cast,,DEM,,11,2,3,16
DeWitt,303,"Justice, Supreme Court, Place 7",,DEM,Under Votes,4,1,0,5
DeWitt,303,"Justice, Supreme Court, Place 7",,DEM,Over Votes,0,0,0,0
DeWitt,303,"Justice, Supreme Court, Place 8",,DEM,Peter Kelly,3,1,3,7
DeWitt,303,"Justice, Supreme Court, Place 8",,DEM,Gisela D. Triana,8,1,0,9
DeWitt,303,Ballots Cast,,DEM,,11,2,3,16
DeWitt,303,"Justice, Supreme Court, Place 8",,DEM,Under Votes,4,1,0,5
DeWitt,303,"Justice, Supreme Court, Place 8",,DEM,Over Votes,0,0,0,0
DeWitt,303,"Judge, Court of Criminal Appeals, Place 3",,DEM,Dan Wood,3,0,1,4
DeWitt,303,"Judge, Court of Criminal Appeals, Place 3",,DEM,William Pieratt Demond,1,0,1,2
DeWitt,303,"Judge, Court of Criminal Appeals, Place 3",,DEM,Elizabeth Davis Frizell,8,2,1,11
DeWitt,303,Ballots Cast,,DEM,,12,2,3,17
DeWitt,303,"Judge, Court of Criminal Appeals, Place 3",,DEM,Under Votes,3,1,0,4
DeWitt,303,"Judge, Court of Criminal Appeals, Place 3",,DEM,Over Votes,0,0,0,0
DeWitt,303,"Judge, Court of Criminal Appeals, Place 4",,DEM,Steven Miears,4,1,0,5
DeWitt,303,"Judge, Court of Criminal Appeals, Place 4",,DEM,Tina Clinton,8,1,2,11
DeWitt,303,Ballots Cast,,DEM,,12,2,2,16
DeWitt,303,"Judge, Court of Criminal Appeals, Place 4",,DEM,Under Votes,3,1,1,5
DeWitt,303,"Judge, Court of Criminal Appeals, Place 4",,DEM,Over Votes,0,0,0,0
DeWitt,303,"Judge, Court of Criminal Appeals, Place 9",,DEM,Brandon Birmingham,11,2,2,15
DeWitt,303,Ballots Cast,,DEM,,11,2,2,15
DeWitt,303,"Judge, Court of Criminal Appeals, Place 9",,DEM,Under Votes,4,1,1,6
DeWitt,303,"Judge, Court of Criminal Appeals, Place 9",,DEM,Over Votes,0,0,0,0
DeWitt,303,State Senate,18,DEM,Michael Antalan,12,1,2,15
DeWitt,303,Ballots Cast,,DEM,,12,1,2,15
DeWitt,303,State Senate,18,DEM,Under Votes,3,2,1,6
DeWitt,303,State Senate,18,DEM,Over Votes,0,0,0,0
DeWitt,303,County Chairman,,DEM,Jospeh L. Sheppard,12,1,1,14
DeWitt,303,Ballots Cast,,DEM,,12,1,1,14
DeWitt,303,County Chairman,,DEM,Under Votes,3,2,2,7
DeWitt,303,County Chairman,,DEM,Over Votes,0,0,0,0
DeWitt,303,President,,REP,Zoltan G. Istvan,1,0,0,1
DeWitt,303,President,,REP,Donald J. Trump,74,16,20,110
DeWitt,303,President,,REP,Bill Weld,0,0,0,0
DeWitt,303,President,,REP,Joe Walsh,2,0,0,2
DeWitt,303,President,,REP,"Roque ""Rocky"" De La Fuente Guerra",0,0,0,0
DeWitt,303,President,,REP,Matthew John Matern,1,0,0,1
DeWitt,303,President,,REP,Bob Ely,0,0,0,0
DeWitt,303,President,,REP,Uncommitted,0,1,2,3
DeWitt,303,Ballots Cast,,REP,,78,17,22,117
DeWitt,303,President,,REP,Under Votes,0,0,0,0
DeWitt,303,President,,REP,Over Votes,0,1,0,1
DeWitt,303,U.S. Senate,,REP,Dwayne Stovall,13,3,4,20
DeWitt,303,U.S. Senate,,REP,Mark Yancey,5,1,0,6
DeWitt,303,U.S. Senate,,REP,Virgil Bierschwale,1,0,0,1
DeWitt,303,U.S. Senate,,REP,John Cornyn,50,11,16,77
DeWitt,303,U.S. Senate,,REP,John Anthony Castro,3,0,1,4
DeWitt,303,Ballots Cast,,REP,,72,15,21,108
DeWitt,303,U.S. Senate,,REP,Under Votes,6,2,1,9
DeWitt,303,U.S. Senate,,REP,Over Votes,0,1,0,1
DeWitt,303,U.S. House,34,REP,Rey Gonzalez,43,3,9,55
DeWitt,303,U.S. House,34,REP,Rod Lingsch,23,9,10,42
DeWitt,303,Ballots Cast,,REP,,66,12,19,97
DeWitt,303,U.S. House,34,REP,Under Votes,12,5,3,20
DeWitt,303,U.S. House,34,REP,Over Votes,0,1,0,1
DeWitt,303,Railroad Commissioner,,REP,Ryan Sitton,26,6,6,38
DeWitt,303,Railroad Commissioner,,REP,"James ""Jim"" Wright",44,7,13,64
DeWitt,303,Ballots Cast,,REP,,70,13,19,102
DeWitt,303,Railroad Commissioner,,REP,Under Votes,8,4,3,15
DeWitt,303,Railroad Commissioner,,REP,Over Votes,0,1,0,1
DeWitt,303,"Chief Justice, Supreme Court",,REP,Nathan Hecht,62,12,20,94
DeWitt,303,Ballots Cast,,REP,,62,12,20,94
DeWitt,303,"Chief Justice, Supreme Court",,REP,Under Votes,16,6,2,24
DeWitt,303,"Chief Justice, Supreme Court",,REP,Over Votes,0,0,0,0
DeWitt,303,"Justice, Supreme Court, Place 6 Unexpired Term",,REP,Jane Bland,63,11,19,93
DeWitt,303,Ballots Cast,,REP,,63,11,19,93
DeWitt,303,"Justice, Supreme Court, Place 6 Unexpired Term",,REP,Under Votes,15,7,3,25
DeWitt,303,"Justice, Supreme Court, Place 6 Unexpired Term",,REP,Over Votes,0,0,0,0
DeWitt,303,"Justice, Supreme Court, Place 7",,REP,Jeff Boyd,61,12,20,93
DeWitt,303,Ballots Cast,,REP,,61,12,20,93
DeWitt,303,"Justice, Supreme Court, Place 7",,REP,Under Votes,17,6,2,25
DeWitt,303,"Justice, Supreme Court, Place 7",,REP,Over Votes,0,0,0,0
DeWitt,303,"Justice, Supreme Court, Place 8",,REP,Brett Busby,63,11,20,94
DeWitt,303,Ballots Cast,,REP,,63,11,20,94
DeWitt,303,"Justice, Supreme Court, Place 8",,REP,Under Votes,15,7,2,24
DeWitt,303,"Justice, Supreme Court, Place 8",,REP,Over Votes,0,0,0,0
DeWitt,303,"Judge, Court of Criminal Appeals, Place 3",,REP,Gina Parker,32,5,8,45
DeWitt,303,"Judge, Court of Criminal Appeals, Place 3",,REP,Bert Richardson,30,5,10,45
DeWitt,303,Ballots Cast,,REP,,62,10,18,90
DeWitt,303,"Judge, Court of Criminal Appeals, Place 3",,REP,Under Votes,16,7,4,27
DeWitt,303,"Judge, Court of Criminal Appeals, Place 3",,REP,Over Votes,0,1,0,1
DeWitt,303,"Judge, Court of Criminal Appeals, Place 4",,REP,Kevin Patrick Yeary,62,12,18,92
DeWitt,303,Ballots Cast,,REP,,62,12,18,92
DeWitt,303,"Judge, Court of Criminal Appeals, Place 4",,REP,Under Votes,16,6,4,26
DeWitt,303,"Judge, Court of Criminal Appeals, Place 4",,REP,Over Votes,0,0,0,0
DeWitt,303,"Judge, Court of Criminal Appeals, Place 9",,REP,David Newell,62,12,18,92
DeWitt,303,Ballots Cast,,REP,,62,12,18,92
DeWitt,303,"Judge, Court of Criminal Appeals, Place 9",,REP,Under Votes,16,6,4,26
DeWitt,303,"Judge, Court of Criminal Appeals, Place 9",,REP,Over Votes,0,0,0,0
DeWitt,303,State Senate,18,REP,Lois W. Kolkhorst,62,11,19,92
DeWitt,303,Ballots Cast,,REP,,62,11,19,92
DeWitt,303,State Senate,18,REP,Under Votes,16,7,3,26
DeWitt,303,State Senate,18,REP,Over Votes,0,0,0,0
DeWitt,303,State Representative,30,REP,Geanie W. Morrison,60,11,19,90
DeWitt,303,State Representative,30,REP,Vanessa Hicks-Callaway,12,2,2,16
DeWitt,303,Ballots Cast,,REP,,72,13,21,106
DeWitt,303,State Representative,30,REP,Under Votes,6,4,1,11
DeWitt,303,State Representative,30,REP,Over Votes,0,1,0,1
DeWitt,303,"District Attorney, 24th Judicial District",,REP,"Robert C. ""Rob"" Lassman",67,12,18,97
DeWitt,303,Ballots Cast,,REP,,67,12,18,97
DeWitt,303,"District Attorney, 24th Judicial District",,REP,Under Votes,11,6,4,21
DeWitt,303,"District Attorney, 24th Judicial District",,REP,Over Votes,0,0,0,0
DeWitt,303,County Attorney,,REP,Jay Condie,63,11,19,93
DeWitt,303,Ballots Cast,,REP,,63,11,19,93
DeWitt,303,County Attorney,,REP,Under Votes,15,7,3,25
DeWitt,303,County Attorney,,REP,Over Votes,0,0,0,0
DeWitt,303,Sheriff,,REP,Carl R. Bowen,69,13,17,99
DeWitt,303,Ballots Cast,,REP,,69,13,17,99
DeWitt,303,Sheriff,,REP,Under Votes,9,5,5,19
DeWitt,303,Sheriff,,REP,Over Votes,0,0,0,0
DeWitt,303,County Tax Assessor-Collector,,REP,Ashley D. Mraz,56,9,14,79
DeWitt,303,County Tax Assessor-Collector,,REP,Guy Dolan,14,3,6,23
DeWitt,303,Ballots Cast,,REP,,70,12,20,102
DeWitt,303,County Tax Assessor-Collector,,REP,Under Votes,8,5,2,15
DeWitt,303,County Tax Assessor-Collector,,REP,Over Votes,0,1,0,1
DeWitt,303,"County Commissioner, Precinct 3",,REP,James Kaiser,63,12,19,94
DeWitt,303,Ballots Cast,,REP,,63,12,19,94
DeWitt,303,"County Commissioner, Precinct 3",,REP,Under Votes,15,6,3,24
DeWitt,303,"County Commissioner, Precinct 3",,REP,Over Votes,0,0,0,0
DeWitt,303,"Constable, Precinct 2",,REP,Jefferson Hobbs,44,7,5,56
DeWitt,303,"Constable, Precinct 2",,REP,Jeff Abbott,27,4,14,45
DeWitt,303,Ballots Cast,,REP,,71,11,19,101
DeWitt,303,"Constable, Precinct 2",,REP,Under Votes,7,6,3,16
DeWitt,303,"Constable, Precinct 2",,REP,Over Votes,0,1,0,1
DeWitt,303,County Chairman,,REP,Paul Guidry,64,14,17,95
DeWitt,303,Ballots Cast,,REP,,64,14,17,95
DeWitt,303,County Chairman,,REP,Under Votes,14,4,5,23
DeWitt,303,County Chairman,,REP,Over Votes,0,0,0,0
DeWitt,303,Proposition #1,,DEM,Yes,14,3,2,19
DeWitt,303,Proposition #1,,DEM,No,0,0,1,1
DeWitt,303,Ballots Cast,,DEM,,14,3,3,20
DeWitt,303,Proposition #1,,DEM,Under Votes,1,0,0,1
DeWitt,303,Proposition #1,,DEM,Over Votes,0,0,0,0
DeWitt,303,Proposition #2,,DEM,Yes,13,3,3,19
DeWitt,303,Proposition #2,,DEM,No,0,0,0,0
DeWitt,303,Ballots Cast,,DEM,,13,3,3,19
DeWitt,303,Proposition #2,,DEM,Under Votes,2,0,0,2
DeWitt,303,Proposition #2,,DEM,Over Votes,0,0,0,0
DeWitt,303,Proposition #3,,DEM,Yes,15,3,3,21
DeWitt,303,Proposition #3,,DEM,No,0,0,0,0
DeWitt,303,Ballots Cast,,DEM,,15,3,3,21
DeWitt,303,Proposition #3,,DEM,Under Votes,0,0,0,0
DeWitt,303,Proposition #3,,DEM,Over Votes,0,0,0,0
DeWitt,303,Proposition #4,,DEM,Yes,13,3,2,18
DeWitt,303,Proposition #4,,DEM,No,1,0,1,2
DeWitt,303,Ballots Cast,,DEM,,14,3,3,20
DeWitt,303,Proposition #4,,DEM,Under Votes,1,0,0,1
DeWitt,303,Proposition #4,,DEM,Over Votes,0,0,0,0
DeWitt,303,Proposition #5,,DEM,Yes,14,3,2,19
DeWitt,303,Proposition #5,,DEM,No,0,0,1,1
DeWitt,303,Ballots Cast,,DEM,,14,3,3,20
DeWitt,303,Proposition #5,,DEM,Under Votes,1,0,0,1
DeWitt,303,Proposition #5,,DEM,Over Votes,0,0,0,0
DeWitt,303,Proposition #6,,DEM,Yes,13,3,2,18
DeWitt,303,Proposition #6,,DEM,No,0,0,1,1
DeWitt,303,Ballots Cast,,DEM,,13,3,3,19
DeWitt,303,Proposition #6,,DEM,Under Votes,2,0,0,2
DeWitt,303,Proposition #6,,DEM,Over Votes,0,0,0,0
DeWitt,303,Proposition #7,,DEM,Yes,14,3,2,19
DeWitt,303,Proposition #7,,DEM,No,0,0,1,1
DeWitt,303,Ballots Cast,,DEM,,14,3,3,20
DeWitt,303,Proposition #7,,DEM,Under Votes,1,0,0,1
DeWitt,303,Proposition #7,,DEM,Over Votes,0,0,0,0
DeWitt,303,Proposition #8,,DEM,Yes,13,3,3,19
DeWitt,303,Proposition #8,,DEM,No,0,0,0,0
DeWitt,303,Ballots Cast,,DEM,,13,3,3,19
DeWitt,303,Proposition #8,,DEM,Under Votes,2,0,0,2
DeWitt,303,Proposition #8,,DEM,Over Votes,0,0,0,0
DeWitt,303,Proposition #9,,DEM,Yes,13,3,3,19
DeWitt,303,Proposition #9,,DEM,No,0,0,0,0
DeWitt,303,Ballots Cast,,DEM,,13,3,3,19
DeWitt,303,Proposition #9,,DEM,Under Votes,2,0,0,2
DeWitt,303,Proposition #9,,DEM,Over Votes,0,0,0,0
DeWitt,303,Proposition #10,,DEM,Yes,13,3,3,19
DeWitt,303,Proposition #10,,DEM,No,0,0,0,0
DeWitt,303,Ballots Cast,,DEM,,13,3,3,19
DeWitt,303,Proposition #10,,DEM,Under Votes,2,0,0,2
DeWitt,303,Proposition #10,,DEM,Over Votes,0,0,0,0
DeWitt,303,Proposition #11,,DEM,Yes,14,3,3,20
DeWitt,303,Proposition #11,,DEM,No,0,0,0,0
DeWitt,303,Ballots Cast,,DEM,,14,3,3,20
DeWitt,303,Proposition #11,,DEM,Under Votes,1,0,0,1
DeWitt,303,Proposition #11,,DEM,Over Votes,0,0,0,0
DeWitt,303,Proposition 1,,REP,Yes,68,16,17,101
DeWitt,303,Proposition 1,,REP,No,7,2,3,12
DeWitt,303,Ballots Cast,,REP,,75,18,20,113
DeWitt,303,Proposition 1,,REP,Under Votes,3,0,2,5
DeWitt,303,Proposition 1,,REP,Over Votes,0,0,0,0
DeWitt,303,Proposition 2,,REP,Yes,65,12,18,95
DeWitt,303,Proposition 2,,REP,No,10,4,4,18
DeWitt,303,Ballots Cast,,REP,,75,16,22,113
DeWitt,303,Proposition 2,,REP,Under Votes,3,2,0,5
DeWitt,303,Proposition 2,,REP,Over Votes,0,0,0,0
DeWitt,303,Proposition 3,,REP,Yes,72,17,20,109
DeWitt,303,Proposition 3,,REP,No,4,1,2,7
DeWitt,303,Ballots Cast,,REP,,76,18,22,116
DeWitt,303,Proposition 3,,REP,Under Votes,2,0,0,2
DeWitt,303,Proposition 3,,REP,Over Votes,0,0,0,0
DeWitt,303,Proposition 4,,REP,Yes,71,17,19,107
DeWitt,303,Proposition 4,,REP,No,5,1,3,9
DeWitt,303,Ballots Cast,,REP,,76,18,22,116
DeWitt,303,Proposition 4,,REP,Under Votes,2,0,0,2
DeWitt,303,Proposition 4,,REP,Over Votes,0,0,0,0
DeWitt,303,Proposition 5,,REP,Yes,70,15,20,105
DeWitt,303,Proposition 5,,REP,No,6,3,2,11
DeWitt,303,Ballots Cast,,REP,,76,18,22,116
DeWitt,303,Proposition 5,,REP,Under Votes,2,0,0,2
DeWitt,303,Proposition 5,,REP,Over Votes,0,0,0,0
DeWitt,303,Proposition 6,,REP,Yes,73,16,19,108
DeWitt,303,Proposition 6,,REP,No,4,0,3,7
DeWitt,303,Ballots Cast,,REP,,77,16,22,115
DeWitt,303,Proposition 6,,REP,Under Votes,1,1,0,2
DeWitt,303,Proposition 6,,REP,Over Votes,0,1,0,1
DeWitt,303,Proposition 7,,REP,Yes,73,17,21,111
DeWitt,303,Proposition 7,,REP,No,2,0,1,3
DeWitt,303,Ballots Cast,,REP,,75,17,22,114
DeWitt,303,Proposition 7,,REP,Under Votes,3,1,0,4
DeWitt,303,Proposition 7,,REP,Over Votes,0,0,0,0
DeWitt,303,Proposition 8,,REP,Yes,73,18,21,112
DeWitt,303,Proposition 8,,REP,No,2,0,1,3
DeWitt,303,Ballots Cast,,REP,,75,18,22,115
DeWitt,303,Proposition 8,,REP,Under Votes,3,0,0,3
DeWitt,303,Proposition 8,,REP,Over Votes,0,0,0,0
DeWitt,303,Proposition 9,,REP,Yes,73,16,21,110
DeWitt,303,Proposition 9,,REP,No,3,1,0,4
DeWitt,303,Ballots Cast,,REP,,76,17,21,114
DeWitt,303,Proposition 9,,REP,Under Votes,2,1,1,4
DeWitt,303,Proposition 9,,REP,Over Votes,0,0,0,0
DeWitt,303,Proposition 10,,REP,Yes,71,16,20,107
DeWitt,303,Proposition 10,,REP,No,4,2,2,8
DeWitt,303,Ballots Cast,,REP,,75,18,22,115
DeWitt,303,Proposition 10,,REP,Under Votes,3,0,0,3
DeWitt,303,Proposition 10,,REP,Over Votes,0,0,0,0
DeWitt,401,President,,DEM,Amy Klobuchar,0,1,3,4
DeWitt,401,President,,DEM,Joseph R. Biden,41,5,9,55
DeWitt,401,President,,DEM,Michael Bennet,0,0,0,0
DeWitt,401,President,,DEM,Marianne Williamson,0,0,0,0
DeWitt,401,President,,DEM,Michael R. Bloomberg,3,7,6,16
DeWitt,401,President,,DEM,Elizabeth Warren,3,0,4,7
DeWitt,401,President,,DEM,Andrew Yang,0,0,0,0
DeWitt,401,President,,DEM,Tom Steyer,0,1,2,3
DeWitt,401,President,,DEM,Pete Buttigieg,0,0,0,0
DeWitt,401,President,,DEM,Tulsi Gabbard,0,0,0,0
DeWitt,401,President,,DEM,Robby Wells,0,0,0,0
DeWitt,401,President,,DEM,Deval Patrick,0,0,0,0
DeWitt,401,President,,DEM,Bernie Sanders,11,3,13,27
DeWitt,401,President,,DEM,"Roque ""Rocky"" De La Fuente Guerra",0,0,0,0
DeWitt,401,President,,DEM,John K. Delaney,0,0,0,0
DeWitt,401,President,,DEM,Cory Booker,0,0,0,0
DeWitt,401,President,,DEM,Julián Castro,0,0,0,0
DeWitt,401,Ballots Cast,,DEM,,58,17,37,112
DeWitt,401,President,,DEM,Under Votes,0,2,0,2
DeWitt,401,President,,DEM,Over Votes,0,1,0,1
DeWitt,401,U.S. Senate,,DEM,Victor Hugo Harris,3,0,1,4
DeWitt,401,U.S. Senate,,DEM,"Annie ""Mamá"" Garcia",13,1,4,18
DeWitt,401,U.S. Senate,,DEM,Amanda K. Edwards,6,0,4,10
DeWitt,401,U.S. Senate,,DEM,Royce West,3,1,4,8
DeWitt,401,U.S. Senate,,DEM,Adrian Ocegueda,3,0,2,5
DeWitt,401,U.S. Senate,,DEM,D.R. Hunter,2,0,0,2
DeWitt,401,U.S. Senate,,DEM,Michael Cooper,8,0,2,10
DeWitt,401,U.S. Senate,,DEM,Chris Bell,5,3,5,13
DeWitt,401,U.S. Senate,,DEM,Cristina Tzintzun Ramirez,4,2,2,8
DeWitt,401,U.S. Senate,,DEM,Sema Hernandez,0,0,0,0
DeWitt,401,U.S. Senate,,DEM,Jack Daniel Foster Jr,0,1,0,1
DeWitt,401,U.S. Senate,,DEM,"Mary ""MJ"" Hegar",3,7,10,20
DeWitt,401,Ballots Cast,,DEM,,50,15,34,99
DeWitt,401,U.S. Senate,,DEM,Under Votes,8,4,3,15
DeWitt,401,U.S. Senate,,DEM,Over Votes,0,1,0,1
DeWitt,401,U.S. House,34,DEM,Diego Zavala,23,1,8,32
DeWitt,401,U.S. House,34,DEM,Osbert Haro,3,1,0,4
DeWitt,401,U.S. House,34,DEM,Filemon B. Vela,26,15,26,67
DeWitt,401,Ballots Cast,,DEM,,52,17,34,103
DeWitt,401,U.S. House,34,DEM,Under Votes,6,3,3,12
DeWitt,401,U.S. House,34,DEM,Over Votes,0,0,0,0
DeWitt,401,Railroad Commissioner,,DEM,Chrysta Castañeda,14,4,9,27
DeWitt,401,Railroad Commissioner,,DEM,Kelly Stone,11,4,10,25
DeWitt,401,Railroad Commissioner,,DEM,Mark Watson,12,6,8,26
DeWitt,401,Railroad Commissioner,,DEM,"Roberto R. ""Beto"" Alonzo",16,3,7,26
DeWitt,401,Ballots Cast,,DEM,,53,17,34,104
DeWitt,401,Railroad Commissioner,,DEM,Under Votes,5,3,3,11
DeWitt,401,Railroad Commissioner,,DEM,Over Votes,0,0,0,0
DeWitt,401,"Chief Justice, Supreme Court",,DEM,Jerry Zimmerer,12,5,7,24
DeWitt,401,"Chief Justice, Supreme Court",,DEM,Amy Clark Meachum,41,12,27,80
DeWitt,401,Ballots Cast,,DEM,,53,17,34,104
DeWitt,401,"Chief Justice, Supreme Court",,DEM,Under Votes,5,3,3,11
DeWitt,401,"Chief Justice, Supreme Court",,DEM,Over Votes,0,0,0,0
DeWitt,401,"Justice, Supreme Court, Place 6 Unexpired Term",,DEM,Larry Praeger,13,5,10,28
DeWitt,401,"Justice, Supreme Court, Place 6 Unexpired Term",,DEM,Kathy Cheng,37,12,24,73
DeWitt,401,Ballots Cast,,DEM,,50,17,34,101
DeWitt,401,"Justice, Supreme Court, Place 6 Unexpired Term",,DEM,Under Votes,8,3,3,14
DeWitt,401,"Justice, Supreme Court, Place 6 Unexpired Term",,DEM,Over Votes,0,0,0,0
DeWitt,401,"Justice, Supreme Court, Place 7",,DEM,Staci Williams,36,11,19,66
DeWitt,401,"Justice, Supreme Court, Place 7",,DEM,Brandy Voss,15,6,14,35
DeWitt,401,Ballots Cast,,DEM,,51,17,33,101
DeWitt,401,"Justice, Supreme Court, Place 7",,DEM,Under Votes,7,3,4,14
DeWitt,401,"Justice, Supreme Court, Place 7",,DEM,Over Votes,0,0,0,0
DeWitt,401,"Justice, Supreme Court, Place 8",,DEM,Peter Kelly,14,6,13,33
DeWitt,401,"Justice, Supreme Court, Place 8",,DEM,Gisela D. Triana,36,10,19,65
DeWitt,401,Ballots Cast,,DEM,,50,16,32,98
DeWitt,401,"Justice, Supreme Court, Place 8",,DEM,Under Votes,8,4,5,17
DeWitt,401,"Justice, Supreme Court, Place 8",,DEM,Over Votes,0,0,0,0
DeWitt,401,"Judge, Court of Criminal Appeals, Place 3",,DEM,Dan Wood,11,4,6,21
DeWitt,401,"Judge, Court of Criminal Appeals, Place 3",,DEM,William Pieratt Demond,3,1,1,5
DeWitt,401,"Judge, Court of Criminal Appeals, Place 3",,DEM,Elizabeth Davis Frizell,37,12,27,76
DeWitt,401,Ballots Cast,,DEM,,51,17,34,102
DeWitt,401,"Judge, Court of Criminal Appeals, Place 3",,DEM,Under Votes,7,3,3,13
DeWitt,401,"Judge, Court of Criminal Appeals, Place 3",,DEM,Over Votes,0,0,0,0
DeWitt,401,"Judge, Court of Criminal Appeals, Place 4",,DEM,Steven Miears,12,8,10,30
DeWitt,401,"Judge, Court of Criminal Appeals, Place 4",,DEM,Tina Clinton,40,9,24,73
DeWitt,401,Ballots Cast,,DEM,,52,17,34,103
DeWitt,401,"Judge, Court of Criminal Appeals, Place 4",,DEM,Under Votes,6,3,3,12
DeWitt,401,"Judge, Court of Criminal Appeals, Place 4",,DEM,Over Votes,0,0,0,0
DeWitt,401,"Judge, Court of Criminal Appeals, Place 9",,DEM,Brandon Birmingham,45,15,30,90
DeWitt,401,Ballots Cast,,DEM,,45,15,30,90
DeWitt,401,"Judge, Court of Criminal Appeals, Place 9",,DEM,Under Votes,13,5,7,25
DeWitt,401,"Judge, Court of Criminal Appeals, Place 9",,DEM,Over Votes,0,0,0,0
DeWitt,401,State Senate,18,DEM,Michael Antalan,48,15,29,92
DeWitt,401,Ballots Cast,,DEM,,48,15,29,92
DeWitt,401,State Senate,18,DEM,Under Votes,10,5,8,23
DeWitt,401,State Senate,18,DEM,Over Votes,0,0,0,0
DeWitt,401,County Chairman,,DEM,Jospeh L. Sheppard,52,16,33,101
DeWitt,401,Ballots Cast,,DEM,,52,16,33,101
DeWitt,401,County Chairman,,DEM,Under Votes,6,4,4,14
DeWitt,401,County Chairman,,DEM,Over Votes,0,0,0,0
DeWitt,401,President,,REP,Zoltan G. Istvan,2,0,0,2
DeWitt,401,President,,REP,Donald J. Trump,238,53,312,603
DeWitt,401,President,,REP,Bill Weld,2,1,4,7
DeWitt,401,President,,REP,Joe Walsh,2,0,2,4
DeWitt,401,President,,REP,"Roque ""Rocky"" De La Fuente Guerra",1,0,0,1
DeWitt,401,President,,REP,Matthew John Matern,0,0,0,0
DeWitt,401,President,,REP,Bob Ely,0,0,0,0
DeWitt,401,President,,REP,Uncommitted,12,2,9,23
DeWitt,401,Ballots Cast,,REP,,257,56,327,640
DeWitt,401,President,,REP,Under Votes,2,1,2,5
DeWitt,401,President,,REP,Over Votes,0,0,0,0
DeWitt,401,U.S. Senate,,REP,Dwayne Stovall,58,12,75,145
DeWitt,401,U.S. Senate,,REP,Mark Yancey,14,2,22,38
DeWitt,401,U.S. Senate,,REP,Virgil Bierschwale,2,0,1,3
DeWitt,401,U.S. Senate,,REP,John Cornyn,155,40,203,398
DeWitt,401,U.S. Senate,,REP,John Anthony Castro,10,0,2,12
DeWitt,401,Ballots Cast,,REP,,239,54,303,596
DeWitt,401,U.S. Senate,,REP,Under Votes,20,2,26,48
DeWitt,401,U.S. Senate,,REP,Over Votes,0,1,0,1
DeWitt,401,U.S. House,34,REP,Rey Gonzalez,138,28,164,330
DeWitt,401,U.S. House,34,REP,Rod Lingsch,82,21,111,214
DeWitt,401,Ballots Cast,,REP,,220,49,275,544
DeWitt,401,U.S. House,34,REP,Under Votes,39,8,54,101
DeWitt,401,U.S. House,34,REP,Over Votes,0,0,0,0
DeWitt,401,Railroad Commissioner,,REP,Ryan Sitton,67,19,101,187
DeWitt,401,Railroad Commissioner,,REP,"James ""Jim"" Wright",148,32,171,351
DeWitt,401,Ballots Cast,,REP,,215,51,272,538
DeWitt,401,Railroad Commissioner,,REP,Under Votes,44,6,57,107
DeWitt,401,Railroad Commissioner,,REP,Over Votes,0,0,0,0
DeWitt,401,"Chief Justice, Supreme Court",,REP,Nathan Hecht,224,48,268,540
DeWitt,401,Ballots Cast,,REP,,224,48,268,540
DeWitt,401,"Chief Justice, Supreme Court",,REP,Under Votes,35,9,61,105
DeWitt,401,"Chief Justice, Supreme Court",,REP,Over Votes,0,0,0,0
DeWitt,401,"Justice, Supreme Court, Place 6 Unexpired Term",,REP,Jane Bland,221,49,272,542
DeWitt,401,Ballots Cast,,REP,,221,49,272,542
DeWitt,401,"Justice, Supreme Court, Place 6 Unexpired Term",,REP,Under Votes,38,8,57,103
DeWitt,401,"Justice, Supreme Court, Place 6 Unexpired Term",,REP,Over Votes,0,0,0,0
DeWitt,401,"Justice, Supreme Court, Place 7",,REP,Jeff Boyd,220,49,272,541
DeWitt,401,Ballots Cast,,REP,,220,49,272,541
DeWitt,401,"Justice, Supreme Court, Place 7",,REP,Under Votes,39,8,57,104
DeWitt,401,"Justice, Supreme Court, Place 7",,REP,Over Votes,0,0,0,0
DeWitt,401,"Justice, Supreme Court, Place 8",,REP,Brett Busby,217,49,269,535
DeWitt,401,Ballots Cast,,REP,,217,49,269,535
DeWitt,401,"Justice, Supreme Court, Place 8",,REP,Under Votes,42,8,60,110
DeWitt,401,"Justice, Supreme Court, Place 8",,REP,Over Votes,0,0,0,0
DeWitt,401,"Judge, Court of Criminal Appeals, Place 3",,REP,Gina Parker,127,29,150,306
DeWitt,401,"Judge, Court of Criminal Appeals, Place 3",,REP,Bert Richardson,86,19,113,218
DeWitt,401,Ballots Cast,,REP,,213,48,263,524
DeWitt,401,"Judge, Court of Criminal Appeals, Place 3",,REP,Under Votes,46,8,66,120
DeWitt,401,"Judge, Court of Criminal Appeals, Place 3",,REP,Over Votes,0,1,0,1
DeWitt,401,"Judge, Court of Criminal Appeals, Place 4",,REP,Kevin Patrick Yeary,214,49,269,532
DeWitt,401,Ballots Cast,,REP,,214,49,269,532
DeWitt,401,"Judge, Court of Criminal Appeals, Place 4",,REP,Under Votes,45,8,60,113
DeWitt,401,"Judge, Court of Criminal Appeals, Place 4",,REP,Over Votes,0,0,0,0
DeWitt,401,"Judge, Court of Criminal Appeals, Place 9",,REP,David Newell,211,49,271,531
DeWitt,401,Ballots Cast,,REP,,211,49,271,531
DeWitt,401,"Judge, Court of Criminal Appeals, Place 9",,REP,Under Votes,48,8,58,114
DeWitt,401,"Judge, Court of Criminal Appeals, Place 9",,REP,Over Votes,0,0,0,0
DeWitt,401,State Senate,18,REP,Lois W. Kolkhorst,231,49,290,570
DeWitt,401,Ballots Cast,,REP,,231,49,290,570
DeWitt,401,State Senate,18,REP,Under Votes,28,8,39,75
DeWitt,401,State Senate,18,REP,Over Votes,0,0,0,0
DeWitt,401,State Representative,30,REP,Geanie W. Morrison,199,44,263,506
DeWitt,401,State Representative,30,REP,Vanessa Hicks-Callaway,45,10,45,100
DeWitt,401,Ballots Cast,,REP,,244,54,308,606
DeWitt,401,State Representative,30,REP,Under Votes,15,3,21,39
DeWitt,401,State Representative,30,REP,Over Votes,0,0,0,0
DeWitt,401,"District Attorney, 24th Judicial District",,REP,"Robert C. ""Rob"" Lassman",219,50,297,566
DeWitt,401,Ballots Cast,,REP,,219,50,297,566
DeWitt,401,"District Attorney, 24th Judicial District",,REP,Under Votes,40,7,32,79
DeWitt,401,"District Attorney, 24th Judicial District",,REP,Over Votes,0,0,0,0
DeWitt,401,County Attorney,,REP,Jay Condie,224,50,291,565
DeWitt,401,Ballots Cast,,REP,,224,50,291,565
DeWitt,401,County Attorney,,REP,Under Votes,35,7,38,80
DeWitt,401,County Attorney,,REP,Over Votes,0,0,0,0
DeWitt,401,Sheriff,,REP,Carl R. Bowen,232,52,297,581
DeWitt,401,Ballots Cast,,REP,,232,52,297,581
DeWitt,401,Sheriff,,REP,Under Votes,27,5,32,64
DeWitt,401,Sheriff,,REP,Over Votes,0,0,0,0
DeWitt,401,County Tax Assessor-Collector,,REP,Ashley D. Mraz,189,44,256,489
DeWitt,401,County Tax Assessor-Collector,,REP,Guy Dolan,64,12,67,143
DeWitt,401,Ballots Cast,,REP,,253,56,323,632
DeWitt,401,County Tax Assessor-Collector,,REP,Under Votes,6,1,6,13
DeWitt,401,County Tax Assessor-Collector,,REP,Over Votes,0,0,0,0
DeWitt,401,"Constable, Precinct 2",,REP,Jefferson Hobbs,164,40,202,406
DeWitt,401,"Constable, Precinct 2",,REP,Jeff Abbott,75,14,102,191
DeWitt,401,Ballots Cast,,REP,,239,54,304,597
DeWitt,401,"Constable, Precinct 2",,REP,Under Votes,20,2,25,47
DeWitt,401,"Constable, Precinct 2",,REP,Over Votes,0,1,0,1
DeWitt,401,County Chairman,,REP,Paul Guidry,224,50,285,559
DeWitt,401,Ballots Cast,,REP,,224,50,285,559
DeWitt,401,County Chairman,,REP,Under Votes,35,7,44,86
DeWitt,401,County Chairman,,REP,Over Votes,0,0,0,0
DeWitt,401,Proposition #1,,DEM,Yes,53,16,32,101
DeWitt,401,Proposition #1,,DEM,No,1,3,2,6
DeWitt,401,Ballots Cast,,DEM,,54,19,34,107
DeWitt,401,Proposition #1,,DEM,Under Votes,4,1,3,8
DeWitt,401,Proposition #1,,DEM,Over Votes,0,0,0,0
DeWitt,401,Proposition #2,,DEM,Yes,55,18,30,103
DeWitt,401,Proposition #2,,DEM,No,2,1,3,6
DeWitt,401,Ballots Cast,,DEM,,57,19,33,109
DeWitt,401,Proposition #2,,DEM,Under Votes,1,1,4,6
DeWitt,401,Proposition #2,,DEM,Over Votes,0,0,0,0
DeWitt,401,Proposition #3,,DEM,Yes,57,18,35,110
DeWitt,401,Proposition #3,,DEM,No,0,1,0,1
DeWitt,401,Ballots Cast,,DEM,,57,19,35,111
DeWitt,401,Proposition #3,,DEM,Under Votes,1,1,2,4
DeWitt,401,Proposition #3,,DEM,Over Votes,0,0,0,0
DeWitt,401,Proposition #4,,DEM,Yes,56,16,34,106
DeWitt,401,Proposition #4,,DEM,No,1,3,1,5
DeWitt,401,Ballots Cast,,DEM,,57,19,35,111
DeWitt,401,Proposition #4,,DEM,Under Votes,1,1,2,4
DeWitt,401,Proposition #4,,DEM,Over Votes,0,0,0,0
DeWitt,401,Proposition #5,,DEM,Yes,55,17,34,106
DeWitt,401,Proposition #5,,DEM,No,2,2,1,5
DeWitt,401,Ballots Cast,,DEM,,57,19,35,111
DeWitt,401,Proposition #5,,DEM,Under Votes,1,1,2,4
DeWitt,401,Proposition #5,,DEM,Over Votes,0,0,0,0
DeWitt,401,Proposition #6,,DEM,Yes,57,17,34,108
DeWitt,401,Proposition #6,,DEM,No,0,2,1,3
DeWitt,401,Ballots Cast,,DEM,,57,19,35,111
DeWitt,401,Proposition #6,,DEM,Under Votes,1,1,2,4
DeWitt,401,Proposition #6,,DEM,Over Votes,0,0,0,0
DeWitt,401,Proposition #7,,DEM,Yes,52,16,35,103
DeWitt,401,Proposition #7,,DEM,No,2,3,0,5
DeWitt,401,Ballots Cast,,DEM,,54,19,35,108
DeWitt,401,Proposition #7,,DEM,Under Votes,4,1,2,7
DeWitt,401,Proposition #7,,DEM,Over Votes,0,0,0,0
DeWitt,401,Proposition #8,,DEM,Yes,53,17,34,104
DeWitt,401,Proposition #8,,DEM,No,3,2,1,6
DeWitt,401,Ballots Cast,,DEM,,56,19,35,110
DeWitt,401,Proposition #8,,DEM,Under Votes,2,1,2,5
DeWitt,401,Proposition #8,,DEM,Over Votes,0,0,0,0
DeWitt,401,Proposition #9,,DEM,Yes,55,17,34,106
DeWitt,401,Proposition #9,,DEM,No,0,2,1,3
DeWitt,401,Ballots Cast,,DEM,,55,19,35,109
DeWitt,401,Proposition #9,,DEM,Under Votes,3,1,2,6
DeWitt,401,Proposition #9,,DEM,Over Votes,0,0,0,0
DeWitt,401,Proposition #10,,DEM,Yes,53,16,34,103
DeWitt,401,Proposition #10,,DEM,No,1,3,1,5
DeWitt,401,Ballots Cast,,DEM,,54,19,35,108
DeWitt,401,Proposition #10,,DEM,Under Votes,4,1,2,7
DeWitt,401,Proposition #10,,DEM,Over Votes,0,0,0,0
DeWitt,401,Proposition #11,,DEM,Yes,46,14,32,92
DeWitt,401,Proposition #11,,DEM,No,2,5,2,9
DeWitt,401,Ballots Cast,,DEM,,48,19,34,101
DeWitt,401,Proposition #11,,DEM,Under Votes,10,1,3,14
DeWitt,401,Proposition #11,,DEM,Over Votes,0,0,0,0
DeWitt,401,Proposition 1,,REP,Yes,229,45,287,561
DeWitt,401,Proposition 1,,REP,No,23,12,38,73
DeWitt,401,Ballots Cast,,REP,,252,57,325,634
DeWitt,401,Proposition 1,,REP,Under Votes,7,0,4,11
DeWitt,401,Proposition 1,,REP,Over Votes,0,0,0,0
DeWitt,401,Proposition 2,,REP,Yes,226,47,284,557
DeWitt,401,Proposition 2,,REP,No,29,10,41,80
DeWitt,401,Ballots Cast,,REP,,255,57,325,637
DeWitt,401,Proposition 2,,REP,Under Votes,4,0,4,8
DeWitt,401,Proposition 2,,REP,Over Votes,0,0,0,0
DeWitt,401,Proposition 3,,REP,Yes,237,52,289,578
DeWitt,401,Proposition 3,,REP,No,10,3,26,39
DeWitt,401,Ballots Cast,,REP,,247,55,315,617
DeWitt,401,Proposition 3,,REP,Under Votes,12,1,14,27
DeWitt,401,Proposition 3,,REP,Over Votes,0,1,0,1
DeWitt,401,Proposition 4,,REP,Yes,237,51,304,592
DeWitt,401,Proposition 4,,REP,No,16,5,16,37
DeWitt,401,Ballots Cast,,REP,,253,56,320,629
DeWitt,401,Proposition 4,,REP,Under Votes,6,1,9,16
DeWitt,401,Proposition 4,,REP,Over Votes,0,0,0,0
DeWitt,401,Proposition 5,,REP,Yes,225,49,296,570
DeWitt,401,Proposition 5,,REP,No,29,5,22,56
DeWitt,401,Ballots Cast,,REP,,254,54,318,626
DeWitt,401,Proposition 5,,REP,Under Votes,5,3,11,19
DeWitt,401,Proposition 5,,REP,Over Votes,0,0,0,0
DeWitt,401,Proposition 6,,REP,Yes,243,51,293,587
DeWitt,401,Proposition 6,,REP,No,8,2,17,27
DeWitt,401,Ballots Cast,,REP,,251,53,310,614
DeWitt,401,Proposition 6,,REP,Under Votes,8,4,19,31
DeWitt,401,Proposition 6,,REP,Over Votes,0,0,0,0
DeWitt,401,Proposition 7,,REP,Yes,251,52,314,617
DeWitt,401,Proposition 7,,REP,No,2,1,4,7
DeWitt,401,Ballots Cast,,REP,,253,53,318,624
DeWitt,401,Proposition 7,,REP,Under Votes,6,4,11,21
DeWitt,401,Proposition 7,,REP,Over Votes,0,0,0,0
DeWitt,401,Proposition 8,,REP,Yes,252,52,312,616
DeWitt,401,Proposition 8,,REP,No,1,0,5,6
DeWitt,401,Ballots Cast,,REP,,253,52,317,622
DeWitt,401,Proposition 8,,REP,Under Votes,6,4,12,22
DeWitt,401,Proposition 8,,REP,Over Votes,0,1,0,1
DeWitt,401,Proposition 9,,REP,Yes,238,51,304,593
DeWitt,401,Proposition 9,,REP,No,14,1,11,26
DeWitt,401,Ballots Cast,,REP,,252,52,315,619
DeWitt,401,Proposition 9,,REP,Under Votes,7,4,14,25
DeWitt,401,Proposition 9,,REP,Over Votes,0,1,0,1
DeWitt,401,Proposition 10,,REP,Yes,233,52,291,576
DeWitt,401,Proposition 10,,REP,No,15,1,22,38
DeWitt,401,Ballots Cast,,REP,,248,53,313,614
DeWitt,401,Proposition 10,,REP,Under Votes,11,4,16,31
DeWitt,401,Proposition 10,,REP,Over Votes,0,0,0,0
DeWitt,402,President,,DEM,Amy Klobuchar,0,1,0,1
DeWitt,402,President,,DEM,Joseph R. Biden,7,4,2,13
DeWitt,402,President,,DEM,Michael Bennet,0,0,0,0
DeWitt,402,President,,DEM,Marianne Williamson,0,0,0,0
DeWitt,402,President,,DEM,Michael R. Bloomberg,0,2,2,4
DeWitt,402,President,,DEM,Elizabeth Warren,3,2,2,7
DeWitt,402,President,,DEM,Andrew Yang,0,0,0,0
DeWitt,402,President,,DEM,Tom Steyer,0,0,0,0
DeWitt,402,President,,DEM,Pete Buttigieg,0,0,1,1
DeWitt,402,President,,DEM,Tulsi Gabbard,0,0,0,0
DeWitt,402,President,,DEM,Robby Wells,0,0,0,0
DeWitt,402,President,,DEM,Deval Patrick,0,0,0,0
DeWitt,402,President,,DEM,Bernie Sanders,4,0,3,7
DeWitt,402,President,,DEM,"Roque ""Rocky"" De La Fuente Guerra",0,0,0,0
DeWitt,402,President,,DEM,John K. Delaney,0,0,0,0
DeWitt,402,President,,DEM,Cory Booker,0,0,0,0
DeWitt,402,President,,DEM,Julián Castro,0,0,0,0
DeWitt,402,Ballots Cast,,DEM,,14,9,10,33
DeWitt,402,President,,DEM,Under Votes,1,0,0,1
DeWitt,402,President,,DEM,Over Votes,0,0,0,0
DeWitt,402,U.S. Senate,,DEM,Victor Hugo Harris,2,0,1,3
DeWitt,402,U.S. Senate,,DEM,"Annie ""Mamá"" Garcia",2,2,1,5
DeWitt,402,U.S. Senate,,DEM,Amanda K. Edwards,1,2,0,3
DeWitt,402,U.S. Senate,,DEM,Royce West,0,0,1,1
DeWitt,402,U.S. Senate,,DEM,Adrian Ocegueda,0,0,0,0
DeWitt,402,U.S. Senate,,DEM,D.R. Hunter,2,0,0,2
DeWitt,402,U.S. Senate,,DEM,Michael Cooper,0,1,0,1
DeWitt,402,U.S. Senate,,DEM,Chris Bell,0,0,2,2
DeWitt,402,U.S. Senate,,DEM,Cristina Tzintzun Ramirez,0,0,0,0
DeWitt,402,U.S. Senate,,DEM,Sema Hernandez,0,1,2,3
DeWitt,402,U.S. Senate,,DEM,Jack Daniel Foster Jr,0,0,0,0
DeWitt,402,U.S. Senate,,DEM,"Mary ""MJ"" Hegar",3,3,1,7
DeWitt,402,Ballots Cast,,DEM,,10,9,8,27
DeWitt,402,U.S. Senate,,DEM,Under Votes,5,0,2,7
DeWitt,402,U.S. Senate,,DEM,Over Votes,0,0,0,0
DeWitt,402,U.S. House,34,DEM,Diego Zavala,1,2,2,5
DeWitt,402,U.S. House,34,DEM,Osbert Haro,1,1,3,5
DeWitt,402,U.S. House,34,DEM,Filemon B. Vela,8,6,4,18
DeWitt,402,Ballots Cast,,DEM,,10,9,9,28
DeWitt,402,U.S. House,34,DEM,Under Votes,5,0,1,6
DeWitt,402,U.S. House,34,DEM,Over Votes,0,0,0,0
DeWitt,402,Railroad Commissioner,,DEM,Chrysta Castañeda,3,2,2,7
DeWitt,402,Railroad Commissioner,,DEM,Kelly Stone,1,0,4,5
DeWitt,402,Railroad Commissioner,,DEM,Mark Watson,6,2,3,11
DeWitt,402,Railroad Commissioner,,DEM,"Roberto R. ""Beto"" Alonzo",2,3,0,5
DeWitt,402,Ballots Cast,,DEM,,12,7,9,28
DeWitt,402,Railroad Commissioner,,DEM,Under Votes,3,2,1,6
DeWitt,402,Railroad Commissioner,,DEM,Over Votes,0,0,0,0
DeWitt,402,"Chief Justice, Supreme Court",,DEM,Jerry Zimmerer,1,2,2,5
DeWitt,402,"Chief Justice, Supreme Court",,DEM,Amy Clark Meachum,9,5,7,21
DeWitt,402,Ballots Cast,,DEM,,10,7,9,26
DeWitt,402,"Chief Justice, Supreme Court",,DEM,Under Votes,5,2,1,8
DeWitt,402,"Chief Justice, Supreme Court",,DEM,Over Votes,0,0,0,0
DeWitt,402,"Justice, Supreme Court, Place 6 Unexpired Term",,DEM,Larry Praeger,5,3,3,11
DeWitt,402,"Justice, Supreme Court, Place 6 Unexpired Term",,DEM,Kathy Cheng,6,6,5,17
DeWitt,402,Ballots Cast,,DEM,,11,9,8,28
DeWitt,402,"Justice, Supreme Court, Place 6 Unexpired Term",,DEM,Under Votes,4,0,2,6
DeWitt,402,"Justice, Supreme Court, Place 6 Unexpired Term",,DEM,Over Votes,0,0,0,0
DeWitt,402,"Justice, Supreme Court, Place 7",,DEM,Staci Williams,8,3,7,18
DeWitt,402,"Justice, Supreme Court, Place 7",,DEM,Brandy Voss,3,4,1,8
DeWitt,402,Ballots Cast,,DEM,,11,7,8,26
DeWitt,402,"Justice, Supreme Court, Place 7",,DEM,Under Votes,4,2,2,8
DeWitt,402,"Justice, Supreme Court, Place 7",,DEM,Over Votes,0,0,0,0
DeWitt,402,"Justice, Supreme Court, Place 8",,DEM,Peter Kelly,7,4,5,16
DeWitt,402,"Justice, Supreme Court, Place 8",,DEM,Gisela D. Triana,3,3,3,9
DeWitt,402,Ballots Cast,,DEM,,10,7,8,25
DeWitt,402,"Justice, Supreme Court, Place 8",,DEM,Under Votes,5,2,2,9
DeWitt,402,"Justice, Supreme Court, Place 8",,DEM,Over Votes,0,0,0,0
DeWitt,402,"Judge, Court of Criminal Appeals, Place 3",,DEM,Dan Wood,4,1,1,6
DeWitt,402,"Judge, Court of Criminal Appeals, Place 3",,DEM,William Pieratt Demond,1,1,1,3
DeWitt,402,"Judge, Court of Criminal Appeals, Place 3",,DEM,Elizabeth Davis Frizell,6,5,6,17
DeWitt,402,Ballots Cast,,DEM,,11,7,8,26
DeWitt,402,"Judge, Court of Criminal Appeals, Place 3",,DEM,Under Votes,4,2,2,8
DeWitt,402,"Judge, Court of Criminal Appeals, Place 3",,DEM,Over Votes,0,0,0,0
DeWitt,402,"Judge, Court of Criminal Appeals, Place 4",,DEM,Steven Miears,7,1,3,11
DeWitt,402,"Judge, Court of Criminal Appeals, Place 4",,DEM,Tina Clinton,4,6,5,15
DeWitt,402,Ballots Cast,,DEM,,11,7,8,26
DeWitt,402,"Judge, Court of Criminal Appeals, Place 4",,DEM,Under Votes,4,2,2,8
DeWitt,402,"Judge, Court of Criminal Appeals, Place 4",,DEM,Over Votes,0,0,0,0
DeWitt,402,"Judge, Court of Criminal Appeals, Place 9",,DEM,Brandon Birmingham,11,9,7,27
DeWitt,402,Ballots Cast,,DEM,,11,9,7,27
DeWitt,402,"Judge, Court of Criminal Appeals, Place 9",,DEM,Under Votes,4,0,3,7
DeWitt,402,"Judge, Court of Criminal Appeals, Place 9",,DEM,Over Votes,0,0,0,0
DeWitt,402,State Senate,18,DEM,Michael Antalan,11,9,6,26
DeWitt,402,Ballots Cast,,DEM,,11,9,6,26
DeWitt,402,State Senate,18,DEM,Under Votes,4,0,4,8
DeWitt,402,State Senate,18,DEM,Over Votes,0,0,0,0
DeWitt,402,County Chairman,,DEM,Jospeh L. Sheppard,11,9,6,26
DeWitt,402,Ballots Cast,,DEM,,11,9,6,26
DeWitt,402,County Chairman,,DEM,Under Votes,4,0,4,8
DeWitt,402,County Chairman,,DEM,Over Votes,0,0,0,0
DeWitt,402,President,,REP,Zoltan G. Istvan,0,0,0,0
DeWitt,402,President,,REP,Donald J. Trump,182,29,147,358
DeWitt,402,President,,REP,Bill Weld,1,0,0,1
DeWitt,402,President,,REP,Joe Walsh,1,0,0,1
DeWitt,402,President,,REP,"Roque ""Rocky"" De La Fuente Guerra",0,0,0,0
DeWitt,402,President,,REP,Matthew John Matern,0,0,0,0
DeWitt,402,President,,REP,Bob Ely,0,0,0,0
DeWitt,402,President,,REP,Uncommitted,2,2,3,7
DeWitt,402,Ballots Cast,,REP,,186,31,150,367
DeWitt,402,President,,REP,Under Votes,2,0,0,2
DeWitt,402,President,,REP,Over Votes,0,0,0,0
DeWitt,402,U.S. Senate,,REP,Dwayne Stovall,43,8,29,80
DeWitt,402,U.S. Senate,,REP,Mark Yancey,11,0,9,20
DeWitt,402,U.S. Senate,,REP,Virgil Bierschwale,1,0,0,1
DeWitt,402,U.S. Senate,,REP,John Cornyn,115,23,103,241
DeWitt,402,U.S. Senate,,REP,John Anthony Castro,4,0,2,6
DeWitt,402,Ballots Cast,,REP,,174,31,143,348
DeWitt,402,U.S. Senate,,REP,Under Votes,14,0,7,21
DeWitt,402,U.S. Senate,,REP,Over Votes,0,0,0,0
DeWitt,402,U.S. House,34,REP,Rey Gonzalez,81,19,75,175
DeWitt,402,U.S. House,34,REP,Rod Lingsch,84,7,55,146
DeWitt,402,Ballots Cast,,REP,,165,26,130,321
DeWitt,402,U.S. House,34,REP,Under Votes,23,5,20,48
DeWitt,402,U.S. House,34,REP,Over Votes,0,0,0,0
DeWitt,402,Railroad Commissioner,,REP,Ryan Sitton,78,10,53,141
DeWitt,402,Railroad Commissioner,,REP,"James ""Jim"" Wright",88,16,81,185
DeWitt,402,Ballots Cast,,REP,,166,26,134,326
DeWitt,402,Railroad Commissioner,,REP,Under Votes,22,5,16,43
DeWitt,402,Railroad Commissioner,,REP,Over Votes,0,0,0,0
DeWitt,402,"Chief Justice, Supreme Court",,REP,Nathan Hecht,155,28,133,316
DeWitt,402,Ballots Cast,,REP,,155,28,133,316
DeWitt,402,"Chief Justice, Supreme Court",,REP,Under Votes,33,3,17,53
DeWitt,402,"Chief Justice, Supreme Court",,REP,Over Votes,0,0,0,0
DeWitt,402,"Justice, Supreme Court, Place 6 Unexpired Term",,REP,Jane Bland,150,30,130,310
DeWitt,402,Ballots Cast,,REP,,150,30,130,310
DeWitt,402,"Justice, Supreme Court, Place 6 Unexpired Term",,REP,Under Votes,38,1,20,59
DeWitt,402,"Justice, Supreme Court, Place 6 Unexpired Term",,REP,Over Votes,0,0,0,0
DeWitt,402,"Justice, Supreme Court, Place 7",,REP,Jeff Boyd,153,30,133,316
DeWitt,402,Ballots Cast,,REP,,153,30,133,316
DeWitt,402,"Justice, Supreme Court, Place 7",,REP,Under Votes,35,1,17,53
DeWitt,402,"Justice, Supreme Court, Place 7",,REP,Over Votes,0,0,0,0
DeWitt,402,"Justice, Supreme Court, Place 8",,REP,Brett Busby,151,29,130,310
DeWitt,402,Ballots Cast,,REP,,151,29,130,310
DeWitt,402,"Justice, Supreme Court, Place 8",,REP,Under Votes,37,2,20,59
DeWitt,402,"Justice, Supreme Court, Place 8",,REP,Over Votes,0,0,0,0
DeWitt,402,"Judge, Court of Criminal Appeals, Place 3",,REP,Gina Parker,85,13,78,176
DeWitt,402,"Judge, Court of Criminal Appeals, Place 3",,REP,Bert Richardson,75,15,56,146
DeWitt,402,Ballots Cast,,REP,,160,28,134,322
DeWitt,402,"Judge, Court of Criminal Appeals, Place 3",,REP,Under Votes,28,3,16,47
DeWitt,402,"Judge, Court of Criminal Appeals, Place 3",,REP,Over Votes,0,0,0,0
DeWitt,402,"Judge, Court of Criminal Appeals, Place 4",,REP,Kevin Patrick Yeary,150,29,130,309
DeWitt,402,Ballots Cast,,REP,,150,29,130,309
DeWitt,402,"Judge, Court of Criminal Appeals, Place 4",,REP,Under Votes,38,2,20,60
DeWitt,402,"Judge, Court of Criminal Appeals, Place 4",,REP,Over Votes,0,0,0,0
DeWitt,402,"Judge, Court of Criminal Appeals, Place 9",,REP,David Newell,149,29,130,308
DeWitt,402,Ballots Cast,,REP,,149,29,130,308
DeWitt,402,"Judge, Court of Criminal Appeals, Place 9",,REP,Under Votes,39,2,20,61
DeWitt,402,"Judge, Court of Criminal Appeals, Place 9",,REP,Over Votes,0,0,0,0
DeWitt,402,State Senate,18,REP,Lois W. Kolkhorst,160,30,141,331
DeWitt,402,Ballots Cast,,REP,,160,30,141,331
DeWitt,402,State Senate,18,REP,Under Votes,28,1,9,38
DeWitt,402,State Senate,18,REP,Over Votes,0,0,0,0
DeWitt,402,State Representative,30,REP,Geanie W. Morrison,143,29,122,294
DeWitt,402,State Representative,30,REP,Vanessa Hicks-Callaway,32,2,26,60
DeWitt,402,Ballots Cast,,REP,,175,31,148,354
DeWitt,402,State Representative,30,REP,Under Votes,13,0,2,15
DeWitt,402,State Representative,30,REP,Over Votes,0,0,0,0
DeWitt,402,"District Attorney, 24th Judicial District",,REP,"Robert C. ""Rob"" Lassman",165,30,136,331
DeWitt,402,Ballots Cast,,REP,,165,30,136,331
DeWitt,402,"District Attorney, 24th Judicial District",,REP,Under Votes,23,1,14,38
DeWitt,402,"District Attorney, 24th Judicial District",,REP,Over Votes,0,0,0,0
DeWitt,402,County Attorney,,REP,Jay Condie,163,30,134,327
DeWitt,402,Ballots Cast,,REP,,163,30,134,327
DeWitt,402,County Attorney,,REP,Under Votes,25,1,16,42
DeWitt,402,County Attorney,,REP,Over Votes,0,0,0,0
DeWitt,402,Sheriff,,REP,Carl R. Bowen,167,30,138,335
DeWitt,402,Ballots Cast,,REP,,167,30,138,335
DeWitt,402,Sheriff,,REP,Under Votes,21,1,12,34
DeWitt,402,Sheriff,,REP,Over Votes,0,0,0,0
DeWitt,402,County Tax Assessor-Collector,,REP,Ashley D. Mraz,140,24,123,287
DeWitt,402,County Tax Assessor-Collector,,REP,Guy Dolan,39,7,24,70
DeWitt,402,Ballots Cast,,REP,,179,31,147,357
DeWitt,402,County Tax Assessor-Collector,,REP,Under Votes,9,0,3,12
DeWitt,402,County Tax Assessor-Collector,,REP,Over Votes,0,0,0,0
DeWitt,402,"Constable, Precinct 2",,REP,Jefferson Hobbs,103,16,89,208
DeWitt,402,"Constable, Precinct 2",,REP,Jeff Abbott,67,14,52,133
DeWitt,402,Ballots Cast,,REP,,170,30,141,341
DeWitt,402,"Constable, Precinct 2",,REP,Under Votes,18,1,9,28
DeWitt,402,"Constable, Precinct 2",,REP,Over Votes,0,0,0,0
DeWitt,402,County Chairman,,REP,Paul Guidry,158,30,134,322
DeWitt,402,Ballots Cast,,REP,,158,30,134,322
DeWitt,402,County Chairman,,REP,Under Votes,30,1,16,47
DeWitt,402,County Chairman,,REP,Over Votes,0,0,0,0
DeWitt,402,Proposition #1,,DEM,Yes,11,8,10,29
DeWitt,402,Proposition #1,,DEM,No,3,1,0,4
DeWitt,402,Ballots Cast,,DEM,,14,9,10,33
DeWitt,402,Proposition #1,,DEM,Under Votes,1,0,0,1
DeWitt,402,Proposition #1,,DEM,Over Votes,0,0,0,0
DeWitt,402,Proposition #2,,DEM,Yes,12,9,10,31
DeWitt,402,Proposition #2,,DEM,No,2,0,0,2
DeWitt,402,Ballots Cast,,DEM,,14,9,10,33
DeWitt,402,Proposition #2,,DEM,Under Votes,1,0,0,1
DeWitt,402,Proposition #2,,DEM,Over Votes,0,0,0,0
DeWitt,402,Proposition #3,,DEM,Yes,13,8,10,31
DeWitt,402,Proposition #3,,DEM,No,1,1,0,2
DeWitt,402,Ballots Cast,,DEM,,14,9,10,33
DeWitt,402,Proposition #3,,DEM,Under Votes,1,0,0,1
DeWitt,402,Proposition #3,,DEM,Over Votes,0,0,0,0
DeWitt,402,Proposition #4,,DEM,Yes,13,9,10,32
DeWitt,402,Proposition #4,,DEM,No,0,0,0,0
DeWitt,402,Ballots Cast,,DEM,,13,9,10,32
DeWitt,402,Proposition #4,,DEM,Under Votes,2,0,0,2
DeWitt,402,Proposition #4,,DEM,Over Votes,0,0,0,0
DeWitt,402,Proposition #5,,DEM,Yes,13,9,10,32
DeWitt,402,Proposition #5,,DEM,No,0,0,0,0
DeWitt,402,Ballots Cast,,DEM,,13,9,10,32
DeWitt,402,Proposition #5,,DEM,Under Votes,2,0,0,2
DeWitt,402,Proposition #5,,DEM,Over Votes,0,0,0,0
DeWitt,402,Proposition #6,,DEM,Yes,14,9,10,33
DeWitt,402,Proposition #6,,DEM,No,0,0,0,0
DeWitt,402,Ballots Cast,,DEM,,14,9,10,33
DeWitt,402,Proposition #6,,DEM,Under Votes,1,0,0,1
DeWitt,402,Proposition #6,,DEM,Over Votes,0,0,0,0
DeWitt,402,Proposition #7,,DEM,Yes,13,9,10,32
DeWitt,402,Proposition #7,,DEM,No,1,0,0,1
DeWitt,402,Ballots Cast,,DEM,,14,9,10,33
DeWitt,402,Proposition #7,,DEM,Under Votes,1,0,0,1
DeWitt,402,Proposition #7,,DEM,Over Votes,0,0,0,0
DeWitt,402,Proposition #8,,DEM,Yes,12,8,10,30
DeWitt,402,Proposition #8,,DEM,No,1,0,0,1
DeWitt,402,Ballots Cast,,DEM,,13,8,10,31
DeWitt,402,Proposition #8,,DEM,Under Votes,2,0,0,2
DeWitt,402,Proposition #8,,DEM,Over Votes,0,1,0,1
DeWitt,402,Proposition #9,,DEM,Yes,13,9,9,31
DeWitt,402,Proposition #9,,DEM,No,0,0,1,1
DeWitt,402,Ballots Cast,,DEM,,13,9,10,32
DeWitt,402,Proposition #9,,DEM,Under Votes,2,0,0,2
DeWitt,402,Proposition #9,,DEM,Over Votes,0,0,0,0
DeWitt,402,Proposition #10,,DEM,Yes,13,9,10,32
DeWitt,402,Proposition #10,,DEM,No,1,0,0,1
DeWitt,402,Ballots Cast,,DEM,,14,9,10,33
DeWitt,402,Proposition #10,,DEM,Under Votes,1,0,0,1
DeWitt,402,Proposition #10,,DEM,Over Votes,0,0,0,0
DeWitt,402,Proposition #11,,DEM,Yes,12,8,9,29
DeWitt,402,Proposition #11,,DEM,No,0,1,1,2
DeWitt,402,Ballots Cast,,DEM,,12,9,10,31
DeWitt,402,Proposition #11,,DEM,Under Votes,3,0,0,3
DeWitt,402,Proposition #11,,DEM,Over Votes,0,0,0,0
DeWitt,402,Proposition 1,,REP,Yes,161,31,136,328
DeWitt,402,Proposition 1,,REP,No,23,0,13,36
DeWitt,402,Ballots Cast,,REP,,184,31,149,364
DeWitt,402,Proposition 1,,REP,Under Votes,4,0,1,5
DeWitt,402,Proposition 1,,REP,Over Votes,0,0,0,0
DeWitt,402,Proposition 2,,REP,Yes,167,30,132,329
DeWitt,402,Proposition 2,,REP,No,15,1,17,33
DeWitt,402,Ballots Cast,,REP,,182,31,149,362
DeWitt,402,Proposition 2,,REP,Under Votes,6,0,1,7
DeWitt,402,Proposition 2,,REP,Over Votes,0,0,0,0
DeWitt,402,Proposition 3,,REP,Yes,172,30,142,344
DeWitt,402,Proposition 3,,REP,No,7,0,6,13
DeWitt,402,Ballots Cast,,REP,,179,30,148,357
DeWitt,402,Proposition 3,,REP,Under Votes,9,1,2,12
DeWitt,402,Proposition 3,,REP,Over Votes,0,0,0,0
DeWitt,402,Proposition 4,,REP,Yes,178,28,141,347
DeWitt,402,Proposition 4,,REP,No,5,3,5,13
DeWitt,402,Ballots Cast,,REP,,183,31,146,360
DeWitt,402,Proposition 4,,REP,Under Votes,5,0,4,9
DeWitt,402,Proposition 4,,REP,Over Votes,0,0,0,0
DeWitt,402,Proposition 5,,REP,Yes,169,28,138,335
DeWitt,402,Proposition 5,,REP,No,10,3,9,22
DeWitt,402,Ballots Cast,,REP,,179,31,147,357
DeWitt,402,Proposition 5,,REP,Under Votes,9,0,3,12
DeWitt,402,Proposition 5,,REP,Over Votes,0,0,0,0
DeWitt,402,Proposition 6,,REP,Yes,168,31,144,343
DeWitt,402,Proposition 6,,REP,No,6,0,4,10
DeWitt,402,Ballots Cast,,REP,,174,31,148,353
DeWitt,402,Proposition 6,,REP,Under Votes,14,0,2,16
DeWitt,402,Proposition 6,,REP,Over Votes,0,0,0,0
DeWitt,402,Proposition 7,,REP,Yes,178,29,147,354
DeWitt,402,Proposition 7,,REP,No,0,2,1,3
DeWitt,402,Ballots Cast,,REP,,178,31,148,357
DeWitt,402,Proposition 7,,REP,Under Votes,10,0,2,12
DeWitt,402,Proposition 7,,REP,Over Votes,0,0,0,0
DeWitt,402,Proposition 8,,REP,Yes,177,31,149,357
DeWitt,402,Proposition 8,,REP,No,0,0,0,0
DeWitt,402,Ballots Cast,,REP,,177,31,149,357
DeWitt,402,Proposition 8,,REP,Under Votes,11,0,1,12
DeWitt,402,Proposition 8,,REP,Over Votes,0,0,0,0
DeWitt,402,Proposition 9,,REP,Yes,175,31,143,349
DeWitt,402,Proposition 9,,REP,No,7,0,4,11
DeWitt,402,Ballots Cast,,REP,,182,31,147,360
DeWitt,402,Proposition 9,,REP,Under Votes,6,0,3,9
DeWitt,402,Proposition 9,,REP,Over Votes,0,0,0,0
DeWitt,402,Proposition 10,,REP,Yes,162,24,135,321
DeWitt,402,Proposition 10,,REP,No,18,5,8,31
DeWitt,402,Ballots Cast,,REP,,180,29,143,352
DeWitt,402,Proposition 10,,REP,Under Votes,8,2,7,17
DeWitt,402,Proposition 10,,REP,Over Votes,0,0,0,0