county,precinct,office,district,candidate,party,election_day,mail,early_voting,votes
Concho,101,President,,Matthew John Matern,REP,1,0,0,1
Concho,101,President,,Joe Walsh,REP,0,2,1,3
Concho,101,President,,Bill Weld,REP,2,0,1,3
Concho,101,President,,Zoltan G. Istvan,REP,0,0,0,0
Concho,101,President,,Donald J. Trump,REP,75,10,117,202
Concho,101,President,,"Roque ""Rocky"" De La Fuente Guerra",REP,1,1,1,3
Concho,101,President,,Bob Ely,REP,0,0,0,0
Concho,101,President,,Uncommitted,REP,6,1,5,12
Concho,101,President,,Under Votes,REP,0,1,2,3
Concho,101,President,,Over Votes,REP,0,0,0,0
Concho,101,U.S. Senate,,John Cornyn,REP,54,11,78,143
Concho,101,U.S. Senate,,John Anthony Castro,REP,7,1,5,13
Concho,101,U.S. Senate,,Virgil Bierschwale,REP,2,2,1,5
Concho,101,U.S. Senate,,Dwayne Stovall,REP,8,0,20,28
Concho,101,U.S. Senate,,Mark Yancey,REP,2,0,13,15
Concho,101,U.S. Senate,,Under Votes,REP,12,1,10,23
Concho,101,U.S. Senate,,Over Votes,REP,0,0,0,0
Concho,101,U.S. House,11,Ned Luscombe,REP,8,0,12,20
Concho,101,U.S. House,11,Gene Barber,REP,4,0,3,7
Concho,101,U.S. House,11,Robert Tucker,REP,4,0,8,12
Concho,101,U.S. House,11,J. D. Faircloth,REP,6,0,10,16
Concho,101,U.S. House,11,J. Ross Lacy,REP,2,0,4,6
Concho,101,U.S. House,11,Wesley W. Virdell,REP,2,0,7,9
Concho,101,U.S. House,11,Casey Gray,REP,4,0,8,12
Concho,101,U.S. House,11,Jamie Berryhill,REP,2,0,5,7
Concho,101,U.S. House,11,Brandon Batch,REP,6,4,2,12
Concho,101,U.S. House,11,August Pfluger,REP,29,10,58,97
Concho,101,U.S. House,11,Under Votes,REP,18,1,10,29
Concho,101,U.S. House,11,Over Votes,REP,0,0,0,0
Concho,101,Railroad Commissioner,,"James ""Jim"" Wright",REP,48,8,74,130
Concho,101,Railroad Commissioner,,Ryan Sitton,REP,14,4,35,53
Concho,101,Railroad Commissioner,,Under Votes,REP,23,3,18,44
Concho,101,Railroad Commissioner,,Over Votes,REP,0,0,0,0
Concho,101,State Senate,28,Charles Perry,REP,63,11,106,180
Concho,101,State Senate,28,Under Votes,REP,22,4,21,47
Concho,101,State Senate,28,Over Votes,REP,0,0,0,0
Concho,101,State Representative,72,Lynette Lucas,REP,18,3,17,38
Concho,101,State Representative,72,Drew Darby,REP,62,12,104,178
Concho,101,State Representative,72,Under Votes,REP,5,0,6,11
Concho,101,State Representative,72,Over Votes,REP,0,0,0,0
Concho,102,President,,Matthew John Matern,REP,0,0,0,0
Concho,102,President,,Joe Walsh,REP,1,0,0,1
Concho,102,President,,Bill Weld,REP,0,0,0,0
Concho,102,President,,Zoltan G. Istvan,REP,0,0,0,0
Concho,102,President,,Donald J. Trump,REP,27,3,13,43
Concho,102,President,,"Roque ""Rocky"" De La Fuente Guerra",REP,2,0,0,2
Concho,102,President,,Bob Ely,REP,0,0,1,1
Concho,102,President,,Uncommitted,REP,1,0,1,2
Concho,102,President,,Under Votes,REP,0,0,0,0
Concho,102,President,,Over Votes,REP,0,0,0,0
Concho,102,U.S. Senate,,John Cornyn,REP,16,3,8,27
Concho,102,U.S. Senate,,John Anthony Castro,REP,3,0,0,3
Concho,102,U.S. Senate,,Virgil Bierschwale,REP,1,0,0,1
Concho,102,U.S. Senate,,Dwayne Stovall,REP,4,0,5,9
Concho,102,U.S. Senate,,Mark Yancey,REP,2,0,0,2
Concho,102,U.S. Senate,,Under Votes,REP,5,0,2,7
Concho,102,U.S. Senate,,Over Votes,REP,0,0,0,0
Concho,102,U.S. House,11,Ned Luscombe,REP,0,0,1,1
Concho,102,U.S. House,11,Gene Barber,REP,0,0,0,0
Concho,102,U.S. House,11,Robert Tucker,REP,3,0,0,3
Concho,102,U.S. House,11,J. D. Faircloth,REP,1,0,0,1
Concho,102,U.S. House,11,J. Ross Lacy,REP,1,0,0,1
Concho,102,U.S. House,11,Wesley W. Virdell,REP,2,1,4,7
Concho,102,U.S. House,11,Casey Gray,REP,1,0,0,1
Concho,102,U.S. House,11,Jamie Berryhill,REP,0,0,0,0
Concho,102,U.S. House,11,Brandon Batch,REP,0,0,1,1
Concho,102,U.S. House,11,August Pfluger,REP,19,2,8,29
Concho,102,U.S. House,11,Under Votes,REP,4,0,1,5
Concho,102,U.S. House,11,Over Votes,REP,0,0,0,0
Concho,102,Railroad Commissioner,,"James ""Jim"" Wright",REP,15,2,6,23
Concho,102,Railroad Commissioner,,Ryan Sitton,REP,10,0,6,16
Concho,102,Railroad Commissioner,,Under Votes,REP,6,1,3,10
Concho,102,Railroad Commissioner,,Over Votes,REP,0,0,0,0
Concho,102,State Senate,28,Charles Perry,REP,24,3,13,40
Concho,102,State Senate,28,Under Votes,REP,7,0,2,9
Concho,102,State Senate,28,Over Votes,REP,0,0,0,0
Concho,102,State Representative,72,Lynette Lucas,REP,2,0,0,2
Concho,102,State Representative,72,Drew Darby,REP,22,3,14,39
Concho,102,State Representative,72,Under Votes,REP,7,0,1,8
Concho,102,State Representative,72,Over Votes,REP,0,0,0,0
Concho,203,President,,Matthew John Matern,REP,0,0,0,0
Concho,203,President,,Joe Walsh,REP,0,0,0,0
Concho,203,President,,Bill Weld,REP,0,0,0,0
Concho,203,President,,Zoltan G. Istvan,REP,0,0,0,0
Concho,203,President,,Donald J. Trump,REP,43,12,15,70
Concho,203,President,,"Roque ""Rocky"" De La Fuente Guerra",REP,0,0,0,0
Concho,203,President,,Bob Ely,REP,0,0,0,0
Concho,203,President,,Uncommitted,REP,0,0,4,4
Concho,203,President,,Under Votes,REP,0,2,0,2
Concho,203,President,,Over Votes,REP,0,0,0,0
Concho,203,U.S. Senate,,John Cornyn,REP,36,12,14,62
Concho,203,U.S. Senate,,John Anthony Castro,REP,0,0,0,0
Concho,203,U.S. Senate,,Virgil Bierschwale,REP,0,0,0,0
Concho,203,U.S. Senate,,Dwayne Stovall,REP,2,0,3,5
Concho,203,U.S. Senate,,Mark Yancey,REP,1,0,1,2
Concho,203,U.S. Senate,,Under Votes,REP,4,2,1,7
Concho,203,U.S. Senate,,Over Votes,REP,0,0,0,0
Concho,203,U.S. House,11,Ned Luscombe,REP,7,0,0,7
Concho,203,U.S. House,11,Gene Barber,REP,0,0,0,0
Concho,203,U.S. House,11,Robert Tucker,REP,0,0,3,3
Concho,203,U.S. House,11,J. D. Faircloth,REP,1,0,2,3
Concho,203,U.S. House,11,J. Ross Lacy,REP,4,0,0,4
Concho,203,U.S. House,11,Wesley W. Virdell,REP,2,0,1,3
Concho,203,U.S. House,11,Casey Gray,REP,1,1,0,2
Concho,203,U.S. House,11,Jamie Berryhill,REP,0,0,0,0
Concho,203,U.S. House,11,Brandon Batch,REP,1,0,0,1
Concho,203,U.S. House,11,August Pfluger,REP,19,12,13,44
Concho,203,U.S. House,11,Under Votes,REP,8,1,0,9
Concho,203,U.S. House,11,Over Votes,REP,0,0,0,0
Concho,203,Railroad Commissioner,,"James ""Jim"" Wright",REP,18,10,11,39
Concho,203,Railroad Commissioner,,Ryan Sitton,REP,17,1,6,24
Concho,203,Railroad Commissioner,,Under Votes,REP,8,3,2,13
Concho,203,Railroad Commissioner,,Over Votes,REP,0,0,0,0
Concho,203,State Senate,28,Charles Perry,REP,36,10,18,64
Concho,203,State Senate,28,Under Votes,REP,7,4,1,12
Concho,203,State Senate,28,Over Votes,REP,0,0,0,0
Concho,203,State Representative,72,Lynette Lucas,REP,2,3,2,7
Concho,203,State Representative,72,Drew Darby,REP,41,9,17,67
Concho,203,State Representative,72,Under Votes,REP,0,2,0,2
Concho,203,State Representative,72,Over Votes,REP,0,0,0,0
Concho,204,President,,Matthew John Matern,REP,1,0,0,1
Concho,204,President,,Joe Walsh,REP,2,0,0,2
Concho,204,President,,Bill Weld,REP,0,0,0,0
Concho,204,President,,Zoltan G. Istvan,REP,0,0,0,0
Concho,204,President,,Donald J. Trump,REP,32,2,5,39
Concho,204,President,,"Roque ""Rocky"" De La Fuente Guerra",REP,1,0,0,1
Concho,204,President,,Bob Ely,REP,0,0,0,0
Concho,204,President,,Uncommitted,REP,7,0,0,7
Concho,204,President,,Under Votes,REP,0,0,0,0
Concho,204,President,,Over Votes,REP,0,0,0,0
Concho,204,U.S. Senate,,John Cornyn,REP,28,2,5,35
Concho,204,U.S. Senate,,John Anthony Castro,REP,5,0,0,5
Concho,204,U.S. Senate,,Virgil Bierschwale,REP,2,0,0,2
Concho,204,U.S. Senate,,Dwayne Stovall,REP,0,0,0,0
Concho,204,U.S. Senate,,Mark Yancey,REP,3,0,0,3
Concho,204,U.S. Senate,,Under Votes,REP,5,0,0,5
Concho,204,U.S. Senate,,Over Votes,REP,0,0,0,0
Concho,204,U.S. House,11,Ned Luscombe,REP,4,0,0,4
Concho,204,U.S. House,11,Gene Barber,REP,0,0,0,0
Concho,204,U.S. House,11,Robert Tucker,REP,1,0,1,2
Concho,204,U.S. House,11,J. D. Faircloth,REP,2,0,0,2
Concho,204,U.S. House,11,J. Ross Lacy,REP,1,0,0,1
Concho,204,U.S. House,11,Wesley W. Virdell,REP,0,0,0,0
Concho,204,U.S. House,11,Casey Gray,REP,1,0,0,1
Concho,204,U.S. House,11,Jamie Berryhill,REP,0,0,0,0
Concho,204,U.S. House,11,Brandon Batch,REP,0,1,0,1
Concho,204,U.S. House,11,August Pfluger,REP,27,1,3,31
Concho,204,U.S. House,11,Under Votes,REP,7,0,1,8
Concho,204,U.S. House,11,Over Votes,REP,0,0,0,0
Concho,204,Railroad Commissioner,,"James ""Jim"" Wright",REP,24,1,3,28
Concho,204,Railroad Commissioner,,Ryan Sitton,REP,7,0,1,8
Concho,204,Railroad Commissioner,,Under Votes,REP,12,1,1,14
Concho,204,Railroad Commissioner,,Over Votes,REP,0,0,0,0
Concho,204,State Senate,28,Charles Perry,REP,31,1,5,37
Concho,204,State Senate,28,Under Votes,REP,12,1,0,13
Concho,204,State Senate,28,Over Votes,REP,0,0,0,0
Concho,204,State Representative,72,Lynette Lucas,REP,5,0,1,6
Concho,204,State Representative,72,Drew Darby,REP,36,2,4,42
Concho,204,State Representative,72,Under Votes,REP,2,0,0,2
Concho,204,State Representative,72,Over Votes,REP,0,0,0,0
Concho,205,President,,Matthew John Matern,REP,0,0,0,0
Concho,205,President,,Joe Walsh,REP,0,0,1,1
Concho,205,President,,Bill Weld,REP,0,0,0,0
Concho,205,President,,Zoltan G. Istvan,REP,0,0,0,0
Concho,205,President,,Donald J. Trump,REP,41,5,11,57
Concho,205,President,,"Roque ""Rocky"" De La Fuente Guerra",REP,3,0,0,3
Concho,205,President,,Bob Ely,REP,0,0,0,0
Concho,205,President,,Uncommitted,REP,5,1,1,7
Concho,205,President,,Under Votes,REP,1,0,1,2
Concho,205,President,,Over Votes,REP,0,1,0,1
Concho,205,U.S. Senate,,John Cornyn,REP,32,5,7,44
Concho,205,U.S. Senate,,John Anthony Castro,REP,7,0,0,7
Concho,205,U.S. Senate,,Virgil Bierschwale,REP,1,0,1,2
Concho,205,U.S. Senate,,Dwayne Stovall,REP,6,0,5,11
Concho,205,U.S. Senate,,Mark Yancey,REP,2,0,0,2
Concho,205,U.S. Senate,,Under Votes,REP,2,2,1,5
Concho,205,U.S. Senate,,Over Votes,REP,0,0,0,0
Concho,205,U.S. House,11,Ned Luscombe,REP,6,0,0,6
Concho,205,U.S. House,11,Gene Barber,REP,2,0,1,3
Concho,205,U.S. House,11,Robert Tucker,REP,4,0,0,4
Concho,205,U.S. House,11,J. D. Faircloth,REP,2,0,0,2
Concho,205,U.S. House,11,J. Ross Lacy,REP,1,0,1,2
Concho,205,U.S. House,11,Wesley W. Virdell,REP,2,0,4,6
Concho,205,U.S. House,11,Casey Gray,REP,0,0,0,0
Concho,205,U.S. House,11,Jamie Berryhill,REP,0,0,0,0
Concho,205,U.S. House,11,Brandon Batch,REP,0,0,0,0
Concho,205,U.S. House,11,August Pfluger,REP,29,7,7,43
Concho,205,U.S. House,11,Under Votes,REP,4,0,1,5
Concho,205,U.S. House,11,Over Votes,REP,0,0,0,0
Concho,205,Railroad Commissioner,,"James ""Jim"" Wright",REP,31,3,4,38
Concho,205,Railroad Commissioner,,Ryan Sitton,REP,9,2,4,15
Concho,205,Railroad Commissioner,,Under Votes,REP,10,2,6,18
Concho,205,Railroad Commissioner,,Over Votes,REP,0,0,0,0
Concho,205,State Senate,28,Charles Perry,REP,41,4,9,54
Concho,205,State Senate,28,Under Votes,REP,9,3,5,17
Concho,205,State Senate,28,Over Votes,REP,0,0,0,0
Concho,205,State Representative,72,Lynette Lucas,REP,9,0,4,13
Concho,205,State Representative,72,Drew Darby,REP,39,7,8,54
Concho,205,State Representative,72,Under Votes,REP,2,0,2,4
Concho,205,State Representative,72,Over Votes,REP,0,0,0,0
Concho,306,President,,Matthew John Matern,REP,2,0,0,2
Concho,306,President,,Joe Walsh,REP,2,0,0,2
Concho,306,President,,Bill Weld,REP,1,0,0,1
Concho,306,President,,Zoltan G. Istvan,REP,1,0,0,1
Concho,306,President,,Donald J. Trump,REP,96,17,27,140
Concho,306,President,,"Roque ""Rocky"" De La Fuente Guerra",REP,6,2,0,8
Concho,306,President,,Bob Ely,REP,0,0,0,0
Concho,306,President,,Uncommitted,REP,16,5,0,21
Concho,306,President,,Under Votes,REP,3,0,0,3
Concho,306,President,,Over Votes,REP,0,0,0,0
Concho,306,U.S. Senate,,John Cornyn,REP,59,18,17,94
Concho,306,U.S. Senate,,John Anthony Castro,REP,26,3,1,30
Concho,306,U.S. Senate,,Virgil Bierschwale,REP,1,0,2,3
Concho,306,U.S. Senate,,Dwayne Stovall,REP,16,3,5,24
Concho,306,U.S. Senate,,Mark Yancey,REP,7,0,1,8
Concho,306,U.S. Senate,,Under Votes,REP,18,0,1,19
Concho,306,U.S. Senate,,Over Votes,REP,0,0,0,0
Concho,306,U.S. House,11,Ned Luscombe,REP,8,0,0,8
Concho,306,U.S. House,11,Gene Barber,REP,6,0,0,6
Concho,306,U.S. House,11,Robert Tucker,REP,9,0,0,9
Concho,306,U.S. House,11,J. D. Faircloth,REP,5,0,3,8
Concho,306,U.S. House,11,J. Ross Lacy,REP,2,0,1,3
Concho,306,U.S. House,11,Wesley W. Virdell,REP,12,0,3,15
Concho,306,U.S. House,11,Casey Gray,REP,5,0,1,6
Concho,306,U.S. House,11,Jamie Berryhill,REP,0,0,0,0
Concho,306,U.S. House,11,Brandon Batch,REP,5,1,4,10
Concho,306,U.S. House,11,August Pfluger,REP,55,22,15,92
Concho,306,U.S. House,11,Under Votes,REP,20,1,0,21
Concho,306,U.S. House,11,Over Votes,REP,0,0,0,0
Concho,306,Railroad Commissioner,,"James ""Jim"" Wright",REP,71,11,27,109
Concho,306,Railroad Commissioner,,Ryan Sitton,REP,27,5,0,32
Concho,306,Railroad Commissioner,,Under Votes,REP,29,8,0,37
Concho,306,Railroad Commissioner,,Over Votes,REP,0,0,0,0
Concho,306,State Senate,28,Charles Perry,REP,98,15,25,138
Concho,306,State Senate,28,Under Votes,REP,29,9,2,40
Concho,306,State Senate,28,Over Votes,REP,0,0,0,0
Concho,306,State Representative,72,Lynette Lucas,REP,23,0,2,25
Concho,306,State Representative,72,Drew Darby,REP,93,22,24,139
Concho,306,State Representative,72,Under Votes,REP,11,2,1,14
Concho,306,State Representative,72,Over Votes,REP,0,0,0,0
Concho,407,President,,Matthew John Matern,REP,0,0,0,0
Concho,407,President,,Joe Walsh,REP,0,0,0,0
Concho,407,President,,Bill Weld,REP,0,0,0,0
Concho,407,President,,Zoltan G. Istvan,REP,0,0,0,0
Concho,407,President,,Donald J. Trump,REP,34,6,6,46
Concho,407,President,,"Roque ""Rocky"" De La Fuente Guerra",REP,0,0,0,0
Concho,407,President,,Bob Ely,REP,0,0,0,0
Concho,407,President,,Uncommitted,REP,0,0,0,0
Concho,407,President,,Under Votes,REP,0,0,0,0
Concho,407,President,,Over Votes,REP,0,0,0,0
Concho,407,U.S. Senate,,John Cornyn,REP,26,5,5,36
Concho,407,U.S. Senate,,John Anthony Castro,REP,0,0,0,0
Concho,407,U.S. Senate,,Virgil Bierschwale,REP,0,0,0,0
Concho,407,U.S. Senate,,Dwayne Stovall,REP,6,1,0,7
Concho,407,U.S. Senate,,Mark Yancey,REP,0,0,0,0
Concho,407,U.S. Senate,,Under Votes,REP,2,0,1,3
Concho,407,U.S. Senate,,Over Votes,REP,0,0,0,0
Concho,407,U.S. House,11,Ned Luscombe,REP,1,0,0,1
Concho,407,U.S. House,11,Gene Barber,REP,1,0,0,1
Concho,407,U.S. House,11,Robert Tucker,REP,0,0,0,0
Concho,407,U.S. House,11,J. D. Faircloth,REP,1,0,1,2
Concho,407,U.S. House,11,J. Ross Lacy,REP,0,0,0,0
Concho,407,U.S. House,11,Wesley W. Virdell,REP,6,0,0,6
Concho,407,U.S. House,11,Casey Gray,REP,1,0,0,1
Concho,407,U.S. House,11,Jamie Berryhill,REP,0,0,0,0
Concho,407,U.S. House,11,Brandon Batch,REP,1,0,0,1
Concho,407,U.S. House,11,August Pfluger,REP,18,6,4,28
Concho,407,U.S. House,11,Under Votes,REP,5,0,1,6
Concho,407,U.S. House,11,Over Votes,REP,0,0,0,0
Concho,407,Railroad Commissioner,,"James ""Jim"" Wright",REP,19,2,3,24
Concho,407,Railroad Commissioner,,Ryan Sitton,REP,6,2,1,9
Concho,407,Railroad Commissioner,,Under Votes,REP,9,2,2,13
Concho,407,Railroad Commissioner,,Over Votes,REP,0,0,0,0
Concho,407,State Senate,28,Charles Perry,REP,29,6,5,40
Concho,407,State Senate,28,Under Votes,REP,5,0,1,6
Concho,407,State Senate,28,Over Votes,REP,0,0,0,0
Concho,407,State Representative,72,Lynette Lucas,REP,4,1,1,6
Concho,407,State Representative,72,Drew Darby,REP,28,5,5,38
Concho,407,State Representative,72,Under Votes,REP,2,0,0,2
Concho,407,State Representative,72,Over Votes,REP,0,0,0,0
Concho,408,President,,Matthew John Matern,REP,1,0,0,1
Concho,408,President,,Joe Walsh,REP,1,0,0,1
Concho,408,President,,Bill Weld,REP,0,0,1,1
Concho,408,President,,Zoltan G. Istvan,REP,0,0,0,0
Concho,408,President,,Donald J. Trump,REP,83,13,16,112
Concho,408,President,,"Roque ""Rocky"" De La Fuente Guerra",REP,1,0,0,1
Concho,408,President,,Bob Ely,REP,0,0,0,0
Concho,408,President,,Uncommitted,REP,8,0,1,9
Concho,408,President,,Under Votes,REP,1,0,1,2
Concho,408,President,,Over Votes,REP,0,0,0,0
Concho,408,U.S. Senate,,John Cornyn,REP,63,13,15,91
Concho,408,U.S. Senate,,John Anthony Castro,REP,6,0,1,7
Concho,408,U.S. Senate,,Virgil Bierschwale,REP,2,0,0,2
Concho,408,U.S. Senate,,Dwayne Stovall,REP,8,0,0,8
Concho,408,U.S. Senate,,Mark Yancey,REP,2,0,2,4
Concho,408,U.S. Senate,,Under Votes,REP,14,0,1,15
Concho,408,U.S. Senate,,Over Votes,REP,0,0,0,0
Concho,408,U.S. House,11,Ned Luscombe,REP,5,0,0,5
Concho,408,U.S. House,11,Gene Barber,REP,3,0,0,3
Concho,408,U.S. House,11,Robert Tucker,REP,3,0,0,3
Concho,408,U.S. House,11,J. D. Faircloth,REP,5,0,1,6
Concho,408,U.S. House,11,J. Ross Lacy,REP,1,0,1,2
Concho,408,U.S. House,11,Wesley W. Virdell,REP,17,1,1,19
Concho,408,U.S. House,11,Casey Gray,REP,3,0,0,3
Concho,408,U.S. House,11,Jamie Berryhill,REP,0,0,0,0
Concho,408,U.S. House,11,Brandon Batch,REP,5,0,0,5
Concho,408,U.S. House,11,August Pfluger,REP,43,12,15,70
Concho,408,U.S. House,11,Under Votes,REP,10,0,1,11
Concho,408,U.S. House,11,Over Votes,REP,0,0,0,0
Concho,408,Railroad Commissioner,,"James ""Jim"" Wright",REP,56,9,11,76
Concho,408,Railroad Commissioner,,Ryan Sitton,REP,19,4,3,26
Concho,408,Railroad Commissioner,,Under Votes,REP,20,0,5,25
Concho,408,Railroad Commissioner,,Over Votes,REP,0,0,0,0
Concho,408,State Senate,28,Charles Perry,REP,80,12,17,109
Concho,408,State Senate,28,Under Votes,REP,15,1,2,18
Concho,408,State Senate,28,Over Votes,REP,0,0,0,0
Concho,408,State Representative,72,Lynette Lucas,REP,10,0,2,12
Concho,408,State Representative,72,Drew Darby,REP,76,13,16,105
Concho,408,State Representative,72,Under Votes,REP,9,0,1,10
Concho,408,State Representative,72,Over Votes,REP,0,0,0,0
Concho,101,President,,Michael R. Bloomberg,DEM,0,0,0,0
Concho,101,President,,Bernie Sanders,DEM,1,1,4,6
Concho,101,President,,Michael Bennet,DEM,0,0,0,0
Concho,101,President,,Elizabeth Warren,DEM,1,0,0,1
Concho,101,President,,John K. Delaney,DEM,0,0,0,0
Concho,101,President,,Deval Patrick,DEM,0,0,0,0
Concho,101,President,,Amy Klobuchar,DEM,0,0,0,0
Concho,101,President,,Marianne Williamson,DEM,0,0,0,0
Concho,101,President,,Andrew Yang,DEM,0,0,0,0
Concho,101,President,,Julian Castro,DEM,0,0,0,0
Concho,101,President,,Tom Steyer,DEM,0,0,0,0
Concho,101,President,,Joseph R. Biden,DEM,2,1,3,6
Concho,101,President,,Robby Wells,DEM,0,0,0,0
Concho,101,President,,Tulsi Gabbard,DEM,0,0,0,0
Concho,101,President,,Pete Buttigieg,DEM,0,0,2,2
Concho,101,President,,Cory Booker,DEM,0,0,0,0
Concho,101,President,,"Roque ""Rocky"" De La Fuente",DEM,0,0,0,0
Concho,101,President,,Under Votes,DEM,0,0,0,0
Concho,101,President,,Over Votes,DEM,0,0,0,0
Concho,101,U.S. Senate,,Royce West,DEM,0,0,1,1
Concho,101,U.S. Senate,,Sema Hernandez,DEM,0,0,0,0
Concho,101,U.S. Senate,,Cristina Tzintzun Ramirez,DEM,1,0,3,4
Concho,101,U.S. Senate,,"Annie ""Mama"" Garcia",DEM,1,0,1,2
Concho,101,U.S. Senate,,D. R. Hunter,DEM,0,1,0,1
Concho,101,U.S. Senate,,Adrian Ocegueda,DEM,0,0,0,0
Concho,101,U.S. Senate,,Amanda K. Edwards,DEM,0,0,1,1
Concho,101,U.S. Senate,,Michael Cooper,DEM,1,0,1,2
Concho,101,U.S. Senate,,Victor Hugo Harris,DEM,0,0,0,0
Concho,101,U.S. Senate,,"Mary ""MJ"" Hegar",DEM,0,0,2,2
Concho,101,U.S. Senate,,Jack Daniel Foster Jr,DEM,0,0,0,0
Concho,101,U.S. Senate,,Chris Bell,DEM,0,0,0,0
Concho,101,U.S. Senate,,Under Votes,DEM,1,1,0,2
Concho,101,U.S. Senate,,Over Votes,DEM,0,0,0,0
Concho,101,U.S. House,11,Jon Mark Hogg,DEM,3,0,9,12
Concho,101,U.S. House,11,Under Votes,DEM,1,2,0,3
Concho,101,U.S. House,11,Over Votes,DEM,0,0,0,0
Concho,101,Railroad Commissioner,,"Roberto R. ""Beto"" Alonzo",DEM,1,0,3,4
Concho,101,Railroad Commissioner,,Kelly Stone,DEM,0,1,2,3
Concho,101,Railroad Commissioner,,Chrysta Castaneda,DEM,0,0,1,1
Concho,101,Railroad Commissioner,,Mark Watson,DEM,2,0,2,4
Concho,101,Railroad Commissioner,,Under Votes,DEM,1,1,1,3
Concho,101,Railroad Commissioner,,Over Votes,DEM,0,0,0,0
Concho,102,President,,Michael R. Bloomberg,DEM,0,1,0,1
Concho,102,President,,Bernie Sanders,DEM,0,0,0,0
Concho,102,President,,Michael Bennet,DEM,0,0,0,0
Concho,102,President,,Elizabeth Warren,DEM,0,0,0,0
Concho,102,President,,John K. Delaney,DEM,0,0,0,0
Concho,102,President,,Deval Patrick,DEM,0,0,0,0
Concho,102,President,,Amy Klobuchar,DEM,0,0,0,0
Concho,102,President,,Marianne Williamson,DEM,0,0,0,0
Concho,102,President,,Andrew Yang,DEM,0,0,0,0
Concho,102,President,,Julian Castro,DEM,0,0,0,0
Concho,102,President,,Tom Steyer,DEM,0,0,0,0
Concho,102,President,,Joseph R. Biden,DEM,3,0,0,3
Concho,102,President,,Robby Wells,DEM,0,0,0,0
Concho,102,President,,Tulsi Gabbard,DEM,0,0,0,0
Concho,102,President,,Pete Buttigieg,DEM,0,0,0,0
Concho,102,President,,Cory Booker,DEM,0,0,0,0
Concho,102,President,,"Roque ""Rocky"" De La Fuente",DEM,0,0,0,0
Concho,102,President,,Under Votes,DEM,0,0,0,0
Concho,102,President,,Over Votes,DEM,0,0,0,0
Concho,102,U.S. Senate,,Royce West,DEM,0,0,0,0
Concho,102,U.S. Senate,,Sema Hernandez,DEM,1,0,0,1
Concho,102,U.S. Senate,,Cristina Tzintzun Ramirez,DEM,0,0,0,0
Concho,102,U.S. Senate,,"Annie ""Mama"" Garcia",DEM,1,0,0,1
Concho,102,U.S. Senate,,D. R. Hunter,DEM,0,0,0,0
Concho,102,U.S. Senate,,Adrian Ocegueda,DEM,0,0,0,0
Concho,102,U.S. Senate,,Amanda K. Edwards,DEM,0,0,0,0
Concho,102,U.S. Senate,,Michael Cooper,DEM,0,0,0,0
Concho,102,U.S. Senate,,Victor Hugo Harris,DEM,0,1,0,1
Concho,102,U.S. Senate,,"Mary ""MJ"" Hegar",DEM,0,0,0,0
Concho,102,U.S. Senate,,Jack Daniel Foster Jr,DEM,0,0,0,0
Concho,102,U.S. Senate,,Chris Bell,DEM,0,0,0,0
Concho,102,U.S. Senate,,Under Votes,DEM,1,0,0,1
Concho,102,U.S. Senate,,Over Votes,DEM,0,0,0,0
Concho,102,U.S. House,11,Jon Mark Hogg,DEM,1,1,0,2
Concho,102,U.S. House,11,Under Votes,DEM,2,0,0,2
Concho,102,U.S. House,11,Over Votes,DEM,0,0,0,0
Concho,102,Railroad Commissioner,,"Roberto R. ""Beto"" Alonzo",DEM,1,1,0,2
Concho,102,Railroad Commissioner,,Kelly Stone,DEM,0,0,0,0
Concho,102,Railroad Commissioner,,Chrysta Castaneda,DEM,1,0,0,1
Concho,102,Railroad Commissioner,,Mark Watson,DEM,0,0,0,0
Concho,102,Railroad Commissioner,,Under Votes,DEM,1,0,0,1
Concho,102,Railroad Commissioner,,Over Votes,DEM,0,0,0,0
Concho,203,President,,Michael R. Bloomberg,DEM,0,0,0,0
Concho,203,President,,Bernie Sanders,DEM,0,0,1,1
Concho,203,President,,Michael Bennet,DEM,0,0,0,0
Concho,203,President,,Elizabeth Warren,DEM,0,0,0,0
Concho,203,President,,John K. Delaney,DEM,0,0,0,0
Concho,203,President,,Deval Patrick,DEM,0,0,0,0
Concho,203,President,,Amy Klobuchar,DEM,0,0,0,0
Concho,203,President,,Marianne Williamson,DEM,0,0,0,0
Concho,203,President,,Andrew Yang,DEM,0,0,0,0
Concho,203,President,,Julian Castro,DEM,0,0,0,0
Concho,203,President,,Tom Steyer,DEM,0,0,0,0
Concho,203,President,,Joseph R. Biden,DEM,0,0,1,1
Concho,203,President,,Robby Wells,DEM,0,0,0,0
Concho,203,President,,Tulsi Gabbard,DEM,0,0,0,0
Concho,203,President,,Pete Buttigieg,DEM,0,0,0,0
Concho,203,President,,Cory Booker,DEM,0,0,0,0
Concho,203,President,,"Roque ""Rocky"" De La Fuente",DEM,0,0,0,0
Concho,203,President,,Under Votes,DEM,0,0,0,0
Concho,203,President,,Over Votes,DEM,0,0,0,0
Concho,203,U.S. Senate,,Royce West,DEM,0,0,0,0
Concho,203,U.S. Senate,,Sema Hernandez,DEM,0,0,0,0
Concho,203,U.S. Senate,,Cristina Tzintzun Ramirez,DEM,0,0,1,1
Concho,203,U.S. Senate,,"Annie ""Mama"" Garcia",DEM,0,0,0,0
Concho,203,U.S. Senate,,D. R. Hunter,DEM,0,0,0,0
Concho,203,U.S. Senate,,Adrian Ocegueda,DEM,0,0,0,0
Concho,203,U.S. Senate,,Amanda K. Edwards,DEM,0,0,0,0
Concho,203,U.S. Senate,,Michael Cooper,DEM,0,0,0,0
Concho,203,U.S. Senate,,Victor Hugo Harris,DEM,0,0,0,0
Concho,203,U.S. Senate,,"Mary ""MJ"" Hegar",DEM,0,0,1,1
Concho,203,U.S. Senate,,Jack Daniel Foster Jr,DEM,0,0,0,0
Concho,203,U.S. Senate,,Chris Bell,DEM,0,0,0,0
Concho,203,U.S. Senate,,Under Votes,DEM,0,0,0,0
Concho,203,U.S. Senate,,Over Votes,DEM,0,0,0,0
Concho,203,U.S. House,11,Jon Mark Hogg,DEM,0,0,1,1
Concho,203,U.S. House,11,Under Votes,DEM,0,0,1,1
Concho,203,U.S. House,11,Over Votes,DEM,0,0,0,0
Concho,203,Railroad Commissioner,,"Roberto R. ""Beto"" Alonzo",DEM,0,0,0,0
Concho,203,Railroad Commissioner,,Kelly Stone,DEM,0,0,0,0
Concho,203,Railroad Commissioner,,Chrysta Castaneda,DEM,0,0,1,1
Concho,203,Railroad Commissioner,,Mark Watson,DEM,0,0,0,0
Concho,203,Railroad Commissioner,,Under Votes,DEM,0,0,1,1
Concho,203,Railroad Commissioner,,Over Votes,DEM,0,0,0,0
Concho,204,President,,Michael R. Bloomberg,DEM,1,0,0,1
Concho,204,President,,Bernie Sanders,DEM,3,0,0,3
Concho,204,President,,Michael Bennet,DEM,0,0,0,0
Concho,204,President,,Elizabeth Warren,DEM,0,0,0,0
Concho,204,President,,John K. Delaney,DEM,0,0,0,0
Concho,204,President,,Deval Patrick,DEM,0,0,0,0
Concho,204,President,,Amy Klobuchar,DEM,0,0,0,0
Concho,204,President,,Marianne Williamson,DEM,0,0,0,0
Concho,204,President,,Andrew Yang,DEM,0,0,0,0
Concho,204,President,,Julian Castro,DEM,0,0,0,0
Concho,204,President,,Tom Steyer,DEM,0,0,0,0
Concho,204,President,,Joseph R. Biden,DEM,0,2,0,2
Concho,204,President,,Robby Wells,DEM,0,0,0,0
Concho,204,President,,Tulsi Gabbard,DEM,0,0,0,0
Concho,204,President,,Pete Buttigieg,DEM,0,0,0,0
Concho,204,President,,Cory Booker,DEM,0,0,0,0
Concho,204,President,,"Roque ""Rocky"" De La Fuente",DEM,0,0,0,0
Concho,204,President,,Under Votes,DEM,1,0,0,1
Concho,204,President,,Over Votes,DEM,0,0,0,0
Concho,204,U.S. Senate,,Royce West,DEM,0,0,0,0
Concho,204,U.S. Senate,,Sema Hernandez,DEM,3,0,0,3
Concho,204,U.S. Senate,,Cristina Tzintzun Ramirez,DEM,0,0,0,0
Concho,204,U.S. Senate,,"Annie ""Mama"" Garcia",DEM,0,1,0,1
Concho,204,U.S. Senate,,D. R. Hunter,DEM,1,0,0,1
Concho,204,U.S. Senate,,Adrian Ocegueda,DEM,0,0,0,0
Concho,204,U.S. Senate,,Amanda K. Edwards,DEM,0,0,0,0
Concho,204,U.S. Senate,,Michael Cooper,DEM,0,0,0,0
Concho,204,U.S. Senate,,Victor Hugo Harris,DEM,0,0,0,0
Concho,204,U.S. Senate,,"Mary ""MJ"" Hegar",DEM,0,0,0,0
Concho,204,U.S. Senate,,Jack Daniel Foster Jr,DEM,0,0,0,0
Concho,204,U.S. Senate,,Chris Bell,DEM,0,1,0,1
Concho,204,U.S. Senate,,Under Votes,DEM,1,0,0,1
Concho,204,U.S. Senate,,Over Votes,DEM,0,0,0,0
Concho,204,U.S. House,11,Jon Mark Hogg,DEM,2,2,0,4
Concho,204,U.S. House,11,Under Votes,DEM,3,0,0,3
Concho,204,U.S. House,11,Over Votes,DEM,0,0,0,0
Concho,204,Railroad Commissioner,,"Roberto R. ""Beto"" Alonzo",DEM,1,2,0,3
Concho,204,Railroad Commissioner,,Kelly Stone,DEM,0,0,0,0
Concho,204,Railroad Commissioner,,Chrysta Castaneda,DEM,1,0,0,1
Concho,204,Railroad Commissioner,,Mark Watson,DEM,0,0,0,0
Concho,204,Railroad Commissioner,,Under Votes,DEM,3,0,0,3
Concho,204,Railroad Commissioner,,Over Votes,DEM,0,0,0,0
Concho,205,President,,Michael R. Bloomberg,DEM,1,1,0,2
Concho,205,President,,Bernie Sanders,DEM,2,1,0,3
Concho,205,President,,Michael Bennet,DEM,0,0,0,0
Concho,205,President,,Elizabeth Warren,DEM,0,0,1,1
Concho,205,President,,John K. Delaney,DEM,0,0,0,0
Concho,205,President,,Deval Patrick,DEM,0,0,0,0
Concho,205,President,,Amy Klobuchar,DEM,0,0,0,0
Concho,205,President,,Marianne Williamson,DEM,0,0,0,0
Concho,205,President,,Andrew Yang,DEM,0,0,0,0
Concho,205,President,,Julian Castro,DEM,0,0,0,0
Concho,205,President,,Tom Steyer,DEM,0,0,0,0
Concho,205,President,,Joseph R. Biden,DEM,1,0,0,1
Concho,205,President,,Robby Wells,DEM,0,0,0,0
Concho,205,President,,Tulsi Gabbard,DEM,0,0,0,0
Concho,205,President,,Pete Buttigieg,DEM,0,0,0,0
Concho,205,President,,Cory Booker,DEM,0,0,0,0
Concho,205,President,,"Roque ""Rocky"" De La Fuente",DEM,0,0,0,0
Concho,205,President,,Under Votes,DEM,0,0,0,0
Concho,205,President,,Over Votes,DEM,0,0,0,0
Concho,205,U.S. Senate,,Royce West,DEM,0,1,0,1
Concho,205,U.S. Senate,,Sema Hernandez,DEM,0,0,0,0
Concho,205,U.S. Senate,,Cristina Tzintzun Ramirez,DEM,1,0,0,1
Concho,205,U.S. Senate,,"Annie ""Mama"" Garcia",DEM,0,0,0,0
Concho,205,U.S. Senate,,D. R. Hunter,DEM,1,0,0,1
Concho,205,U.S. Senate,,Adrian Ocegueda,DEM,0,0,0,0
Concho,205,U.S. Senate,,Amanda K. Edwards,DEM,0,0,0,0
Concho,205,U.S. Senate,,Michael Cooper,DEM,1,0,0,1
Concho,205,U.S. Senate,,Victor Hugo Harris,DEM,0,0,0,0
Concho,205,U.S. Senate,,"Mary ""MJ"" Hegar",DEM,1,1,1,3
Concho,205,U.S. Senate,,Jack Daniel Foster Jr,DEM,0,0,0,0
Concho,205,U.S. Senate,,Chris Bell,DEM,0,0,0,0
Concho,205,U.S. Senate,,Under Votes,DEM,0,0,0,0
Concho,205,U.S. Senate,,Over Votes,DEM,0,0,0,0
Concho,205,U.S. House,11,Jon Mark Hogg,DEM,4,2,1,7
Concho,205,U.S. House,11,Under Votes,DEM,0,0,0,0
Concho,205,U.S. House,11,Over Votes,DEM,0,0,0,0
Concho,205,Railroad Commissioner,,"Roberto R. ""Beto"" Alonzo",DEM,2,1,0,3
Concho,205,Railroad Commissioner,,Kelly Stone,DEM,0,0,0,0
Concho,205,Railroad Commissioner,,Chrysta Castaneda,DEM,1,0,1,2
Concho,205,Railroad Commissioner,,Mark Watson,DEM,0,1,0,1
Concho,205,Railroad Commissioner,,Under Votes,DEM,1,0,0,1
Concho,205,Railroad Commissioner,,Over Votes,DEM,0,0,0,0
Concho,306,President,,Michael R. Bloomberg,DEM,0,3,0,3
Concho,306,President,,Bernie Sanders,DEM,2,0,0,2
Concho,306,President,,Michael Bennet,DEM,0,0,0,0
Concho,306,President,,Elizabeth Warren,DEM,1,0,1,2
Concho,306,President,,John K. Delaney,DEM,0,0,0,0
Concho,306,President,,Deval Patrick,DEM,0,0,0,0
Concho,306,President,,Amy Klobuchar,DEM,0,0,0,0
Concho,306,President,,Marianne Williamson,DEM,0,0,0,0
Concho,306,President,,Andrew Yang,DEM,0,0,0,0
Concho,306,President,,Julian Castro,DEM,0,0,0,0
Concho,306,President,,Tom Steyer,DEM,0,0,0,0
Concho,306,President,,Joseph R. Biden,DEM,3,7,0,10
Concho,306,President,,Robby Wells,DEM,0,0,0,0
Concho,306,President,,Tulsi Gabbard,DEM,0,0,0,0
Concho,306,President,,Pete Buttigieg,DEM,0,0,0,0
Concho,306,President,,Cory Booker,DEM,0,0,0,0
Concho,306,President,,"Roque ""Rocky"" De La Fuente",DEM,0,0,0,0
Concho,306,President,,Under Votes,DEM,1,0,0,1
Concho,306,President,,Over Votes,DEM,0,0,0,0
Concho,306,U.S. Senate,,Royce West,DEM,0,1,0,1
Concho,306,U.S. Senate,,Sema Hernandez,DEM,1,0,0,1
Concho,306,U.S. Senate,,Cristina Tzintzun Ramirez,DEM,2,2,1,5
Concho,306,U.S. Senate,,"Annie ""Mama"" Garcia",DEM,2,1,0,3
Concho,306,U.S. Senate,,D. R. Hunter,DEM,0,0,0,0
Concho,306,U.S. Senate,,Adrian Ocegueda,DEM,0,0,0,0
Concho,306,U.S. Senate,,Amanda K. Edwards,DEM,0,0,0,0
Concho,306,U.S. Senate,,Michael Cooper,DEM,0,0,0,0
Concho,306,U.S. Senate,,Victor Hugo Harris,DEM,1,0,0,1
Concho,306,U.S. Senate,,"Mary ""MJ"" Hegar",DEM,0,3,0,3
Concho,306,U.S. Senate,,Jack Daniel Foster Jr,DEM,0,0,0,0
Concho,306,U.S. Senate,,Chris Bell,DEM,0,2,0,2
Concho,306,U.S. Senate,,Under Votes,DEM,1,1,0,2
Concho,306,U.S. Senate,,Over Votes,DEM,0,0,0,0
Concho,306,U.S. House,11,Jon Mark Hogg,DEM,5,10,1,16
Concho,306,U.S. House,11,Under Votes,DEM,2,0,0,2
Concho,306,U.S. House,11,Over Votes,DEM,0,0,0,0
Concho,306,Railroad Commissioner,,"Roberto R. ""Beto"" Alonzo",DEM,4,3,0,7
Concho,306,Railroad Commissioner,,Kelly Stone,DEM,0,1,0,1
Concho,306,Railroad Commissioner,,Chrysta Castaneda,DEM,1,5,1,7
Concho,306,Railroad Commissioner,,Mark Watson,DEM,1,0,0,1
Concho,306,Railroad Commissioner,,Under Votes,DEM,1,1,0,2
Concho,306,Railroad Commissioner,,Over Votes,DEM,0,0,0,0
Concho,407,President,,Michael R. Bloomberg,DEM,0,0,0,0
Concho,407,President,,Bernie Sanders,DEM,0,0,0,0
Concho,407,President,,Michael Bennet,DEM,0,0,0,0
Concho,407,President,,Elizabeth Warren,DEM,0,0,0,0
Concho,407,President,,John K. Delaney,DEM,0,0,0,0
Concho,407,President,,Deval Patrick,DEM,0,0,0,0
Concho,407,President,,Amy Klobuchar,DEM,0,0,0,0
Concho,407,President,,Marianne Williamson,DEM,0,0,0,0
Concho,407,President,,Andrew Yang,DEM,0,0,0,0
Concho,407,President,,Julian Castro,DEM,0,0,0,0
Concho,407,President,,Tom Steyer,DEM,0,0,0,0
Concho,407,President,,Joseph R. Biden,DEM,0,0,0,0
Concho,407,President,,Robby Wells,DEM,0,0,0,0
Concho,407,President,,Tulsi Gabbard,DEM,0,0,0,0
Concho,407,President,,Pete Buttigieg,DEM,0,0,0,0
Concho,407,President,,Cory Booker,DEM,0,0,0,0
Concho,407,President,,"Roque ""Rocky"" De La Fuente",DEM,0,0,0,0
Concho,407,President,,Under Votes,DEM,0,0,0,0
Concho,407,President,,Over Votes,DEM,0,0,0,0
Concho,407,U.S. Senate,,Royce West,DEM,0,0,0,0
Concho,407,U.S. Senate,,Sema Hernandez,DEM,0,0,0,0
Concho,407,U.S. Senate,,Cristina Tzintzun Ramirez,DEM,0,0,0,0
Concho,407,U.S. Senate,,"Annie ""Mama"" Garcia",DEM,0,0,0,0
Concho,407,U.S. Senate,,D. R. Hunter,DEM,0,0,0,0
Concho,407,U.S. Senate,,Adrian Ocegueda,DEM,0,0,0,0
Concho,407,U.S. Senate,,Amanda K. Edwards,DEM,0,0,0,0
Concho,407,U.S. Senate,,Michael Cooper,DEM,0,0,0,0
Concho,407,U.S. Senate,,Victor Hugo Harris,DEM,0,0,0,0
Concho,407,U.S. Senate,,"Mary ""MJ"" Hegar",DEM,0,0,0,0
Concho,407,U.S. Senate,,Jack Daniel Foster Jr,DEM,0,0,0,0
Concho,407,U.S. Senate,,Chris Bell,DEM,0,0,0,0
Concho,407,U.S. Senate,,Under Votes,DEM,0,0,0,0
Concho,407,U.S. Senate,,Over Votes,DEM,0,0,0,0
Concho,407,U.S. House,11,Jon Mark Hogg,DEM,0,0,0,0
Concho,407,U.S. House,11,Under Votes,DEM,0,0,0,0
Concho,407,U.S. House,11,Over Votes,DEM,0,0,0,0
Concho,407,Railroad Commissioner,,"Roberto R. ""Beto"" Alonzo",DEM,0,0,0,0
Concho,407,Railroad Commissioner,,Kelly Stone,DEM,0,0,0,0
Concho,407,Railroad Commissioner,,Chrysta Castaneda,DEM,0,0,0,0
Concho,407,Railroad Commissioner,,Mark Watson,DEM,0,0,0,0
Concho,407,Railroad Commissioner,,Under Votes,DEM,0,0,0,0
Concho,407,Railroad Commissioner,,Over Votes,DEM,0,0,0,0
Concho,408,President,,Michael R. Bloomberg,DEM,1,0,2,3
Concho,408,President,,Bernie Sanders,DEM,1,1,2,4
Concho,408,President,,Michael Bennet,DEM,0,0,0,0
Concho,408,President,,Elizabeth Warren,DEM,2,0,1,3
Concho,408,President,,John K. Delaney,DEM,0,0,0,0
Concho,408,President,,Deval Patrick,DEM,0,0,0,0
Concho,408,President,,Amy Klobuchar,DEM,0,0,0,0
Concho,408,President,,Marianne Williamson,DEM,0,0,0,0
Concho,408,President,,Andrew Yang,DEM,0,0,0,0
Concho,408,President,,Julian Castro,DEM,0,0,0,0
Concho,408,President,,Tom Steyer,DEM,0,0,0,0
Concho,408,President,,Joseph R. Biden,DEM,4,0,0,4
Concho,408,President,,Robby Wells,DEM,0,0,0,0
Concho,408,President,,Tulsi Gabbard,DEM,0,0,0,0
Concho,408,President,,Pete Buttigieg,DEM,0,0,0,0
Concho,408,President,,Cory Booker,DEM,0,0,0,0
Concho,408,President,,"Roque ""Rocky"" De La Fuente",DEM,0,0,0,0
Concho,408,President,,Under Votes,DEM,0,2,0,2
Concho,408,President,,Over Votes,DEM,0,0,0,0
Concho,408,U.S. Senate,,Royce West,DEM,0,0,2,2
Concho,408,U.S. Senate,,Sema Hernandez,DEM,2,0,0,2
Concho,408,U.S. Senate,,Cristina Tzintzun Ramirez,DEM,2,0,1,3
Concho,408,U.S. Senate,,"Annie ""Mama"" Garcia",DEM,2,0,1,3
Concho,408,U.S. Senate,,D. R. Hunter,DEM,0,0,0,0
Concho,408,U.S. Senate,,Adrian Ocegueda,DEM,0,0,1,1
Concho,408,U.S. Senate,,Amanda K. Edwards,DEM,1,0,0,1
Concho,408,U.S. Senate,,Michael Cooper,DEM,0,0,0,0
Concho,408,U.S. Senate,,Victor Hugo Harris,DEM,0,0,0,0
Concho,408,U.S. Senate,,"Mary ""MJ"" Hegar",DEM,0,0,0,0
Concho,408,U.S. Senate,,Jack Daniel Foster Jr,DEM,0,0,0,0
Concho,408,U.S. Senate,,Chris Bell,DEM,0,1,0,1
Concho,408,U.S. Senate,,Under Votes,DEM,1,2,0,3
Concho,408,U.S. Senate,,Over Votes,DEM,0,0,0,0
Concho,408,U.S. House,11,Jon Mark Hogg,DEM,6,1,4,11
Concho,408,U.S. House,11,Under Votes,DEM,2,2,1,5
Concho,408,U.S. House,11,Over Votes,DEM,0,0,0,0
Concho,408,Railroad Commissioner,,"Roberto R. ""Beto"" Alonzo",DEM,2,0,1,3
Concho,408,Railroad Commissioner,,Kelly Stone,DEM,0,0,1,1
Concho,408,Railroad Commissioner,,Chrysta Castaneda,DEM,5,1,1,7
Concho,408,Railroad Commissioner,,Mark Watson,DEM,0,0,1,1
Concho,408,Railroad Commissioner,,Under Votes,DEM,1,2,1,4
Concho,408,Railroad Commissioner,,Over Votes,DEM,0,0,0,0
