county,precinct,office,district,party,candidate,election_day,mail,early_voting,votes
Comal,201,President,,DEM,Tulsi Gabbard,1,0,0,1
Comal,201,President,,DEM,Marianne Williamson,0,0,0,0
Comal,201,President,,DEM,John K. Delaney,0,0,0,0
Comal,201,President,,DEM,Elizabeth Warren,43,5,22,70
Comal,201,President,,DEM,Cory Booker,1,0,0,1
Comal,201,President,,DEM,Amy Klobuchar,0,2,3,5
Comal,201,President,,DEM,Joseph R. Biden,129,16,36,181
Comal,201,President,,DEM,Pete Buttigieg,2,4,26,32
Comal,201,President,,DEM,Juli치n Castro,1,1,0,2
Comal,201,President,,DEM,Tom Steyer,3,1,3,7
Comal,201,President,,DEM,Michael Bennet,0,0,0,0
Comal,201,President,,DEM,Michael R. Bloomberg,25,12,15,52
Comal,201,President,,DEM,Robby Wells,0,0,0,0
Comal,201,President,,DEM,"Roque ""Rocky"" De La Fuente",0,0,0,0
Comal,201,President,,DEM,Deval Patrick,1,0,0,1
Comal,201,President,,DEM,Bernie Sanders,88,6,37,131
Comal,201,President,,DEM,Andrew Yang,1,0,0,1
Comal,201,Ballots Cast,,DEM,,295,47,142,484
Comal,201,President,,DEM,Under Votes,0,0,1,1
Comal,201,President,,DEM,Over Votes,0,0,0,0
Comal,201,U.S. Senate,,DEM,Royce West,10,1,12,23
Comal,201,U.S. Senate,,DEM,Chris Bell,21,4,9,34
Comal,201,U.S. Senate,,DEM,Amanda K. Edwards,51,10,26,87
Comal,201,U.S. Senate,,DEM,Sema Hernandez,28,9,13,50
Comal,201,U.S. Senate,,DEM,Jack Daniel Foster Jr,3,3,1,7
Comal,201,U.S. Senate,,DEM,D.R. Hunter,3,2,2,7
Comal,201,U.S. Senate,,DEM,Adrian Ocegueda,5,1,2,8
Comal,201,U.S. Senate,,DEM,"Mary ""MJ"" Hegar",64,8,42,114
Comal,201,U.S. Senate,,DEM,Cristina Tzintzun Ramirez,39,5,13,57
Comal,201,U.S. Senate,,DEM,Michael Cooper,2,2,3,7
Comal,201,U.S. Senate,,DEM,Victor Hugo Harris,1,0,2,3
Comal,201,U.S. Senate,,DEM,"Annie ""Mam치"" Garcia",24,0,3,27
Comal,201,U.S. Senate,,DEM,Cast Votes:,251,45,128,424
Comal,201,U.S. Senate,,DEM,Under Votes,44,2,15,61
Comal,201,U.S. Senate,,DEM,Over Votes,0,0,0,0
Comal,201,U.S. House,35,DEM,Rafael Alcoser III,94,12,38,144
Comal,201,U.S. House,35,DEM,Lloyd Doggett,163,34,89,286
Comal,201,U.S. House,35,DEM,Cast Votes:,257,46,127,430
Comal,201,U.S. House,35,DEM,Under Votes,38,1,16,55
Comal,201,U.S. House,35,DEM,Over Votes,0,0,0,0
Comal,201,Railroad Commissioner,,DEM,Mark Watson,38,6,18,62
Comal,201,Railroad Commissioner,,DEM,Chrysta Casta침eda,85,17,48,150
Comal,201,Railroad Commissioner,,DEM,Kelly Stone,63,9,29,101
Comal,201,Railroad Commissioner,,DEM,"Roberto R. ""Beto"" Alonzo",61,10,29,100
Comal,201,Railroad Commissioner,,DEM,Cast Votes:,247,42,124,413
Comal,201,Railroad Commissioner,,DEM,Under Votes,48,5,19,72
Comal,201,Railroad Commissioner,,DEM,Over Votes,0,0,0,0
Comal,201,"Chief Justice, Supreme Court",,DEM,Amy Clark Meachum,227,37,110,374
Comal,201,"Chief Justice, Supreme Court",,DEM,Jerry Zimmerer,28,5,18,51
Comal,201,"Chief Justice, Supreme Court",,DEM,Cast Votes:,255,42,128,425
Comal,201,"Chief Justice, Supreme Court",,DEM,Under Votes,40,5,15,60
Comal,201,"Chief Justice, Supreme Court",,DEM,Over Votes,0,0,0,0
Comal,201,"Justice, Supreme Court, Place 6 Unexpired Term",,DEM,Larry Praeger,48,14,31,93
Comal,201,"Justice, Supreme Court, Place 6 Unexpired Term",,DEM,Kathy Cheng,203,29,95,327
Comal,201,"Justice, Supreme Court, Place 6 Unexpired Term",,DEM,Cast Votes:,251,43,126,420
Comal,201,"Justice, Supreme Court, Place 6 Unexpired Term",,DEM,Under Votes,44,4,17,65
Comal,201,"Justice, Supreme Court, Place 6 Unexpired Term",,DEM,Over Votes,0,0,0,0
Comal,201,"Justice, Supreme Court, Place 7",,DEM,Staci Williams,165,32,77,274
Comal,201,"Justice, Supreme Court, Place 7",,DEM,Brandy Voss,88,11,48,147
Comal,201,"Justice, Supreme Court, Place 7",,DEM,Cast Votes:,253,43,125,421
Comal,201,"Justice, Supreme Court, Place 7",,DEM,Under Votes,42,4,18,64
Comal,201,"Justice, Supreme Court, Place 7",,DEM,Over Votes,0,0,0,0
Comal,201,"Justice, Supreme Court, Place 8",,DEM,Peter Kelly,55,17,38,110
Comal,201,"Justice, Supreme Court, Place 8",,DEM,Gisela D. Triana,190,27,84,301
Comal,201,"Justice, Supreme Court, Place 8",,DEM,Cast Votes:,245,44,122,411
Comal,201,"Justice, Supreme Court, Place 8",,DEM,Under Votes,50,3,21,74
Comal,201,"Justice, Supreme Court, Place 8",,DEM,Over Votes,0,0,0,0
Comal,201,"Judge, Court of Criminal Appeals, Place 3",,DEM,Elizabeth Davis Frizell,195,34,96,325
Comal,201,"Judge, Court of Criminal Appeals, Place 3",,DEM,William Pieratt Demond,23,3,14,40
Comal,201,"Judge, Court of Criminal Appeals, Place 3",,DEM,Dan Wood,29,7,14,50
Comal,201,"Judge, Court of Criminal Appeals, Place 3",,DEM,Cast Votes:,247,44,124,415
Comal,201,"Judge, Court of Criminal Appeals, Place 3",,DEM,Under Votes,48,3,19,70
Comal,201,"Judge, Court of Criminal Appeals, Place 3",,DEM,Over Votes,0,0,0,0
Comal,201,"Judge, Court of Criminal Appeals, Place 4",,DEM,Tina Clinton,195,33,98,326
Comal,201,"Judge, Court of Criminal Appeals, Place 4",,DEM,Steven Miears,53,11,25,89
Comal,201,"Judge, Court of Criminal Appeals, Place 4",,DEM,Cast Votes:,248,44,123,415
Comal,201,"Judge, Court of Criminal Appeals, Place 4",,DEM,Under Votes,47,3,20,70
Comal,201,"Judge, Court of Criminal Appeals, Place 4",,DEM,Over Votes,0,0,0,0
Comal,201,"Judge, Court of Criminal Appeals, Place 9",,DEM,Brandon Birmingham,232,40,111,383
Comal,201,"Judge, Court of Criminal Appeals, Place 9",,DEM,Cast Votes:,232,40,111,383
Comal,201,"Judge, Court of Criminal Appeals, Place 9",,DEM,Under Votes,63,7,32,102
Comal,201,"Judge, Court of Criminal Appeals, Place 9",,DEM,Over Votes,0,0,0,0
Comal,201,"Member, State Board of Education, District 5",,DEM,Rebecca Bell-Metereau,153,22,85,260
Comal,201,"Member, State Board of Education, District 5",,DEM,Letti Bresnahan,95,22,37,154
Comal,201,"Member, State Board of Education, District 5",,DEM,Cast Votes:,248,44,122,414
Comal,201,"Member, State Board of Education, District 5",,DEM,Under Votes,47,3,21,71
Comal,201,"Member, State Board of Education, District 5",,DEM,Over Votes,0,0,0,0
Comal,201,State Representative,73,DEM,Stephanie Phillips,236,42,117,395
Comal,201,State Representative,73,DEM,Cast Votes:,236,42,117,395
Comal,201,State Representative,73,DEM,Under Votes,59,5,26,90
Comal,201,State Representative,73,DEM,Over Votes,0,0,0,0
Comal,201,"Chief Justice, 3rd Court of Appeals District",,DEM,Darlene Byrne,197,34,98,329
Comal,201,"Chief Justice, 3rd Court of Appeals District",,DEM,Keith S. Hampton,48,10,24,82
Comal,201,"Chief Justice, 3rd Court of Appeals District",,DEM,Cast Votes:,245,44,122,411
Comal,201,"Chief Justice, 3rd Court of Appeals District",,DEM,Under Votes,50,3,21,74
Comal,201,"Chief Justice, 3rd Court of Appeals District",,DEM,Over Votes,0,0,0,0
Comal,201,County Chairman,,DEM,Gloria Meehan,241,42,122,405
Comal,201,County Chairman,,DEM,Cast Votes:,241,42,122,405
Comal,201,County Chairman,,DEM,Under Votes,54,5,21,80
Comal,201,County Chairman,,DEM,Over Votes,0,0,0,0
Comal,201,Proposition #1,,DEM,Yes,277,44,134,455
Comal,201,Proposition #1,,DEM,No,13,3,7,23
Comal,201,Proposition #1,,DEM,Cast Votes:,290,47,141,478
Comal,201,Proposition #1,,DEM,Under Votes,5,0,2,7
Comal,201,Proposition #1,,DEM,Over Votes,0,0,0,0
Comal,201,Proposition #2,,DEM,Yes,274,44,133,451
Comal,201,Proposition #2,,DEM,No,12,3,6,21
Comal,201,Proposition #2,,DEM,Cast Votes:,286,47,139,472
Comal,201,Proposition #2,,DEM,Under Votes,9,0,4,13
Comal,201,Proposition #2,,DEM,Over Votes,0,0,0,0
Comal,201,Proposition #3,,DEM,Yes,282,47,140,469
Comal,201,Proposition #3,,DEM,No,6,0,1,7
Comal,201,Proposition #3,,DEM,Cast Votes:,288,47,141,476
Comal,201,Proposition #3,,DEM,Under Votes,7,0,2,9
Comal,201,Proposition #3,,DEM,Over Votes,0,0,0,0
Comal,201,Proposition #4,,DEM,Yes,277,47,134,458
Comal,201,Proposition #4,,DEM,No,11,0,6,17
Comal,201,Proposition #4,,DEM,Cast Votes:,288,47,140,475
Comal,201,Proposition #4,,DEM,Under Votes,7,0,3,10
Comal,201,Proposition #4,,DEM,Over Votes,0,0,0,0
Comal,201,Proposition #5,,DEM,Yes,284,47,135,466
Comal,201,Proposition #5,,DEM,No,4,0,3,7
Comal,201,Proposition #5,,DEM,Cast Votes:,288,47,138,473
Comal,201,Proposition #5,,DEM,Under Votes,7,0,5,12
Comal,201,Proposition #5,,DEM,Over Votes,0,0,0,0
Comal,201,Proposition #6,,DEM,Yes,282,47,138,467
Comal,201,Proposition #6,,DEM,No,8,0,1,9
Comal,201,Proposition #6,,DEM,Cast Votes:,290,47,139,476
Comal,201,Proposition #6,,DEM,Under Votes,5,0,4,9
Comal,201,Proposition #6,,DEM,Over Votes,0,0,0,0
Comal,201,Proposition #7,,DEM,Yes,271,47,138,456
Comal,201,Proposition #7,,DEM,No,15,0,3,18
Comal,201,Proposition #7,,DEM,Cast Votes:,286,47,141,474
Comal,201,Proposition #7,,DEM,Under Votes,9,0,2,11
Comal,201,Proposition #7,,DEM,Over Votes,0,0,0,0
Comal,201,Proposition #8,,DEM,Yes,277,45,137,459
Comal,201,Proposition #8,,DEM,No,11,0,3,14
Comal,201,Proposition #8,,DEM,Cast Votes:,288,45,140,473
Comal,201,Proposition #8,,DEM,Under Votes,7,1,3,11
Comal,201,Proposition #8,,DEM,Over Votes,0,0,0,0
Comal,201,Proposition #9,,DEM,Yes,278,45,136,459
Comal,201,Proposition #9,,DEM,No,9,0,4,13
Comal,201,Proposition #9,,DEM,Cast Votes:,287,45,140,472
Comal,201,Proposition #9,,DEM,Under Votes,8,1,3,12
Comal,201,Proposition #9,,DEM,Over Votes,0,0,0,0
Comal,201,Proposition #10,,DEM,Yes,270,44,134,448
Comal,201,Proposition #10,,DEM,No,14,0,6,20
Comal,201,Proposition #10,,DEM,Cast Votes:,284,44,140,468
Comal,201,Proposition #10,,DEM,Under Votes,11,2,3,16
Comal,201,Proposition #10,,DEM,Over Votes,0,0,0,0
Comal,201,Proposition #11,,DEM,Yes,258,41,127,426
Comal,201,Proposition #11,,DEM,No,24,4,14,42
Comal,201,Proposition #11,,DEM,Cast Votes:,282,45,141,468
Comal,201,Proposition #11,,DEM,Under Votes,13,1,2,16
Comal,201,Proposition #11,,DEM,Over Votes,0,0,0,0
Comal,202,President,,DEM,Tulsi Gabbard,0,0,0,0
Comal,202,President,,DEM,Marianne Williamson,0,0,0,0
Comal,202,President,,DEM,John K. Delaney,0,0,0,0
Comal,202,President,,DEM,Elizabeth Warren,4,2,5,11
Comal,202,President,,DEM,Cory Booker,0,0,1,1
Comal,202,President,,DEM,Amy Klobuchar,0,0,1,1
Comal,202,President,,DEM,Joseph R. Biden,28,4,5,37
Comal,202,President,,DEM,Pete Buttigieg,0,0,5,5
Comal,202,President,,DEM,Juli치n Castro,0,0,0,0
Comal,202,President,,DEM,Tom Steyer,0,0,1,1
Comal,202,President,,DEM,Michael Bennet,0,0,0,0
Comal,202,President,,DEM,Michael R. Bloomberg,9,2,7,18
Comal,202,President,,DEM,Robby Wells,0,0,0,0
Comal,202,President,,DEM,"Roque ""Rocky"" De La Fuente",0,0,0,0
Comal,202,President,,DEM,Deval Patrick,0,0,0,0
Comal,202,President,,DEM,Bernie Sanders,12,4,3,19
Comal,202,President,,DEM,Andrew Yang,0,1,0,1
Comal,202,Ballots Cast,,DEM,,53,13,28,94
Comal,202,President,,DEM,Under Votes,0,0,0,0
Comal,202,President,,DEM,Over Votes,0,0,0,0
Comal,202,U.S. Senate,,DEM,Royce West,4,1,2,7
Comal,202,U.S. Senate,,DEM,Chris Bell,2,0,1,3
Comal,202,U.S. Senate,,DEM,Amanda K. Edwards,13,7,1,21
Comal,202,U.S. Senate,,DEM,Sema Hernandez,7,1,5,13
Comal,202,U.S. Senate,,DEM,Jack Daniel Foster Jr,0,0,0,0
Comal,202,U.S. Senate,,DEM,D.R. Hunter,0,0,0,0
Comal,202,U.S. Senate,,DEM,Adrian Ocegueda,2,0,2,4
Comal,202,U.S. Senate,,DEM,"Mary ""MJ"" Hegar",9,1,12,22
Comal,202,U.S. Senate,,DEM,Cristina Tzintzun Ramirez,6,3,1,10
Comal,202,U.S. Senate,,DEM,Michael Cooper,0,0,2,2
Comal,202,U.S. Senate,,DEM,Victor Hugo Harris,1,0,0,1
Comal,202,U.S. Senate,,DEM,"Annie ""Mam치"" Garcia",4,0,1,5
Comal,202,U.S. Senate,,DEM,Cast Votes:,48,13,27,88
Comal,202,U.S. Senate,,DEM,Under Votes,5,0,1,6
Comal,202,U.S. Senate,,DEM,Over Votes,0,0,0,0
Comal,202,U.S. House,35,DEM,Rafael Alcoser III,18,4,10,32
Comal,202,U.S. House,35,DEM,Lloyd Doggett,29,9,17,55
Comal,202,U.S. House,35,DEM,Cast Votes:,47,13,27,87
Comal,202,U.S. House,35,DEM,Under Votes,6,0,1,7
Comal,202,U.S. House,35,DEM,Over Votes,0,0,0,0
Comal,202,Railroad Commissioner,,DEM,Mark Watson,6,0,5,11
Comal,202,Railroad Commissioner,,DEM,Chrysta Casta침eda,22,10,8,40
Comal,202,Railroad Commissioner,,DEM,Kelly Stone,11,3,8,22
Comal,202,Railroad Commissioner,,DEM,"Roberto R. ""Beto"" Alonzo",7,0,5,12
Comal,202,Railroad Commissioner,,DEM,Cast Votes:,46,13,26,85
Comal,202,Railroad Commissioner,,DEM,Under Votes,7,0,2,9
Comal,202,Railroad Commissioner,,DEM,Over Votes,0,0,0,0
Comal,202,"Chief Justice, Supreme Court",,DEM,Amy Clark Meachum,41,13,24,78
Comal,202,"Chief Justice, Supreme Court",,DEM,Jerry Zimmerer,5,0,3,8
Comal,202,"Chief Justice, Supreme Court",,DEM,Cast Votes:,46,13,27,86
Comal,202,"Chief Justice, Supreme Court",,DEM,Under Votes,7,0,1,8
Comal,202,"Chief Justice, Supreme Court",,DEM,Over Votes,0,0,0,0
Comal,202,"Justice, Supreme Court, Place 6 Unexpired Term",,DEM,Larry Praeger,10,6,7,23
Comal,202,"Justice, Supreme Court, Place 6 Unexpired Term",,DEM,Kathy Cheng,36,7,19,62
Comal,202,"Justice, Supreme Court, Place 6 Unexpired Term",,DEM,Cast Votes:,46,13,26,85
Comal,202,"Justice, Supreme Court, Place 6 Unexpired Term",,DEM,Under Votes,7,0,2,9
Comal,202,"Justice, Supreme Court, Place 6 Unexpired Term",,DEM,Over Votes,0,0,0,0
Comal,202,"Justice, Supreme Court, Place 7",,DEM,Staci Williams,30,6,17,53
Comal,202,"Justice, Supreme Court, Place 7",,DEM,Brandy Voss,16,7,8,31
Comal,202,"Justice, Supreme Court, Place 7",,DEM,Cast Votes:,46,13,25,84
Comal,202,"Justice, Supreme Court, Place 7",,DEM,Under Votes,7,0,3,10
Comal,202,"Justice, Supreme Court, Place 7",,DEM,Over Votes,0,0,0,0
Comal,202,"Justice, Supreme Court, Place 8",,DEM,Peter Kelly,13,3,7,23
Comal,202,"Justice, Supreme Court, Place 8",,DEM,Gisela D. Triana,33,10,19,62
Comal,202,"Justice, Supreme Court, Place 8",,DEM,Cast Votes:,46,13,26,85
Comal,202,"Justice, Supreme Court, Place 8",,DEM,Under Votes,7,0,2,9
Comal,202,"Justice, Supreme Court, Place 8",,DEM,Over Votes,0,0,0,0
Comal,202,"Judge, Court of Criminal Appeals, Place 3",,DEM,Elizabeth Davis Frizell,35,13,22,70
Comal,202,"Judge, Court of Criminal Appeals, Place 3",,DEM,William Pieratt Demond,2,0,1,3
Comal,202,"Judge, Court of Criminal Appeals, Place 3",,DEM,Dan Wood,8,0,2,10
Comal,202,"Judge, Court of Criminal Appeals, Place 3",,DEM,Cast Votes:,45,13,25,83
Comal,202,"Judge, Court of Criminal Appeals, Place 3",,DEM,Under Votes,8,0,3,11
Comal,202,"Judge, Court of Criminal Appeals, Place 3",,DEM,Over Votes,0,0,0,0
Comal,202,"Judge, Court of Criminal Appeals, Place 4",,DEM,Tina Clinton,39,13,21,73
Comal,202,"Judge, Court of Criminal Appeals, Place 4",,DEM,Steven Miears,6,0,6,12
Comal,202,"Judge, Court of Criminal Appeals, Place 4",,DEM,Cast Votes:,45,13,27,85
Comal,202,"Judge, Court of Criminal Appeals, Place 4",,DEM,Under Votes,8,0,1,9
Comal,202,"Judge, Court of Criminal Appeals, Place 4",,DEM,Over Votes,0,0,0,0
Comal,202,"Judge, Court of Criminal Appeals, Place 9",,DEM,Brandon Birmingham,38,10,24,72
Comal,202,"Judge, Court of Criminal Appeals, Place 9",,DEM,Cast Votes:,38,10,24,72
Comal,202,"Judge, Court of Criminal Appeals, Place 9",,DEM,Under Votes,15,3,4,22
Comal,202,"Judge, Court of Criminal Appeals, Place 9",,DEM,Over Votes,0,0,0,0
Comal,202,"Member, State Board of Education, District 5",,DEM,Rebecca Bell-Metereau,29,12,16,57
Comal,202,"Member, State Board of Education, District 5",,DEM,Letti Bresnahan,15,1,10,26
Comal,202,"Member, State Board of Education, District 5",,DEM,Cast Votes:,44,13,26,83
Comal,202,"Member, State Board of Education, District 5",,DEM,Under Votes,9,0,2,11
Comal,202,"Member, State Board of Education, District 5",,DEM,Over Votes,0,0,0,0
Comal,202,State Representative,73,DEM,Stephanie Phillips,39,12,25,76
Comal,202,State Representative,73,DEM,Cast Votes:,39,12,25,76
Comal,202,State Representative,73,DEM,Under Votes,14,1,3,18
Comal,202,State Representative,73,DEM,Over Votes,0,0,0,0
Comal,202,"Chief Justice, 3rd Court of Appeals District",,DEM,Darlene Byrne,36,10,19,65
Comal,202,"Chief Justice, 3rd Court of Appeals District",,DEM,Keith S. Hampton,5,2,6,13
Comal,202,"Chief Justice, 3rd Court of Appeals District",,DEM,Cast Votes:,41,12,25,78
Comal,202,"Chief Justice, 3rd Court of Appeals District",,DEM,Under Votes,12,1,3,16
Comal,202,"Chief Justice, 3rd Court of Appeals District",,DEM,Over Votes,0,0,0,0
Comal,202,County Chairman,,DEM,Gloria Meehan,43,12,25,80
Comal,202,County Chairman,,DEM,Cast Votes:,43,12,25,80
Comal,202,County Chairman,,DEM,Under Votes,10,1,3,14
Comal,202,County Chairman,,DEM,Over Votes,0,0,0,0
Comal,202,Proposition #1,,DEM,Yes,48,13,25,86
Comal,202,Proposition #1,,DEM,No,2,0,1,3
Comal,202,Proposition #1,,DEM,Cast Votes:,50,13,26,89
Comal,202,Proposition #1,,DEM,Under Votes,3,0,2,5
Comal,202,Proposition #1,,DEM,Over Votes,0,0,0,0
Comal,202,Proposition #2,,DEM,Yes,49,13,25,87
Comal,202,Proposition #2,,DEM,No,2,0,1,3
Comal,202,Proposition #2,,DEM,Cast Votes:,51,13,26,90
Comal,202,Proposition #2,,DEM,Under Votes,2,0,2,4
Comal,202,Proposition #2,,DEM,Over Votes,0,0,0,0
Comal,202,Proposition #3,,DEM,Yes,52,13,25,90
Comal,202,Proposition #3,,DEM,No,0,0,1,1
Comal,202,Proposition #3,,DEM,Cast Votes:,52,13,26,91
Comal,202,Proposition #3,,DEM,Under Votes,1,0,2,3
Comal,202,Proposition #3,,DEM,Over Votes,0,0,0,0
Comal,202,Proposition #4,,DEM,Yes,52,13,25,90
Comal,202,Proposition #4,,DEM,No,0,0,1,1
Comal,202,Proposition #4,,DEM,Cast Votes:,52,13,26,91
Comal,202,Proposition #4,,DEM,Under Votes,1,0,2,3
Comal,202,Proposition #4,,DEM,Over Votes,0,0,0,0
Comal,202,Proposition #5,,DEM,Yes,52,13,25,90
Comal,202,Proposition #5,,DEM,No,0,0,1,1
Comal,202,Proposition #5,,DEM,Cast Votes:,52,13,26,91
Comal,202,Proposition #5,,DEM,Under Votes,1,0,2,3
Comal,202,Proposition #5,,DEM,Over Votes,0,0,0,0
Comal,202,Proposition #6,,DEM,Yes,52,13,25,90
Comal,202,Proposition #6,,DEM,No,0,0,1,1
Comal,202,Proposition #6,,DEM,Cast Votes:,52,13,26,91
Comal,202,Proposition #6,,DEM,Under Votes,1,0,2,3
Comal,202,Proposition #6,,DEM,Over Votes,0,0,0,0
Comal,202,Proposition #7,,DEM,Yes,51,13,26,90
Comal,202,Proposition #7,,DEM,No,1,0,1,2
Comal,202,Proposition #7,,DEM,Cast Votes:,52,13,27,92
Comal,202,Proposition #7,,DEM,Under Votes,1,0,1,2
Comal,202,Proposition #7,,DEM,Over Votes,0,0,0,0
Comal,202,Proposition #8,,DEM,Yes,48,13,25,86
Comal,202,Proposition #8,,DEM,No,3,0,0,3
Comal,202,Proposition #8,,DEM,Cast Votes:,51,13,25,89
Comal,202,Proposition #8,,DEM,Under Votes,2,0,3,5
Comal,202,Proposition #8,,DEM,Over Votes,0,0,0,0
Comal,202,Proposition #9,,DEM,Yes,51,13,25,89
Comal,202,Proposition #9,,DEM,No,1,0,1,2
Comal,202,Proposition #9,,DEM,Cast Votes:,52,13,26,91
Comal,202,Proposition #9,,DEM,Under Votes,1,0,2,3
Comal,202,Proposition #9,,DEM,Over Votes,0,0,0,0
Comal,202,Proposition #10,,DEM,Yes,50,13,25,88
Comal,202,Proposition #10,,DEM,No,2,0,1,3
Comal,202,Proposition #10,,DEM,Cast Votes:,52,13,26,91
Comal,202,Proposition #10,,DEM,Under Votes,1,0,2,3
Comal,202,Proposition #10,,DEM,Over Votes,0,0,0,0
Comal,202,Proposition #11,,DEM,Yes,49,13,22,84
Comal,202,Proposition #11,,DEM,No,3,0,3,6
Comal,202,Proposition #11,,DEM,Cast Votes:,52,13,25,90
Comal,202,Proposition #11,,DEM,Under Votes,1,0,3,4
Comal,202,Proposition #11,,DEM,Over Votes,0,0,0,0
Comal,203,President,,DEM,Tulsi Gabbard,1,0,0,1
Comal,203,President,,DEM,Marianne Williamson,0,0,0,0
Comal,203,President,,DEM,John K. Delaney,0,0,0,0
Comal,203,President,,DEM,Elizabeth Warren,14,5,26,45
Comal,203,President,,DEM,Cory Booker,0,0,0,0
Comal,203,President,,DEM,Amy Klobuchar,1,4,10,15
Comal,203,President,,DEM,Joseph R. Biden,139,6,58,203
Comal,203,President,,DEM,Pete Buttigieg,2,3,14,19
Comal,203,President,,DEM,Juli치n Castro,0,0,0,0
Comal,203,President,,DEM,Tom Steyer,1,0,0,1
Comal,203,President,,DEM,Michael Bennet,0,0,0,0
Comal,203,President,,DEM,Michael R. Bloomberg,15,11,38,64
Comal,203,President,,DEM,Robby Wells,0,0,0,0
Comal,203,President,,DEM,"Roque ""Rocky"" De La Fuente",0,0,0,0
Comal,203,President,,DEM,Deval Patrick,0,0,0,0
Comal,203,President,,DEM,Bernie Sanders,39,3,25,67
Comal,203,President,,DEM,Andrew Yang,0,0,0,0
Comal,203,Ballots Cast,,DEM,,212,32,171,415
Comal,203,President,,DEM,Under Votes,1,0,0,1
Comal,203,President,,DEM,Over Votes,0,0,0,0
Comal,203,U.S. Senate,,DEM,Royce West,13,3,11,27
Comal,203,U.S. Senate,,DEM,Chris Bell,16,3,9,28
Comal,203,U.S. Senate,,DEM,Amanda K. Edwards,33,11,22,66
Comal,203,U.S. Senate,,DEM,Sema Hernandez,23,1,14,38
Comal,203,U.S. Senate,,DEM,Jack Daniel Foster Jr,7,1,4,12
Comal,203,U.S. Senate,,DEM,D.R. Hunter,4,0,1,5
Comal,203,U.S. Senate,,DEM,Adrian Ocegueda,5,0,2,7
Comal,203,U.S. Senate,,DEM,"Mary ""MJ"" Hegar",40,7,73,120
Comal,203,U.S. Senate,,DEM,Cristina Tzintzun Ramirez,12,2,6,20
Comal,203,U.S. Senate,,DEM,Michael Cooper,4,0,1,5
Comal,203,U.S. Senate,,DEM,Victor Hugo Harris,7,0,2,9
Comal,203,U.S. Senate,,DEM,"Annie ""Mam치"" Garcia",11,2,4,17
Comal,203,U.S. Senate,,DEM,Cast Votes:,175,30,149,354
Comal,203,U.S. Senate,,DEM,Under Votes,38,2,22,62
Comal,203,U.S. Senate,,DEM,Over Votes,0,0,0,0
Comal,203,U.S. House,21,DEM,Wendy R. Davis,151,27,139,317
Comal,203,U.S. House,21,DEM,Jennie Lou Leeder,29,3,12,44
Comal,203,U.S. House,21,DEM,Cast Votes:,180,30,151,361
Comal,203,U.S. House,21,DEM,Under Votes,33,2,20,55
Comal,203,U.S. House,21,DEM,Over Votes,0,0,0,0
Comal,203,Railroad Commissioner,,DEM,Mark Watson,33,6,20,59
Comal,203,Railroad Commissioner,,DEM,Chrysta Casta침eda,57,15,64,136
Comal,203,Railroad Commissioner,,DEM,Kelly Stone,39,4,31,74
Comal,203,Railroad Commissioner,,DEM,"Roberto R. ""Beto"" Alonzo",38,4,29,71
Comal,203,Railroad Commissioner,,DEM,Cast Votes:,167,29,144,340
Comal,203,Railroad Commissioner,,DEM,Under Votes,46,3,27,76
Comal,203,Railroad Commissioner,,DEM,Over Votes,0,0,0,0
Comal,203,"Chief Justice, Supreme Court",,DEM,Amy Clark Meachum,141,27,132,300
Comal,203,"Chief Justice, Supreme Court",,DEM,Jerry Zimmerer,30,2,14,46
Comal,203,"Chief Justice, Supreme Court",,DEM,Cast Votes:,171,29,146,346
Comal,203,"Chief Justice, Supreme Court",,DEM,Under Votes,42,3,25,70
Comal,203,"Chief Justice, Supreme Court",,DEM,Over Votes,0,0,0,0
Comal,203,"Justice, Supreme Court, Place 6 Unexpired Term",,DEM,Larry Praeger,39,13,34,86
Comal,203,"Justice, Supreme Court, Place 6 Unexpired Term",,DEM,Kathy Cheng,133,16,114,263
Comal,203,"Justice, Supreme Court, Place 6 Unexpired Term",,DEM,Cast Votes:,172,29,148,349
Comal,203,"Justice, Supreme Court, Place 6 Unexpired Term",,DEM,Under Votes,41,3,23,67
Comal,203,"Justice, Supreme Court, Place 6 Unexpired Term",,DEM,Over Votes,0,0,0,0
Comal,203,"Justice, Supreme Court, Place 7",,DEM,Staci Williams,120,13,76,209
Comal,203,"Justice, Supreme Court, Place 7",,DEM,Brandy Voss,53,16,67,136
Comal,203,"Justice, Supreme Court, Place 7",,DEM,Cast Votes:,173,29,143,345
Comal,203,"Justice, Supreme Court, Place 7",,DEM,Under Votes,40,3,28,71
Comal,203,"Justice, Supreme Court, Place 7",,DEM,Over Votes,0,0,0,0
Comal,203,"Justice, Supreme Court, Place 8",,DEM,Peter Kelly,51,8,27,86
Comal,203,"Justice, Supreme Court, Place 8",,DEM,Gisela D. Triana,116,21,116,253
Comal,203,"Justice, Supreme Court, Place 8",,DEM,Cast Votes:,167,29,143,339
Comal,203,"Justice, Supreme Court, Place 8",,DEM,Under Votes,46,3,28,77
Comal,203,"Justice, Supreme Court, Place 8",,DEM,Over Votes,0,0,0,0
Comal,203,"Judge, Court of Criminal Appeals, Place 3",,DEM,Elizabeth Davis Frizell,122,27,115,264
Comal,203,"Judge, Court of Criminal Appeals, Place 3",,DEM,William Pieratt Demond,12,0,14,26
Comal,203,"Judge, Court of Criminal Appeals, Place 3",,DEM,Dan Wood,35,2,13,50
Comal,203,"Judge, Court of Criminal Appeals, Place 3",,DEM,Cast Votes:,169,29,142,340
Comal,203,"Judge, Court of Criminal Appeals, Place 3",,DEM,Under Votes,44,3,29,76
Comal,203,"Judge, Court of Criminal Appeals, Place 3",,DEM,Over Votes,0,0,0,0
Comal,203,"Judge, Court of Criminal Appeals, Place 4",,DEM,Tina Clinton,133,24,126,283
Comal,203,"Judge, Court of Criminal Appeals, Place 4",,DEM,Steven Miears,37,5,15,57
Comal,203,"Judge, Court of Criminal Appeals, Place 4",,DEM,Cast Votes:,170,29,141,340
Comal,203,"Judge, Court of Criminal Appeals, Place 4",,DEM,Under Votes,43,3,30,76
Comal,203,"Judge, Court of Criminal Appeals, Place 4",,DEM,Over Votes,0,0,0,0
Comal,203,"Judge, Court of Criminal Appeals, Place 9",,DEM,Brandon Birmingham,154,24,130,308
Comal,203,"Judge, Court of Criminal Appeals, Place 9",,DEM,Cast Votes:,154,24,130,308
Comal,203,"Judge, Court of Criminal Appeals, Place 9",,DEM,Under Votes,59,8,41,108
Comal,203,"Judge, Court of Criminal Appeals, Place 9",,DEM,Over Votes,0,0,0,0
Comal,203,"Member, State Board of Education, District 5",,DEM,Rebecca Bell-Metereau,106,19,94,219
Comal,203,"Member, State Board of Education, District 5",,DEM,Letti Bresnahan,64,10,45,119
Comal,203,"Member, State Board of Education, District 5",,DEM,Cast Votes:,170,29,139,338
Comal,203,"Member, State Board of Education, District 5",,DEM,Under Votes,43,3,32,78
Comal,203,"Member, State Board of Education, District 5",,DEM,Over Votes,0,0,0,0
Comal,203,State Representative,73,DEM,Stephanie Phillips,162,27,137,326
Comal,203,State Representative,73,DEM,Cast Votes:,162,27,137,326
Comal,203,State Representative,73,DEM,Under Votes,51,5,34,90
Comal,203,State Representative,73,DEM,Over Votes,0,0,0,0
Comal,203,"Chief Justice, 3rd Court of Appeals District",,DEM,Darlene Byrne,122,23,114,259
Comal,203,"Chief Justice, 3rd Court of Appeals District",,DEM,Keith S. Hampton,42,6,21,69
Comal,203,"Chief Justice, 3rd Court of Appeals District",,DEM,Cast Votes:,164,29,135,328
Comal,203,"Chief Justice, 3rd Court of Appeals District",,DEM,Under Votes,49,3,36,88
Comal,203,"Chief Justice, 3rd Court of Appeals District",,DEM,Over Votes,0,0,0,0
Comal,203,County Chairman,,DEM,Gloria Meehan,162,27,136,325
Comal,203,County Chairman,,DEM,Cast Votes:,162,27,136,325
Comal,203,County Chairman,,DEM,Under Votes,51,5,35,91
Comal,203,County Chairman,,DEM,Over Votes,0,0,0,0
Comal,203,Proposition #1,,DEM,Yes,190,28,155,373
Comal,203,Proposition #1,,DEM,No,16,0,9,25
Comal,203,Proposition #1,,DEM,Cast Votes:,206,28,164,398
Comal,203,Proposition #1,,DEM,Under Votes,7,4,7,18
Comal,203,Proposition #1,,DEM,Over Votes,0,0,0,0
Comal,203,Proposition #2,,DEM,Yes,190,28,155,373
Comal,203,Proposition #2,,DEM,No,18,1,10,29
Comal,203,Proposition #2,,DEM,Cast Votes:,208,29,165,402
Comal,203,Proposition #2,,DEM,Under Votes,5,3,6,14
Comal,203,Proposition #2,,DEM,Over Votes,0,0,0,0
Comal,203,Proposition #3,,DEM,Yes,202,29,162,393
Comal,203,Proposition #3,,DEM,No,6,0,2,8
Comal,203,Proposition #3,,DEM,Cast Votes:,208,29,164,401
Comal,203,Proposition #3,,DEM,Under Votes,5,3,7,15
Comal,203,Proposition #3,,DEM,Over Votes,0,0,0,0
Comal,203,Proposition #4,,DEM,Yes,191,29,153,373
Comal,203,Proposition #4,,DEM,No,13,0,9,22
Comal,203,Proposition #4,,DEM,Cast Votes:,204,29,162,395
Comal,203,Proposition #4,,DEM,Under Votes,9,3,9,21
Comal,203,Proposition #4,,DEM,Over Votes,0,0,0,0
Comal,203,Proposition #5,,DEM,Yes,201,29,160,390
Comal,203,Proposition #5,,DEM,No,6,0,3,9
Comal,203,Proposition #5,,DEM,Cast Votes:,207,29,163,399
Comal,203,Proposition #5,,DEM,Under Votes,6,3,8,17
Comal,203,Proposition #5,,DEM,Over Votes,0,0,0,0
Comal,203,Proposition #6,,DEM,Yes,196,29,160,385
Comal,203,Proposition #6,,DEM,No,10,0,4,14
Comal,203,Proposition #6,,DEM,Cast Votes:,206,29,164,399
Comal,203,Proposition #6,,DEM,Under Votes,7,3,7,17
Comal,203,Proposition #6,,DEM,Over Votes,0,0,0,0
Comal,203,Proposition #7,,DEM,Yes,192,29,152,373
Comal,203,Proposition #7,,DEM,No,12,0,9,21
Comal,203,Proposition #7,,DEM,Cast Votes:,204,29,161,394
Comal,203,Proposition #7,,DEM,Under Votes,9,3,10,22
Comal,203,Proposition #7,,DEM,Over Votes,0,0,0,0
Comal,203,Proposition #8,,DEM,Yes,197,28,155,380
Comal,203,Proposition #8,,DEM,No,7,0,7,14
Comal,203,Proposition #8,,DEM,Cast Votes:,204,28,162,394
Comal,203,Proposition #8,,DEM,Under Votes,9,3,9,21
Comal,203,Proposition #8,,DEM,Over Votes,0,0,0,0
Comal,203,Proposition #9,,DEM,Yes,199,28,156,383
Comal,203,Proposition #9,,DEM,No,5,0,4,9
Comal,203,Proposition #9,,DEM,Cast Votes:,204,28,160,392
Comal,203,Proposition #9,,DEM,Under Votes,9,3,11,23
Comal,203,Proposition #9,,DEM,Over Votes,0,0,0,0
Comal,203,Proposition #10,,DEM,Yes,193,28,155,376
Comal,203,Proposition #10,,DEM,No,13,0,6,19
Comal,203,Proposition #10,,DEM,Cast Votes:,206,28,161,395
Comal,203,Proposition #10,,DEM,Under Votes,7,3,10,20
Comal,203,Proposition #10,,DEM,Over Votes,0,0,0,0
Comal,203,Proposition #11,,DEM,Yes,185,26,154,365
Comal,203,Proposition #11,,DEM,No,17,2,9,28
Comal,203,Proposition #11,,DEM,Cast Votes:,202,28,163,393
Comal,203,Proposition #11,,DEM,Under Votes,11,3,8,22
Comal,203,Proposition #11,,DEM,Over Votes,0,0,0,0
Comal,204,President,,DEM,Tulsi Gabbard,0,0,0,0
Comal,204,President,,DEM,Marianne Williamson,0,0,0,0
Comal,204,President,,DEM,John K. Delaney,0,0,0,0
Comal,204,President,,DEM,Elizabeth Warren,17,5,19,41
Comal,204,President,,DEM,Cory Booker,0,0,0,0
Comal,204,President,,DEM,Amy Klobuchar,0,1,9,10
Comal,204,President,,DEM,Joseph R. Biden,52,15,25,92
Comal,204,President,,DEM,Pete Buttigieg,1,1,21,23
Comal,204,President,,DEM,Juli치n Castro,0,0,3,3
Comal,204,President,,DEM,Tom Steyer,0,0,1,1
Comal,204,President,,DEM,Michael Bennet,0,0,0,0
Comal,204,President,,DEM,Michael R. Bloomberg,14,6,22,42
Comal,204,President,,DEM,Robby Wells,0,0,0,0
Comal,204,President,,DEM,"Roque ""Rocky"" De La Fuente",0,0,0,0
Comal,204,President,,DEM,Deval Patrick,0,0,0,0
Comal,204,President,,DEM,Bernie Sanders,31,4,35,70
Comal,204,President,,DEM,Andrew Yang,0,0,0,0
Comal,204,Ballots Cast,,DEM,,115,32,135,282
Comal,204,President,,DEM,Under Votes,0,1,1,2
Comal,204,President,,DEM,Over Votes,0,0,0,0
Comal,204,U.S. Senate,,DEM,Royce West,10,1,6,17
Comal,204,U.S. Senate,,DEM,Chris Bell,9,5,11,25
Comal,204,U.S. Senate,,DEM,Amanda K. Edwards,14,4,23,41
Comal,204,U.S. Senate,,DEM,Sema Hernandez,12,2,7,21
Comal,204,U.S. Senate,,DEM,Jack Daniel Foster Jr,0,0,3,3
Comal,204,U.S. Senate,,DEM,D.R. Hunter,1,0,0,1
Comal,204,U.S. Senate,,DEM,Adrian Ocegueda,7,1,3,11
Comal,204,U.S. Senate,,DEM,"Mary ""MJ"" Hegar",25,8,40,73
Comal,204,U.S. Senate,,DEM,Cristina Tzintzun Ramirez,6,5,21,32
Comal,204,U.S. Senate,,DEM,Michael Cooper,1,1,0,2
Comal,204,U.S. Senate,,DEM,Victor Hugo Harris,2,0,1,3
Comal,204,U.S. Senate,,DEM,"Annie ""Mam치"" Garcia",5,3,6,14
Comal,204,U.S. Senate,,DEM,Cast Votes:,92,30,121,243
Comal,204,U.S. Senate,,DEM,Under Votes,23,1,15,39
Comal,204,U.S. Senate,,DEM,Over Votes,0,2,0,2
Comal,204,U.S. House,21,DEM,Wendy R. Davis,72,25,108,205
Comal,204,U.S. House,21,DEM,Jennie Lou Leeder,23,5,19,47
Comal,204,U.S. House,21,DEM,Cast Votes:,95,30,127,252
Comal,204,U.S. House,21,DEM,Under Votes,20,3,9,32
Comal,204,U.S. House,21,DEM,Over Votes,0,0,0,0
Comal,204,Railroad Commissioner,,DEM,Mark Watson,16,3,19,38
Comal,204,Railroad Commissioner,,DEM,Chrysta Casta침eda,32,13,41,86
Comal,204,Railroad Commissioner,,DEM,Kelly Stone,19,4,35,58
Comal,204,Railroad Commissioner,,DEM,"Roberto R. ""Beto"" Alonzo",21,7,21,49
Comal,204,Railroad Commissioner,,DEM,Cast Votes:,88,27,116,231
Comal,204,Railroad Commissioner,,DEM,Under Votes,27,6,20,53
Comal,204,Railroad Commissioner,,DEM,Over Votes,0,0,0,0
Comal,204,"Chief Justice, Supreme Court",,DEM,Amy Clark Meachum,78,26,107,211
Comal,204,"Chief Justice, Supreme Court",,DEM,Jerry Zimmerer,9,3,9,21
Comal,204,"Chief Justice, Supreme Court",,DEM,Cast Votes:,87,29,116,232
Comal,204,"Chief Justice, Supreme Court",,DEM,Under Votes,28,4,20,52
Comal,204,"Chief Justice, Supreme Court",,DEM,Over Votes,0,0,0,0
Comal,204,"Justice, Supreme Court, Place 6 Unexpired Term",,DEM,Larry Praeger,18,12,19,49
Comal,204,"Justice, Supreme Court, Place 6 Unexpired Term",,DEM,Kathy Cheng,70,18,100,188
Comal,204,"Justice, Supreme Court, Place 6 Unexpired Term",,DEM,Cast Votes:,88,30,119,237
Comal,204,"Justice, Supreme Court, Place 6 Unexpired Term",,DEM,Under Votes,27,3,17,47
Comal,204,"Justice, Supreme Court, Place 6 Unexpired Term",,DEM,Over Votes,0,0,0,0
Comal,204,"Justice, Supreme Court, Place 7",,DEM,Staci Williams,54,22,74,150
Comal,204,"Justice, Supreme Court, Place 7",,DEM,Brandy Voss,32,8,43,83
Comal,204,"Justice, Supreme Court, Place 7",,DEM,Cast Votes:,86,30,117,233
Comal,204,"Justice, Supreme Court, Place 7",,DEM,Under Votes,29,3,19,51
Comal,204,"Justice, Supreme Court, Place 7",,DEM,Over Votes,0,0,0,0
Comal,204,"Justice, Supreme Court, Place 8",,DEM,Peter Kelly,22,9,25,56
Comal,204,"Justice, Supreme Court, Place 8",,DEM,Gisela D. Triana,66,21,91,178
Comal,204,"Justice, Supreme Court, Place 8",,DEM,Cast Votes:,88,30,116,234
Comal,204,"Justice, Supreme Court, Place 8",,DEM,Under Votes,27,3,20,50
Comal,204,"Justice, Supreme Court, Place 8",,DEM,Over Votes,0,0,0,0
Comal,204,"Judge, Court of Criminal Appeals, Place 3",,DEM,Elizabeth Davis Frizell,74,16,93,183
Comal,204,"Judge, Court of Criminal Appeals, Place 3",,DEM,William Pieratt Demond,2,6,7,15
Comal,204,"Judge, Court of Criminal Appeals, Place 3",,DEM,Dan Wood,13,8,17,38
Comal,204,"Judge, Court of Criminal Appeals, Place 3",,DEM,Cast Votes:,89,30,117,236
Comal,204,"Judge, Court of Criminal Appeals, Place 3",,DEM,Under Votes,26,3,19,48
Comal,204,"Judge, Court of Criminal Appeals, Place 3",,DEM,Over Votes,0,0,0,0
Comal,204,"Judge, Court of Criminal Appeals, Place 4",,DEM,Tina Clinton,70,22,98,190
Comal,204,"Judge, Court of Criminal Appeals, Place 4",,DEM,Steven Miears,17,8,18,43
Comal,204,"Judge, Court of Criminal Appeals, Place 4",,DEM,Cast Votes:,87,30,116,233
Comal,204,"Judge, Court of Criminal Appeals, Place 4",,DEM,Under Votes,28,3,20,51
Comal,204,"Judge, Court of Criminal Appeals, Place 4",,DEM,Over Votes,0,0,0,0
Comal,204,"Judge, Court of Criminal Appeals, Place 9",,DEM,Brandon Birmingham,76,24,99,199
Comal,204,"Judge, Court of Criminal Appeals, Place 9",,DEM,Cast Votes:,76,24,99,199
Comal,204,"Judge, Court of Criminal Appeals, Place 9",,DEM,Under Votes,39,9,37,85
Comal,204,"Judge, Court of Criminal Appeals, Place 9",,DEM,Over Votes,0,0,0,0
Comal,204,"Member, State Board of Education, District 5",,DEM,Rebecca Bell-Metereau,42,21,74,137
Comal,204,"Member, State Board of Education, District 5",,DEM,Letti Bresnahan,44,9,41,94
Comal,204,"Member, State Board of Education, District 5",,DEM,Cast Votes:,86,30,115,231
Comal,204,"Member, State Board of Education, District 5",,DEM,Under Votes,29,3,21,53
Comal,204,"Member, State Board of Education, District 5",,DEM,Over Votes,0,0,0,0
Comal,204,State Representative,73,DEM,Stephanie Phillips,81,26,108,215
Comal,204,State Representative,73,DEM,Cast Votes:,81,26,108,215
Comal,204,State Representative,73,DEM,Under Votes,34,7,28,69
Comal,204,State Representative,73,DEM,Over Votes,0,0,0,0
Comal,204,"Chief Justice, 3rd Court of Appeals District",,DEM,Darlene Byrne,69,25,94,188
Comal,204,"Chief Justice, 3rd Court of Appeals District",,DEM,Keith S. Hampton,18,5,23,46
Comal,204,"Chief Justice, 3rd Court of Appeals District",,DEM,Cast Votes:,87,30,117,234
Comal,204,"Chief Justice, 3rd Court of Appeals District",,DEM,Under Votes,28,3,19,50
Comal,204,"Chief Justice, 3rd Court of Appeals District",,DEM,Over Votes,0,0,0,0
Comal,204,County Chairman,,DEM,Gloria Meehan,80,26,108,214
Comal,204,County Chairman,,DEM,Cast Votes:,80,26,108,214
Comal,204,County Chairman,,DEM,Under Votes,35,7,28,70
Comal,204,County Chairman,,DEM,Over Votes,0,0,0,0
Comal,204,Proposition #1,,DEM,Yes,101,32,124,257
Comal,204,Proposition #1,,DEM,No,11,0,8,19
Comal,204,Proposition #1,,DEM,Cast Votes:,112,32,132,276
Comal,204,Proposition #1,,DEM,Under Votes,3,1,4,8
Comal,204,Proposition #1,,DEM,Over Votes,0,0,0,0
Comal,204,Proposition #2,,DEM,Yes,102,31,123,256
Comal,204,Proposition #2,,DEM,No,11,0,9,20
Comal,204,Proposition #2,,DEM,Cast Votes:,113,31,132,276
Comal,204,Proposition #2,,DEM,Under Votes,2,2,4,8
Comal,204,Proposition #2,,DEM,Over Votes,0,0,0,0
Comal,204,Proposition #3,,DEM,Yes,108,32,129,269
Comal,204,Proposition #3,,DEM,No,5,0,3,8
Comal,204,Proposition #3,,DEM,Cast Votes:,113,32,132,277
Comal,204,Proposition #3,,DEM,Under Votes,2,1,4,7
Comal,204,Proposition #3,,DEM,Over Votes,0,0,0,0
Comal,204,Proposition #4,,DEM,Yes,101,32,119,252
Comal,204,Proposition #4,,DEM,No,11,0,12,23
Comal,204,Proposition #4,,DEM,Cast Votes:,112,32,131,275
Comal,204,Proposition #4,,DEM,Under Votes,3,1,5,9
Comal,204,Proposition #4,,DEM,Over Votes,0,0,0,0
Comal,204,Proposition #5,,DEM,Yes,109,31,129,269
Comal,204,Proposition #5,,DEM,No,3,0,3,6
Comal,204,Proposition #5,,DEM,Cast Votes:,112,31,132,275
Comal,204,Proposition #5,,DEM,Under Votes,3,2,4,9
Comal,204,Proposition #5,,DEM,Over Votes,0,0,0,0
Comal,204,Proposition #6,,DEM,Yes,107,32,129,268
Comal,204,Proposition #6,,DEM,No,4,0,4,8
Comal,204,Proposition #6,,DEM,Cast Votes:,111,32,133,276
Comal,204,Proposition #6,,DEM,Under Votes,4,1,3,8
Comal,204,Proposition #6,,DEM,Over Votes,0,0,0,0
Comal,204,Proposition #7,,DEM,Yes,102,30,124,256
Comal,204,Proposition #7,,DEM,No,11,0,8,19
Comal,204,Proposition #7,,DEM,Cast Votes:,113,30,132,275
Comal,204,Proposition #7,,DEM,Under Votes,2,3,4,9
Comal,204,Proposition #7,,DEM,Over Votes,0,0,0,0
Comal,204,Proposition #8,,DEM,Yes,104,33,126,263
Comal,204,Proposition #8,,DEM,No,9,0,5,14
Comal,204,Proposition #8,,DEM,Cast Votes:,113,33,131,277
Comal,204,Proposition #8,,DEM,Under Votes,2,0,5,7
Comal,204,Proposition #8,,DEM,Over Votes,0,0,0,0
Comal,204,Proposition #9,,DEM,Yes,106,33,127,266
Comal,204,Proposition #9,,DEM,No,7,0,6,13
Comal,204,Proposition #9,,DEM,Cast Votes:,113,33,133,279
Comal,204,Proposition #9,,DEM,Under Votes,2,0,3,5
Comal,204,Proposition #9,,DEM,Over Votes,0,0,0,0
Comal,204,Proposition #10,,DEM,Yes,104,32,127,263
Comal,204,Proposition #10,,DEM,No,8,1,4,13
Comal,204,Proposition #10,,DEM,Cast Votes:,112,33,131,276
Comal,204,Proposition #10,,DEM,Under Votes,3,0,5,8
Comal,204,Proposition #10,,DEM,Over Votes,0,0,0,0
Comal,204,Proposition #11,,DEM,Yes,99,32,124,255
Comal,204,Proposition #11,,DEM,No,12,1,9,22
Comal,204,Proposition #11,,DEM,Cast Votes:,111,33,133,277
Comal,204,Proposition #11,,DEM,Under Votes,4,0,3,7
Comal,204,Proposition #11,,DEM,Over Votes,0,0,0,0
Comal,205,President,,DEM,Tulsi Gabbard,2,0,1,3
Comal,205,President,,DEM,Marianne Williamson,0,0,1,1
Comal,205,President,,DEM,John K. Delaney,0,0,0,0
Comal,205,President,,DEM,Elizabeth Warren,16,6,23,45
Comal,205,President,,DEM,Cory Booker,0,0,1,1
Comal,205,President,,DEM,Amy Klobuchar,1,1,24,26
Comal,205,President,,DEM,Joseph R. Biden,166,17,112,295
Comal,205,President,,DEM,Pete Buttigieg,0,3,33,36
Comal,205,President,,DEM,Juli치n Castro,3,0,0,3
Comal,205,President,,DEM,Tom Steyer,1,0,4,5
Comal,205,President,,DEM,Michael Bennet,1,0,0,1
Comal,205,President,,DEM,Michael R. Bloomberg,20,10,66,96
Comal,205,President,,DEM,Robby Wells,0,0,0,0
Comal,205,President,,DEM,"Roque ""Rocky"" De La Fuente",1,0,0,1
Comal,205,President,,DEM,Deval Patrick,0,0,0,0
Comal,205,President,,DEM,Bernie Sanders,40,5,46,91
Comal,205,President,,DEM,Andrew Yang,0,0,0,0
Comal,205,Ballots Cast,,DEM,,251,42,311,604
Comal,205,President,,DEM,Under Votes,3,1,1,5
Comal,205,President,,DEM,Over Votes,0,0,0,0
Comal,205,U.S. Senate,,DEM,Royce West,21,12,25,58
Comal,205,U.S. Senate,,DEM,Chris Bell,16,2,21,39
Comal,205,U.S. Senate,,DEM,Amanda K. Edwards,51,6,58,115
Comal,205,U.S. Senate,,DEM,Sema Hernandez,16,2,21,39
Comal,205,U.S. Senate,,DEM,Jack Daniel Foster Jr,5,0,4,9
Comal,205,U.S. Senate,,DEM,D.R. Hunter,3,0,3,6
Comal,205,U.S. Senate,,DEM,Adrian Ocegueda,11,2,11,24
Comal,205,U.S. Senate,,DEM,"Mary ""MJ"" Hegar",56,7,92,155
Comal,205,U.S. Senate,,DEM,Cristina Tzintzun Ramirez,9,6,25,40
Comal,205,U.S. Senate,,DEM,Michael Cooper,6,2,7,15
Comal,205,U.S. Senate,,DEM,Victor Hugo Harris,2,0,2,4
Comal,205,U.S. Senate,,DEM,"Annie ""Mam치"" Garcia",10,2,15,27
Comal,205,U.S. Senate,,DEM,Cast Votes:,206,41,284,531
Comal,205,U.S. Senate,,DEM,Under Votes,48,2,28,78
Comal,205,U.S. Senate,,DEM,Over Votes,0,0,0,0
Comal,205,U.S. House,21,DEM,Wendy R. Davis,182,32,256,470
Comal,205,U.S. House,21,DEM,Jennie Lou Leeder,27,9,32,68
Comal,205,U.S. House,21,DEM,Cast Votes:,209,41,288,538
Comal,205,U.S. House,21,DEM,Under Votes,45,2,24,71
Comal,205,U.S. House,21,DEM,Over Votes,0,0,0,0
Comal,205,Railroad Commissioner,,DEM,Mark Watson,35,5,44,84
Comal,205,Railroad Commissioner,,DEM,Chrysta Casta침eda,70,21,106,197
Comal,205,Railroad Commissioner,,DEM,Kelly Stone,51,8,67,126
Comal,205,Railroad Commissioner,,DEM,"Roberto R. ""Beto"" Alonzo",44,5,57,106
Comal,205,Railroad Commissioner,,DEM,Cast Votes:,200,39,274,513
Comal,205,Railroad Commissioner,,DEM,Under Votes,54,4,38,96
Comal,205,Railroad Commissioner,,DEM,Over Votes,0,0,0,0
Comal,205,"Chief Justice, Supreme Court",,DEM,Amy Clark Meachum,169,36,245,450
Comal,205,"Chief Justice, Supreme Court",,DEM,Jerry Zimmerer,41,3,29,73
Comal,205,"Chief Justice, Supreme Court",,DEM,Cast Votes:,210,39,274,523
Comal,205,"Chief Justice, Supreme Court",,DEM,Under Votes,44,4,38,86
Comal,205,"Chief Justice, Supreme Court",,DEM,Over Votes,0,0,0,0
Comal,205,"Justice, Supreme Court, Place 6 Unexpired Term",,DEM,Larry Praeger,43,6,61,110
Comal,205,"Justice, Supreme Court, Place 6 Unexpired Term",,DEM,Kathy Cheng,162,33,210,405
Comal,205,"Justice, Supreme Court, Place 6 Unexpired Term",,DEM,Cast Votes:,205,39,271,515
Comal,205,"Justice, Supreme Court, Place 6 Unexpired Term",,DEM,Under Votes,49,4,41,94
Comal,205,"Justice, Supreme Court, Place 6 Unexpired Term",,DEM,Over Votes,0,0,0,0
Comal,205,"Justice, Supreme Court, Place 7",,DEM,Staci Williams,124,24,177,325
Comal,205,"Justice, Supreme Court, Place 7",,DEM,Brandy Voss,78,15,94,187
Comal,205,"Justice, Supreme Court, Place 7",,DEM,Cast Votes:,202,39,271,512
Comal,205,"Justice, Supreme Court, Place 7",,DEM,Under Votes,52,4,41,97
Comal,205,"Justice, Supreme Court, Place 7",,DEM,Over Votes,0,0,0,0
Comal,205,"Justice, Supreme Court, Place 8",,DEM,Peter Kelly,49,8,62,119
Comal,205,"Justice, Supreme Court, Place 8",,DEM,Gisela D. Triana,146,31,208,385
Comal,205,"Justice, Supreme Court, Place 8",,DEM,Cast Votes:,195,39,270,504
Comal,205,"Justice, Supreme Court, Place 8",,DEM,Under Votes,59,4,42,105
Comal,205,"Justice, Supreme Court, Place 8",,DEM,Over Votes,0,0,0,0
Comal,205,"Judge, Court of Criminal Appeals, Place 3",,DEM,Elizabeth Davis Frizell,159,31,221,411
Comal,205,"Judge, Court of Criminal Appeals, Place 3",,DEM,William Pieratt Demond,18,2,12,32
Comal,205,"Judge, Court of Criminal Appeals, Place 3",,DEM,Dan Wood,22,6,35,63
Comal,205,"Judge, Court of Criminal Appeals, Place 3",,DEM,Cast Votes:,199,39,268,506
Comal,205,"Judge, Court of Criminal Appeals, Place 3",,DEM,Under Votes,55,4,44,103
Comal,205,"Judge, Court of Criminal Appeals, Place 3",,DEM,Over Votes,0,0,0,0
Comal,205,"Judge, Court of Criminal Appeals, Place 4",,DEM,Tina Clinton,167,29,224,420
Comal,205,"Judge, Court of Criminal Appeals, Place 4",,DEM,Steven Miears,31,10,43,84
Comal,205,"Judge, Court of Criminal Appeals, Place 4",,DEM,Cast Votes:,198,39,267,504
Comal,205,"Judge, Court of Criminal Appeals, Place 4",,DEM,Under Votes,56,4,45,105
Comal,205,"Judge, Court of Criminal Appeals, Place 4",,DEM,Over Votes,0,0,0,0
Comal,205,"Judge, Court of Criminal Appeals, Place 9",,DEM,Brandon Birmingham,177,35,243,455
Comal,205,"Judge, Court of Criminal Appeals, Place 9",,DEM,Cast Votes:,177,35,243,455
Comal,205,"Judge, Court of Criminal Appeals, Place 9",,DEM,Under Votes,77,8,69,154
Comal,205,"Judge, Court of Criminal Appeals, Place 9",,DEM,Over Votes,0,0,0,0
Comal,205,"Member, State Board of Education, District 5",,DEM,Rebecca Bell-Metereau,109,30,181,320
Comal,205,"Member, State Board of Education, District 5",,DEM,Letti Bresnahan,84,9,95,188
Comal,205,"Member, State Board of Education, District 5",,DEM,Cast Votes:,193,39,276,508
Comal,205,"Member, State Board of Education, District 5",,DEM,Under Votes,61,4,36,101
Comal,205,"Member, State Board of Education, District 5",,DEM,Over Votes,0,0,0,0
Comal,205,State Representative,73,DEM,Stephanie Phillips,184,37,259,480
Comal,205,State Representative,73,DEM,Cast Votes:,184,37,259,480
Comal,205,State Representative,73,DEM,Under Votes,70,6,53,129
Comal,205,State Representative,73,DEM,Over Votes,0,0,0,0
Comal,205,"Chief Justice, 3rd Court of Appeals District",,DEM,Darlene Byrne,151,34,212,397
Comal,205,"Chief Justice, 3rd Court of Appeals District",,DEM,Keith S. Hampton,39,5,53,97
Comal,205,"Chief Justice, 3rd Court of Appeals District",,DEM,Cast Votes:,190,39,265,494
Comal,205,"Chief Justice, 3rd Court of Appeals District",,DEM,Under Votes,64,4,47,115
Comal,205,"Chief Justice, 3rd Court of Appeals District",,DEM,Over Votes,0,0,0,0
Comal,205,County Chairman,,DEM,Gloria Meehan,184,38,262,484
Comal,205,County Chairman,,DEM,Cast Votes:,184,38,262,484
Comal,205,County Chairman,,DEM,Under Votes,70,5,50,125
Comal,205,County Chairman,,DEM,Over Votes,0,0,0,0
Comal,205,Proposition #1,,DEM,Yes,222,42,285,549
Comal,205,Proposition #1,,DEM,No,19,0,23,42
Comal,205,Proposition #1,,DEM,Cast Votes:,241,42,308,591
Comal,205,Proposition #1,,DEM,Under Votes,13,1,4,18
Comal,205,Proposition #1,,DEM,Over Votes,0,0,0,0
Comal,205,Proposition #2,,DEM,Yes,220,41,276,537
Comal,205,Proposition #2,,DEM,No,22,0,27,49
Comal,205,Proposition #2,,DEM,Cast Votes:,242,41,303,586
Comal,205,Proposition #2,,DEM,Under Votes,12,2,9,23
Comal,205,Proposition #2,,DEM,Over Votes,0,0,0,0
Comal,205,Proposition #3,,DEM,Yes,241,43,297,581
Comal,205,Proposition #3,,DEM,No,4,0,7,11
Comal,205,Proposition #3,,DEM,Cast Votes:,245,43,304,592
Comal,205,Proposition #3,,DEM,Under Votes,9,0,8,17
Comal,205,Proposition #3,,DEM,Over Votes,0,0,0,0
Comal,205,Proposition #4,,DEM,Yes,223,42,281,546
Comal,205,Proposition #4,,DEM,No,19,0,23,42
Comal,205,Proposition #4,,DEM,Cast Votes:,242,42,304,588
Comal,205,Proposition #4,,DEM,Under Votes,12,1,8,21
Comal,205,Proposition #4,,DEM,Over Votes,0,0,0,0
Comal,205,Proposition #5,,DEM,Yes,235,42,297,574
Comal,205,Proposition #5,,DEM,No,8,0,8,16
Comal,205,Proposition #5,,DEM,Cast Votes:,243,42,305,590
Comal,205,Proposition #5,,DEM,Under Votes,11,0,7,18
Comal,205,Proposition #5,,DEM,Over Votes,0,1,0,1
Comal,205,Proposition #6,,DEM,Yes,237,42,290,569
Comal,205,Proposition #6,,DEM,No,5,0,11,16
Comal,205,Proposition #6,,DEM,Cast Votes:,242,42,301,585
Comal,205,Proposition #6,,DEM,Under Votes,12,1,11,24
Comal,205,Proposition #6,,DEM,Over Votes,0,0,0,0
Comal,205,Proposition #7,,DEM,Yes,226,40,281,547
Comal,205,Proposition #7,,DEM,No,17,1,21,39
Comal,205,Proposition #7,,DEM,Cast Votes:,243,41,302,586
Comal,205,Proposition #7,,DEM,Under Votes,11,2,10,23
Comal,205,Proposition #7,,DEM,Over Votes,0,0,0,0
Comal,205,Proposition #8,,DEM,Yes,233,41,289,563
Comal,205,Proposition #8,,DEM,No,11,0,16,27
Comal,205,Proposition #8,,DEM,Cast Votes:,244,41,305,590
Comal,205,Proposition #8,,DEM,Under Votes,10,0,7,17
Comal,205,Proposition #8,,DEM,Over Votes,0,0,0,0
Comal,205,Proposition #9,,DEM,Yes,237,39,296,572
Comal,205,Proposition #9,,DEM,No,6,0,5,11
Comal,205,Proposition #9,,DEM,Cast Votes:,243,39,301,583
Comal,205,Proposition #9,,DEM,Under Votes,11,2,11,24
Comal,205,Proposition #9,,DEM,Over Votes,0,0,0,0
Comal,205,Proposition #10,,DEM,Yes,235,40,283,558
Comal,205,Proposition #10,,DEM,No,8,0,19,27
Comal,205,Proposition #10,,DEM,Cast Votes:,243,40,302,585
Comal,205,Proposition #10,,DEM,Under Votes,11,1,10,22
Comal,205,Proposition #10,,DEM,Over Votes,0,0,0,0
Comal,205,Proposition #11,,DEM,Yes,228,38,276,542
Comal,205,Proposition #11,,DEM,No,14,1,26,41
Comal,205,Proposition #11,,DEM,Cast Votes:,242,39,302,583
Comal,205,Proposition #11,,DEM,Under Votes,12,2,10,24
Comal,205,Proposition #11,,DEM,Over Votes,0,0,0,0
Comal,206,President,,DEM,Tulsi Gabbard,0,0,1,1
Comal,206,President,,DEM,Marianne Williamson,1,0,0,1
Comal,206,President,,DEM,John K. Delaney,0,0,1,1
Comal,206,President,,DEM,Elizabeth Warren,21,3,23,47
Comal,206,President,,DEM,Cory Booker,0,0,0,0
Comal,206,President,,DEM,Amy Klobuchar,0,6,17,23
Comal,206,President,,DEM,Joseph R. Biden,114,15,51,180
Comal,206,President,,DEM,Pete Buttigieg,2,4,36,42
Comal,206,President,,DEM,Juli치n Castro,0,0,0,0
Comal,206,President,,DEM,Tom Steyer,1,1,1,3
Comal,206,President,,DEM,Michael Bennet,0,1,0,1
Comal,206,President,,DEM,Michael R. Bloomberg,19,10,49,78
Comal,206,President,,DEM,Robby Wells,0,0,0,0
Comal,206,President,,DEM,"Roque ""Rocky"" De La Fuente",0,0,0,0
Comal,206,President,,DEM,Deval Patrick,0,0,0,0
Comal,206,President,,DEM,Bernie Sanders,55,6,42,103
Comal,206,President,,DEM,Andrew Yang,0,0,0,0
Comal,206,Ballots Cast,,DEM,,213,46,221,480
Comal,206,President,,DEM,Under Votes,0,0,0,0
Comal,206,President,,DEM,Over Votes,0,0,0,0
Comal,206,U.S. Senate,,DEM,Royce West,15,3,17,35
Comal,206,U.S. Senate,,DEM,Chris Bell,21,2,27,50
Comal,206,U.S. Senate,,DEM,Amanda K. Edwards,24,6,33,63
Comal,206,U.S. Senate,,DEM,Sema Hernandez,12,3,25,40
Comal,206,U.S. Senate,,DEM,Jack Daniel Foster Jr,5,0,5,10
Comal,206,U.S. Senate,,DEM,D.R. Hunter,2,2,2,6
Comal,206,U.S. Senate,,DEM,Adrian Ocegueda,4,0,2,6
Comal,206,U.S. Senate,,DEM,"Mary ""MJ"" Hegar",70,22,67,159
Comal,206,U.S. Senate,,DEM,Cristina Tzintzun Ramirez,16,1,14,31
Comal,206,U.S. Senate,,DEM,Michael Cooper,2,0,4,6
Comal,206,U.S. Senate,,DEM,Victor Hugo Harris,3,1,3,7
Comal,206,U.S. Senate,,DEM,"Annie ""Mam치"" Garcia",9,4,9,22
Comal,206,U.S. Senate,,DEM,Cast Votes:,183,44,208,435
Comal,206,U.S. Senate,,DEM,Under Votes,30,2,13,45
Comal,206,U.S. Senate,,DEM,Over Votes,0,0,0,0
Comal,206,U.S. House,21,DEM,Wendy R. Davis,163,35,166,364
Comal,206,U.S. House,21,DEM,Jennie Lou Leeder,23,9,38,70
Comal,206,U.S. House,21,DEM,Cast Votes:,186,44,204,434
Comal,206,U.S. House,21,DEM,Under Votes,27,2,17,46
Comal,206,U.S. House,21,DEM,Over Votes,0,0,0,0
Comal,206,Railroad Commissioner,,DEM,Mark Watson,30,5,31,66
Comal,206,Railroad Commissioner,,DEM,Chrysta Casta침eda,66,22,68,156
Comal,206,Railroad Commissioner,,DEM,Kelly Stone,37,5,41,83
Comal,206,Railroad Commissioner,,DEM,"Roberto R. ""Beto"" Alonzo",40,10,57,107
Comal,206,Railroad Commissioner,,DEM,Cast Votes:,173,42,197,412
Comal,206,Railroad Commissioner,,DEM,Under Votes,40,4,24,68
Comal,206,Railroad Commissioner,,DEM,Over Votes,0,0,0,0
Comal,206,"Chief Justice, Supreme Court",,DEM,Amy Clark Meachum,148,35,163,346
Comal,206,"Chief Justice, Supreme Court",,DEM,Jerry Zimmerer,21,6,33,60
Comal,206,"Chief Justice, Supreme Court",,DEM,Cast Votes:,169,41,196,406
Comal,206,"Chief Justice, Supreme Court",,DEM,Under Votes,44,5,25,74
Comal,206,"Chief Justice, Supreme Court",,DEM,Over Votes,0,0,0,0
Comal,206,"Justice, Supreme Court, Place 6 Unexpired Term",,DEM,Larry Praeger,36,10,55,101
Comal,206,"Justice, Supreme Court, Place 6 Unexpired Term",,DEM,Kathy Cheng,133,32,144,309
Comal,206,"Justice, Supreme Court, Place 6 Unexpired Term",,DEM,Cast Votes:,169,42,199,410
Comal,206,"Justice, Supreme Court, Place 6 Unexpired Term",,DEM,Under Votes,44,4,22,70
Comal,206,"Justice, Supreme Court, Place 6 Unexpired Term",,DEM,Over Votes,0,0,0,0
Comal,206,"Justice, Supreme Court, Place 7",,DEM,Staci Williams,108,29,121,258
Comal,206,"Justice, Supreme Court, Place 7",,DEM,Brandy Voss,55,13,73,141
Comal,206,"Justice, Supreme Court, Place 7",,DEM,Cast Votes:,163,42,194,399
Comal,206,"Justice, Supreme Court, Place 7",,DEM,Under Votes,50,4,27,81
Comal,206,"Justice, Supreme Court, Place 7",,DEM,Over Votes,0,0,0,0
Comal,206,"Justice, Supreme Court, Place 8",,DEM,Peter Kelly,43,9,56,108
Comal,206,"Justice, Supreme Court, Place 8",,DEM,Gisela D. Triana,121,33,140,294
Comal,206,"Justice, Supreme Court, Place 8",,DEM,Cast Votes:,164,42,196,402
Comal,206,"Justice, Supreme Court, Place 8",,DEM,Under Votes,49,4,25,78
Comal,206,"Justice, Supreme Court, Place 8",,DEM,Over Votes,0,0,0,0
Comal,206,"Judge, Court of Criminal Appeals, Place 3",,DEM,Elizabeth Davis Frizell,132,31,154,317
Comal,206,"Judge, Court of Criminal Appeals, Place 3",,DEM,William Pieratt Demond,9,3,10,22
Comal,206,"Judge, Court of Criminal Appeals, Place 3",,DEM,Dan Wood,18,5,29,52
Comal,206,"Judge, Court of Criminal Appeals, Place 3",,DEM,Cast Votes:,159,39,193,391
Comal,206,"Judge, Court of Criminal Appeals, Place 3",,DEM,Under Votes,54,7,28,89
Comal,206,"Judge, Court of Criminal Appeals, Place 3",,DEM,Over Votes,0,0,0,0
Comal,206,"Judge, Court of Criminal Appeals, Place 4",,DEM,Tina Clinton,133,33,169,335
Comal,206,"Judge, Court of Criminal Appeals, Place 4",,DEM,Steven Miears,25,9,27,61
Comal,206,"Judge, Court of Criminal Appeals, Place 4",,DEM,Cast Votes:,158,42,196,396
Comal,206,"Judge, Court of Criminal Appeals, Place 4",,DEM,Under Votes,55,4,25,84
Comal,206,"Judge, Court of Criminal Appeals, Place 4",,DEM,Over Votes,0,0,0,0
Comal,206,"Judge, Court of Criminal Appeals, Place 9",,DEM,Brandon Birmingham,145,36,179,360
Comal,206,"Judge, Court of Criminal Appeals, Place 9",,DEM,Cast Votes:,145,36,179,360
Comal,206,"Judge, Court of Criminal Appeals, Place 9",,DEM,Under Votes,68,10,42,120
Comal,206,"Judge, Court of Criminal Appeals, Place 9",,DEM,Over Votes,0,0,0,0
Comal,206,"Member, State Board of Education, District 5",,DEM,Rebecca Bell-Metereau,104,29,123,256
Comal,206,"Member, State Board of Education, District 5",,DEM,Letti Bresnahan,60,15,69,144
Comal,206,"Member, State Board of Education, District 5",,DEM,Cast Votes:,164,44,192,400
Comal,206,"Member, State Board of Education, District 5",,DEM,Under Votes,49,2,29,80
Comal,206,"Member, State Board of Education, District 5",,DEM,Over Votes,0,0,0,0
Comal,206,State Representative,73,DEM,Stephanie Phillips,151,37,187,375
Comal,206,State Representative,73,DEM,Cast Votes:,151,37,187,375
Comal,206,State Representative,73,DEM,Under Votes,62,9,34,105
Comal,206,State Representative,73,DEM,Over Votes,0,0,0,0
Comal,206,"Chief Justice, 3rd Court of Appeals District",,DEM,Darlene Byrne,132,38,149,319
Comal,206,"Chief Justice, 3rd Court of Appeals District",,DEM,Keith S. Hampton,31,5,39,75
Comal,206,"Chief Justice, 3rd Court of Appeals District",,DEM,Cast Votes:,163,43,188,394
Comal,206,"Chief Justice, 3rd Court of Appeals District",,DEM,Under Votes,50,3,33,86
Comal,206,"Chief Justice, 3rd Court of Appeals District",,DEM,Over Votes,0,0,0,0
Comal,206,County Chairman,,DEM,Gloria Meehan,155,35,187,377
Comal,206,County Chairman,,DEM,Cast Votes:,155,35,187,377
Comal,206,County Chairman,,DEM,Under Votes,58,11,34,103
Comal,206,County Chairman,,DEM,Over Votes,0,0,0,0
Comal,206,Proposition #1,,DEM,Yes,193,43,199,435
Comal,206,Proposition #1,,DEM,No,12,2,15,29
Comal,206,Proposition #1,,DEM,Cast Votes:,205,45,214,464
Comal,206,Proposition #1,,DEM,Under Votes,8,1,7,16
Comal,206,Proposition #1,,DEM,Over Votes,0,0,0,0
Comal,206,Proposition #2,,DEM,Yes,197,42,200,439
Comal,206,Proposition #2,,DEM,No,8,3,16,27
Comal,206,Proposition #2,,DEM,Cast Votes:,205,45,216,466
Comal,206,Proposition #2,,DEM,Under Votes,8,1,5,14
Comal,206,Proposition #2,,DEM,Over Votes,0,0,0,0
Comal,206,Proposition #3,,DEM,Yes,196,46,210,452
Comal,206,Proposition #3,,DEM,No,8,0,5,13
Comal,206,Proposition #3,,DEM,Cast Votes:,204,46,215,465
Comal,206,Proposition #3,,DEM,Under Votes,9,0,6,15
Comal,206,Proposition #3,,DEM,Over Votes,0,0,0,0
Comal,206,Proposition #4,,DEM,Yes,196,43,204,443
Comal,206,Proposition #4,,DEM,No,9,3,13,25
Comal,206,Proposition #4,,DEM,Cast Votes:,205,46,217,468
Comal,206,Proposition #4,,DEM,Under Votes,8,0,4,12
Comal,206,Proposition #4,,DEM,Over Votes,0,0,0,0
Comal,206,Proposition #5,,DEM,Yes,196,46,209,451
Comal,206,Proposition #5,,DEM,No,9,0,5,14
Comal,206,Proposition #5,,DEM,Cast Votes:,205,46,214,465
Comal,206,Proposition #5,,DEM,Under Votes,8,0,7,15
Comal,206,Proposition #5,,DEM,Over Votes,0,0,0,0
Comal,206,Proposition #6,,DEM,Yes,194,45,208,447
Comal,206,Proposition #6,,DEM,No,10,0,6,16
Comal,206,Proposition #6,,DEM,Cast Votes:,204,45,214,463
Comal,206,Proposition #6,,DEM,Under Votes,9,1,7,17
Comal,206,Proposition #6,,DEM,Over Votes,0,0,0,0
Comal,206,Proposition #7,,DEM,Yes,196,41,199,436
Comal,206,Proposition #7,,DEM,No,8,2,13,23
Comal,206,Proposition #7,,DEM,Cast Votes:,204,43,212,459
Comal,206,Proposition #7,,DEM,Under Votes,9,3,9,21
Comal,206,Proposition #7,,DEM,Over Votes,0,0,0,0
Comal,206,Proposition #8,,DEM,Yes,196,45,207,448
Comal,206,Proposition #8,,DEM,No,9,0,7,16
Comal,206,Proposition #8,,DEM,Cast Votes:,205,45,214,464
Comal,206,Proposition #8,,DEM,Under Votes,8,0,7,15
Comal,206,Proposition #8,,DEM,Over Votes,0,0,0,0
Comal,206,Proposition #9,,DEM,Yes,194,44,210,448
Comal,206,Proposition #9,,DEM,No,9,0,5,14
Comal,206,Proposition #9,,DEM,Cast Votes:,203,44,215,462
Comal,206,Proposition #9,,DEM,Under Votes,10,1,6,17
Comal,206,Proposition #9,,DEM,Over Votes,0,0,0,0
Comal,206,Proposition #10,,DEM,Yes,193,44,205,442
Comal,206,Proposition #10,,DEM,No,12,0,11,23
Comal,206,Proposition #10,,DEM,Cast Votes:,205,44,216,465
Comal,206,Proposition #10,,DEM,Under Votes,8,1,5,14
Comal,206,Proposition #10,,DEM,Over Votes,0,0,0,0
Comal,206,Proposition #11,,DEM,Yes,185,44,196,425
Comal,206,Proposition #11,,DEM,No,17,1,17,35
Comal,206,Proposition #11,,DEM,Cast Votes:,202,45,213,460
Comal,206,Proposition #11,,DEM,Under Votes,11,0,8,19
Comal,206,Proposition #11,,DEM,Over Votes,0,0,0,0
Comal,207,President,,DEM,Tulsi Gabbard,1,0,0,1
Comal,207,President,,DEM,Marianne Williamson,0,0,0,0
Comal,207,President,,DEM,John K. Delaney,1,0,0,1
Comal,207,President,,DEM,Elizabeth Warren,9,1,4,14
Comal,207,President,,DEM,Cory Booker,0,0,0,0
Comal,207,President,,DEM,Amy Klobuchar,0,1,6,7
Comal,207,President,,DEM,Joseph R. Biden,53,4,8,65
Comal,207,President,,DEM,Pete Buttigieg,0,1,11,12
Comal,207,President,,DEM,Juli치n Castro,0,0,0,0
Comal,207,President,,DEM,Tom Steyer,0,0,0,0
Comal,207,President,,DEM,Michael Bennet,0,0,0,0
Comal,207,President,,DEM,Michael R. Bloomberg,8,7,12,27
Comal,207,President,,DEM,Robby Wells,0,0,0,0
Comal,207,President,,DEM,"Roque ""Rocky"" De La Fuente",0,0,0,0
Comal,207,President,,DEM,Deval Patrick,0,0,0,0
Comal,207,President,,DEM,Bernie Sanders,10,1,18,29
Comal,207,President,,DEM,Andrew Yang,0,0,1,1
Comal,207,Ballots Cast,,DEM,,82,15,60,157
Comal,207,President,,DEM,Under Votes,1,0,0,1
Comal,207,President,,DEM,Over Votes,0,0,0,0
Comal,207,U.S. Senate,,DEM,Royce West,7,1,3,11
Comal,207,U.S. Senate,,DEM,Chris Bell,8,0,3,11
Comal,207,U.S. Senate,,DEM,Amanda K. Edwards,7,4,6,17
Comal,207,U.S. Senate,,DEM,Sema Hernandez,10,0,2,12
Comal,207,U.S. Senate,,DEM,Jack Daniel Foster Jr,3,0,0,3
Comal,207,U.S. Senate,,DEM,D.R. Hunter,0,0,2,2
Comal,207,U.S. Senate,,DEM,Adrian Ocegueda,2,0,1,3
Comal,207,U.S. Senate,,DEM,"Mary ""MJ"" Hegar",23,9,26,58
Comal,207,U.S. Senate,,DEM,Cristina Tzintzun Ramirez,4,0,1,5
Comal,207,U.S. Senate,,DEM,Michael Cooper,2,0,1,3
Comal,207,U.S. Senate,,DEM,Victor Hugo Harris,0,0,0,0
Comal,207,U.S. Senate,,DEM,"Annie ""Mam치"" Garcia",5,0,2,7
Comal,207,U.S. Senate,,DEM,Cast Votes:,71,14,47,132
Comal,207,U.S. Senate,,DEM,Under Votes,12,1,13,26
Comal,207,U.S. Senate,,DEM,Over Votes,0,0,0,0
Comal,207,U.S. House,21,DEM,Wendy R. Davis,61,7,39,107
Comal,207,U.S. House,21,DEM,Jennie Lou Leeder,9,6,9,24
Comal,207,U.S. House,21,DEM,Cast Votes:,70,13,48,131
Comal,207,U.S. House,21,DEM,Under Votes,13,2,12,27
Comal,207,U.S. House,21,DEM,Over Votes,0,0,0,0
Comal,207,Railroad Commissioner,,DEM,Mark Watson,14,0,7,21
Comal,207,Railroad Commissioner,,DEM,Chrysta Casta침eda,16,7,18,41
Comal,207,Railroad Commissioner,,DEM,Kelly Stone,12,2,14,28
Comal,207,Railroad Commissioner,,DEM,"Roberto R. ""Beto"" Alonzo",19,4,6,29
Comal,207,Railroad Commissioner,,DEM,Cast Votes:,61,13,45,119
Comal,207,Railroad Commissioner,,DEM,Under Votes,22,2,15,39
Comal,207,Railroad Commissioner,,DEM,Over Votes,0,0,0,0
Comal,207,"Chief Justice, Supreme Court",,DEM,Amy Clark Meachum,50,12,36,98
Comal,207,"Chief Justice, Supreme Court",,DEM,Jerry Zimmerer,10,1,7,18
Comal,207,"Chief Justice, Supreme Court",,DEM,Cast Votes:,60,13,43,116
Comal,207,"Chief Justice, Supreme Court",,DEM,Under Votes,23,2,17,42
Comal,207,"Chief Justice, Supreme Court",,DEM,Over Votes,0,0,0,0
Comal,207,"Justice, Supreme Court, Place 6 Unexpired Term",,DEM,Larry Praeger,12,2,15,29
Comal,207,"Justice, Supreme Court, Place 6 Unexpired Term",,DEM,Kathy Cheng,47,11,28,86
Comal,207,"Justice, Supreme Court, Place 6 Unexpired Term",,DEM,Cast Votes:,59,13,43,115
Comal,207,"Justice, Supreme Court, Place 6 Unexpired Term",,DEM,Under Votes,24,2,17,43
Comal,207,"Justice, Supreme Court, Place 6 Unexpired Term",,DEM,Over Votes,0,0,0,0
Comal,207,"Justice, Supreme Court, Place 7",,DEM,Staci Williams,41,8,28,77
Comal,207,"Justice, Supreme Court, Place 7",,DEM,Brandy Voss,20,5,14,39
Comal,207,"Justice, Supreme Court, Place 7",,DEM,Cast Votes:,61,13,42,116
Comal,207,"Justice, Supreme Court, Place 7",,DEM,Under Votes,22,2,18,42
Comal,207,"Justice, Supreme Court, Place 7",,DEM,Over Votes,0,0,0,0
Comal,207,"Justice, Supreme Court, Place 8",,DEM,Peter Kelly,16,1,13,30
Comal,207,"Justice, Supreme Court, Place 8",,DEM,Gisela D. Triana,42,12,29,83
Comal,207,"Justice, Supreme Court, Place 8",,DEM,Cast Votes:,58,13,42,113
Comal,207,"Justice, Supreme Court, Place 8",,DEM,Under Votes,25,2,18,45
Comal,207,"Justice, Supreme Court, Place 8",,DEM,Over Votes,0,0,0,0
Comal,207,"Judge, Court of Criminal Appeals, Place 3",,DEM,Elizabeth Davis Frizell,44,10,32,86
Comal,207,"Judge, Court of Criminal Appeals, Place 3",,DEM,William Pieratt Demond,2,0,4,6
Comal,207,"Judge, Court of Criminal Appeals, Place 3",,DEM,Dan Wood,11,3,6,20
Comal,207,"Judge, Court of Criminal Appeals, Place 3",,DEM,Cast Votes:,57,13,42,112
Comal,207,"Judge, Court of Criminal Appeals, Place 3",,DEM,Under Votes,26,2,18,46
Comal,207,"Judge, Court of Criminal Appeals, Place 3",,DEM,Over Votes,0,0,0,0
Comal,207,"Judge, Court of Criminal Appeals, Place 4",,DEM,Tina Clinton,45,11,32,88
Comal,207,"Judge, Court of Criminal Appeals, Place 4",,DEM,Steven Miears,13,2,10,25
Comal,207,"Judge, Court of Criminal Appeals, Place 4",,DEM,Cast Votes:,58,13,42,113
Comal,207,"Judge, Court of Criminal Appeals, Place 4",,DEM,Under Votes,25,2,18,45
Comal,207,"Judge, Court of Criminal Appeals, Place 4",,DEM,Over Votes,0,0,0,0
Comal,207,"Judge, Court of Criminal Appeals, Place 9",,DEM,Brandon Birmingham,56,13,41,110
Comal,207,"Judge, Court of Criminal Appeals, Place 9",,DEM,Cast Votes:,56,13,41,110
Comal,207,"Judge, Court of Criminal Appeals, Place 9",,DEM,Under Votes,27,2,19,48
Comal,207,"Judge, Court of Criminal Appeals, Place 9",,DEM,Over Votes,0,0,0,0
Comal,207,"Member, State Board of Education, District 5",,DEM,Rebecca Bell-Metereau,36,11,25,72
Comal,207,"Member, State Board of Education, District 5",,DEM,Letti Bresnahan,26,2,16,44
Comal,207,"Member, State Board of Education, District 5",,DEM,Cast Votes:,62,13,41,116
Comal,207,"Member, State Board of Education, District 5",,DEM,Under Votes,21,2,19,42
Comal,207,"Member, State Board of Education, District 5",,DEM,Over Votes,0,0,0,0
Comal,207,State Representative,73,DEM,Stephanie Phillips,65,13,44,122
Comal,207,State Representative,73,DEM,Cast Votes:,65,13,44,122
Comal,207,State Representative,73,DEM,Under Votes,18,2,16,36
Comal,207,State Representative,73,DEM,Over Votes,0,0,0,0
Comal,207,"Chief Justice, 3rd Court of Appeals District",,DEM,Darlene Byrne,45,12,34,91
Comal,207,"Chief Justice, 3rd Court of Appeals District",,DEM,Keith S. Hampton,12,1,8,21
Comal,207,"Chief Justice, 3rd Court of Appeals District",,DEM,Cast Votes:,57,13,42,112
Comal,207,"Chief Justice, 3rd Court of Appeals District",,DEM,Under Votes,26,2,18,46
Comal,207,"Chief Justice, 3rd Court of Appeals District",,DEM,Over Votes,0,0,0,0
Comal,207,County Chairman,,DEM,Gloria Meehan,64,13,42,119
Comal,207,County Chairman,,DEM,Cast Votes:,64,13,42,119
Comal,207,County Chairman,,DEM,Under Votes,19,2,18,39
Comal,207,County Chairman,,DEM,Over Votes,0,0,0,0
Comal,207,Proposition #1,,DEM,Yes,73,12,48,133
Comal,207,Proposition #1,,DEM,No,6,1,6,13
Comal,207,Proposition #1,,DEM,Cast Votes:,79,13,54,146
Comal,207,Proposition #1,,DEM,Under Votes,4,2,6,12
Comal,207,Proposition #1,,DEM,Over Votes,0,0,0,0
Comal,207,Proposition #2,,DEM,Yes,72,11,46,129
Comal,207,Proposition #2,,DEM,No,4,2,8,14
Comal,207,Proposition #2,,DEM,Cast Votes:,76,13,54,143
Comal,207,Proposition #2,,DEM,Under Votes,7,2,6,15
Comal,207,Proposition #2,,DEM,Over Votes,0,0,0,0
Comal,207,Proposition #3,,DEM,Yes,76,15,49,140
Comal,207,Proposition #3,,DEM,No,1,0,5,6
Comal,207,Proposition #3,,DEM,Cast Votes:,77,15,54,146
Comal,207,Proposition #3,,DEM,Under Votes,6,0,6,12
Comal,207,Proposition #3,,DEM,Over Votes,0,0,0,0
Comal,207,Proposition #4,,DEM,Yes,72,11,48,131
Comal,207,Proposition #4,,DEM,No,5,0,6,11
Comal,207,Proposition #4,,DEM,Cast Votes:,77,11,54,142
Comal,207,Proposition #4,,DEM,Under Votes,6,4,6,16
Comal,207,Proposition #4,,DEM,Over Votes,0,0,0,0
Comal,207,Proposition #5,,DEM,Yes,76,11,52,139
Comal,207,Proposition #5,,DEM,No,1,0,3,4
Comal,207,Proposition #5,,DEM,Cast Votes:,77,11,55,143
Comal,207,Proposition #5,,DEM,Under Votes,6,4,5,15
Comal,207,Proposition #5,,DEM,Over Votes,0,0,0,0
Comal,207,Proposition #6,,DEM,Yes,74,12,51,137
Comal,207,Proposition #6,,DEM,No,2,1,3,6
Comal,207,Proposition #6,,DEM,Cast Votes:,76,13,54,143
Comal,207,Proposition #6,,DEM,Under Votes,7,2,6,15
Comal,207,Proposition #6,,DEM,Over Votes,0,0,0,0
Comal,207,Proposition #7,,DEM,Yes,73,8,46,127
Comal,207,Proposition #7,,DEM,No,1,1,6,8
Comal,207,Proposition #7,,DEM,Cast Votes:,74,9,52,135
Comal,207,Proposition #7,,DEM,Under Votes,9,6,8,23
Comal,207,Proposition #7,,DEM,Over Votes,0,0,0,0
Comal,207,Proposition #8,,DEM,Yes,75,13,50,138
Comal,207,Proposition #8,,DEM,No,1,0,5,6
Comal,207,Proposition #8,,DEM,Cast Votes:,76,13,55,144
Comal,207,Proposition #8,,DEM,Under Votes,7,2,5,14
Comal,207,Proposition #8,,DEM,Over Votes,0,0,0,0
Comal,207,Proposition #9,,DEM,Yes,75,13,50,138
Comal,207,Proposition #9,,DEM,No,0,0,4,4
Comal,207,Proposition #9,,DEM,Cast Votes:,75,13,54,142
Comal,207,Proposition #9,,DEM,Under Votes,8,2,6,16
Comal,207,Proposition #9,,DEM,Over Votes,0,0,0,0
Comal,207,Proposition #10,,DEM,Yes,74,13,46,133
Comal,207,Proposition #10,,DEM,No,2,0,8,10
Comal,207,Proposition #10,,DEM,Cast Votes:,76,13,54,143
Comal,207,Proposition #10,,DEM,Under Votes,7,2,6,15
Comal,207,Proposition #10,,DEM,Over Votes,0,0,0,0
Comal,207,Proposition #11,,DEM,Yes,68,9,47,124
Comal,207,Proposition #11,,DEM,No,8,2,7,17
Comal,207,Proposition #11,,DEM,Cast Votes:,76,11,54,141
Comal,207,Proposition #11,,DEM,Under Votes,7,4,6,17
Comal,207,Proposition #11,,DEM,Over Votes,0,0,0,0
Comal,208,President,,DEM,Tulsi Gabbard,0,0,3,3
Comal,208,President,,DEM,Marianne Williamson,0,0,0,0
Comal,208,President,,DEM,John K. Delaney,0,0,0,0
Comal,208,President,,DEM,Elizabeth Warren,5,2,10,17
Comal,208,President,,DEM,Cory Booker,0,0,0,0
Comal,208,President,,DEM,Amy Klobuchar,0,4,8,12
Comal,208,President,,DEM,Joseph R. Biden,58,7,18,83
Comal,208,President,,DEM,Pete Buttigieg,0,5,4,9
Comal,208,President,,DEM,Juli치n Castro,0,0,0,0
Comal,208,President,,DEM,Tom Steyer,1,0,1,2
Comal,208,President,,DEM,Michael Bennet,0,0,0,0
Comal,208,President,,DEM,Michael R. Bloomberg,14,6,14,34
Comal,208,President,,DEM,Robby Wells,0,0,0,0
Comal,208,President,,DEM,"Roque ""Rocky"" De La Fuente",0,0,0,0
Comal,208,President,,DEM,Deval Patrick,0,0,0,0
Comal,208,President,,DEM,Bernie Sanders,19,1,13,33
Comal,208,President,,DEM,Andrew Yang,0,0,0,0
Comal,208,Ballots Cast,,DEM,,97,25,71,193
Comal,208,President,,DEM,Under Votes,0,0,0,0
Comal,208,President,,DEM,Over Votes,0,0,0,0
Comal,208,U.S. Senate,,DEM,Royce West,4,2,6,12
Comal,208,U.S. Senate,,DEM,Chris Bell,7,5,11,23
Comal,208,U.S. Senate,,DEM,Amanda K. Edwards,16,3,7,26
Comal,208,U.S. Senate,,DEM,Sema Hernandez,9,1,5,15
Comal,208,U.S. Senate,,DEM,Jack Daniel Foster Jr,2,0,1,3
Comal,208,U.S. Senate,,DEM,D.R. Hunter,2,0,0,2
Comal,208,U.S. Senate,,DEM,Adrian Ocegueda,3,0,2,5
Comal,208,U.S. Senate,,DEM,"Mary ""MJ"" Hegar",30,9,30,69
Comal,208,U.S. Senate,,DEM,Cristina Tzintzun Ramirez,4,1,1,6
Comal,208,U.S. Senate,,DEM,Michael Cooper,3,0,1,4
Comal,208,U.S. Senate,,DEM,Victor Hugo Harris,0,1,2,3
Comal,208,U.S. Senate,,DEM,"Annie ""Mam치"" Garcia",5,1,0,6
Comal,208,U.S. Senate,,DEM,Cast Votes:,85,23,66,174
Comal,208,U.S. Senate,,DEM,Under Votes,12,2,5,19
Comal,208,U.S. Senate,,DEM,Over Votes,0,0,0,0
Comal,208,U.S. House,21,DEM,Wendy R. Davis,70,24,51,145
Comal,208,U.S. House,21,DEM,Jennie Lou Leeder,18,0,13,31
Comal,208,U.S. House,21,DEM,Cast Votes:,88,24,64,176
Comal,208,U.S. House,21,DEM,Under Votes,9,1,7,17
Comal,208,U.S. House,21,DEM,Over Votes,0,0,0,0
Comal,208,Railroad Commissioner,,DEM,Mark Watson,14,3,17,34
Comal,208,Railroad Commissioner,,DEM,Chrysta Casta침eda,22,8,17,47
Comal,208,Railroad Commissioner,,DEM,Kelly Stone,25,7,21,53
Comal,208,Railroad Commissioner,,DEM,"Roberto R. ""Beto"" Alonzo",20,3,8,31
Comal,208,Railroad Commissioner,,DEM,Cast Votes:,81,21,63,165
Comal,208,Railroad Commissioner,,DEM,Under Votes,16,4,8,28
Comal,208,Railroad Commissioner,,DEM,Over Votes,0,0,0,0
Comal,208,"Chief Justice, Supreme Court",,DEM,Amy Clark Meachum,63,17,55,135
Comal,208,"Chief Justice, Supreme Court",,DEM,Jerry Zimmerer,18,1,7,26
Comal,208,"Chief Justice, Supreme Court",,DEM,Cast Votes:,81,18,62,161
Comal,208,"Chief Justice, Supreme Court",,DEM,Under Votes,16,7,9,32
Comal,208,"Chief Justice, Supreme Court",,DEM,Over Votes,0,0,0,0
Comal,208,"Justice, Supreme Court, Place 6 Unexpired Term",,DEM,Larry Praeger,26,6,20,52
Comal,208,"Justice, Supreme Court, Place 6 Unexpired Term",,DEM,Kathy Cheng,54,14,43,111
Comal,208,"Justice, Supreme Court, Place 6 Unexpired Term",,DEM,Cast Votes:,80,20,63,163
Comal,208,"Justice, Supreme Court, Place 6 Unexpired Term",,DEM,Under Votes,17,5,8,30
Comal,208,"Justice, Supreme Court, Place 6 Unexpired Term",,DEM,Over Votes,0,0,0,0
Comal,208,"Justice, Supreme Court, Place 7",,DEM,Staci Williams,50,11,38,99
Comal,208,"Justice, Supreme Court, Place 7",,DEM,Brandy Voss,29,9,24,62
Comal,208,"Justice, Supreme Court, Place 7",,DEM,Cast Votes:,79,20,62,161
Comal,208,"Justice, Supreme Court, Place 7",,DEM,Under Votes,18,5,9,32
Comal,208,"Justice, Supreme Court, Place 7",,DEM,Over Votes,0,0,0,0
Comal,208,"Justice, Supreme Court, Place 8",,DEM,Peter Kelly,24,6,23,53
Comal,208,"Justice, Supreme Court, Place 8",,DEM,Gisela D. Triana,55,13,41,109
Comal,208,"Justice, Supreme Court, Place 8",,DEM,Cast Votes:,79,19,64,162
Comal,208,"Justice, Supreme Court, Place 8",,DEM,Under Votes,18,6,7,31
Comal,208,"Justice, Supreme Court, Place 8",,DEM,Over Votes,0,0,0,0
Comal,208,"Judge, Court of Criminal Appeals, Place 3",,DEM,Elizabeth Davis Frizell,56,15,39,110
Comal,208,"Judge, Court of Criminal Appeals, Place 3",,DEM,William Pieratt Demond,7,2,10,19
Comal,208,"Judge, Court of Criminal Appeals, Place 3",,DEM,Dan Wood,15,2,11,28
Comal,208,"Judge, Court of Criminal Appeals, Place 3",,DEM,Cast Votes:,78,19,60,157
Comal,208,"Judge, Court of Criminal Appeals, Place 3",,DEM,Under Votes,19,6,11,36
Comal,208,"Judge, Court of Criminal Appeals, Place 3",,DEM,Over Votes,0,0,0,0
Comal,208,"Judge, Court of Criminal Appeals, Place 4",,DEM,Tina Clinton,56,17,46,119
Comal,208,"Judge, Court of Criminal Appeals, Place 4",,DEM,Steven Miears,22,2,12,36
Comal,208,"Judge, Court of Criminal Appeals, Place 4",,DEM,Cast Votes:,78,19,58,155
Comal,208,"Judge, Court of Criminal Appeals, Place 4",,DEM,Under Votes,19,6,13,38
Comal,208,"Judge, Court of Criminal Appeals, Place 4",,DEM,Over Votes,0,0,0,0
Comal,208,"Judge, Court of Criminal Appeals, Place 9",,DEM,Brandon Birmingham,74,13,50,137
Comal,208,"Judge, Court of Criminal Appeals, Place 9",,DEM,Cast Votes:,74,13,50,137
Comal,208,"Judge, Court of Criminal Appeals, Place 9",,DEM,Under Votes,23,12,21,56
Comal,208,"Judge, Court of Criminal Appeals, Place 9",,DEM,Over Votes,0,0,0,0
Comal,208,"Member, State Board of Education, District 5",,DEM,Rebecca Bell-Metereau,52,14,32,98
Comal,208,"Member, State Board of Education, District 5",,DEM,Letti Bresnahan,25,4,29,58
Comal,208,"Member, State Board of Education, District 5",,DEM,Cast Votes:,77,18,61,156
Comal,208,"Member, State Board of Education, District 5",,DEM,Under Votes,20,7,10,37
Comal,208,"Member, State Board of Education, District 5",,DEM,Over Votes,0,0,0,0
Comal,208,State Representative,73,DEM,Stephanie Phillips,76,15,56,147
Comal,208,State Representative,73,DEM,Cast Votes:,76,15,56,147
Comal,208,State Representative,73,DEM,Under Votes,21,10,15,46
Comal,208,State Representative,73,DEM,Over Votes,0,0,0,0
Comal,208,"Chief Justice, 3rd Court of Appeals District",,DEM,Darlene Byrne,60,15,46,121
Comal,208,"Chief Justice, 3rd Court of Appeals District",,DEM,Keith S. Hampton,17,3,13,33
Comal,208,"Chief Justice, 3rd Court of Appeals District",,DEM,Cast Votes:,77,18,59,154
Comal,208,"Chief Justice, 3rd Court of Appeals District",,DEM,Under Votes,20,7,12,39
Comal,208,"Chief Justice, 3rd Court of Appeals District",,DEM,Over Votes,0,0,0,0
Comal,208,County Chairman,,DEM,Gloria Meehan,74,15,55,144
Comal,208,County Chairman,,DEM,Cast Votes:,74,15,55,144
Comal,208,County Chairman,,DEM,Under Votes,23,10,16,49
Comal,208,County Chairman,,DEM,Over Votes,0,0,0,0
Comal,208,Proposition #1,,DEM,Yes,74,18,58,150
Comal,208,Proposition #1,,DEM,No,17,3,11,31
Comal,208,Proposition #1,,DEM,Cast Votes:,91,21,69,181
Comal,208,Proposition #1,,DEM,Under Votes,6,4,2,12
Comal,208,Proposition #1,,DEM,Over Votes,0,0,0,0
Comal,208,Proposition #2,,DEM,Yes,78,21,59,158
Comal,208,Proposition #2,,DEM,No,14,0,9,23
Comal,208,Proposition #2,,DEM,Cast Votes:,92,21,68,181
Comal,208,Proposition #2,,DEM,Under Votes,5,4,3,12
Comal,208,Proposition #2,,DEM,Over Votes,0,0,0,0
Comal,208,Proposition #3,,DEM,Yes,85,22,66,173
Comal,208,Proposition #3,,DEM,No,7,0,2,9
Comal,208,Proposition #3,,DEM,Cast Votes:,92,22,68,182
Comal,208,Proposition #3,,DEM,Under Votes,5,3,3,11
Comal,208,Proposition #3,,DEM,Over Votes,0,0,0,0
Comal,208,Proposition #4,,DEM,Yes,79,16,62,157
Comal,208,Proposition #4,,DEM,No,13,1,7,21
Comal,208,Proposition #4,,DEM,Cast Votes:,92,17,69,178
Comal,208,Proposition #4,,DEM,Under Votes,5,8,2,15
Comal,208,Proposition #4,,DEM,Over Votes,0,0,0,0
Comal,208,Proposition #5,,DEM,Yes,87,19,68,174
Comal,208,Proposition #5,,DEM,No,6,0,2,8
Comal,208,Proposition #5,,DEM,Cast Votes:,93,19,70,182
Comal,208,Proposition #5,,DEM,Under Votes,4,6,1,11
Comal,208,Proposition #5,,DEM,Over Votes,0,0,0,0
Comal,208,Proposition #6,,DEM,Yes,87,20,66,173
Comal,208,Proposition #6,,DEM,No,5,0,2,7
Comal,208,Proposition #6,,DEM,Cast Votes:,92,20,68,180
Comal,208,Proposition #6,,DEM,Under Votes,5,5,3,13
Comal,208,Proposition #6,,DEM,Over Votes,0,0,0,0
Comal,208,Proposition #7,,DEM,Yes,79,17,63,159
Comal,208,Proposition #7,,DEM,No,12,2,4,18
Comal,208,Proposition #7,,DEM,Cast Votes:,91,19,67,177
Comal,208,Proposition #7,,DEM,Under Votes,6,6,4,16
Comal,208,Proposition #7,,DEM,Over Votes,0,0,0,0
Comal,208,Proposition #8,,DEM,Yes,84,17,61,162
Comal,208,Proposition #8,,DEM,No,7,1,5,13
Comal,208,Proposition #8,,DEM,Cast Votes:,91,18,66,175
Comal,208,Proposition #8,,DEM,Under Votes,6,6,5,17
Comal,208,Proposition #8,,DEM,Over Votes,0,0,0,0
Comal,208,Proposition #9,,DEM,Yes,87,20,67,174
Comal,208,Proposition #9,,DEM,No,4,0,2,6
Comal,208,Proposition #9,,DEM,Cast Votes:,91,20,69,180
Comal,208,Proposition #9,,DEM,Under Votes,6,4,2,12
Comal,208,Proposition #9,,DEM,Over Votes,0,0,0,0
Comal,208,Proposition #10,,DEM,Yes,85,20,63,168
Comal,208,Proposition #10,,DEM,No,7,1,5,13
Comal,208,Proposition #10,,DEM,Cast Votes:,92,21,68,181
Comal,208,Proposition #10,,DEM,Under Votes,5,3,3,11
Comal,208,Proposition #10,,DEM,Over Votes,0,0,0,0
Comal,208,Proposition #11,,DEM,Yes,76,18,59,153
Comal,208,Proposition #11,,DEM,No,15,1,5,21
Comal,208,Proposition #11,,DEM,Cast Votes:,91,19,64,174
Comal,208,Proposition #11,,DEM,Under Votes,6,5,7,18
Comal,208,Proposition #11,,DEM,Over Votes,0,0,0,0
Comal,301,President,,DEM,Tulsi Gabbard,3,0,0,3
Comal,301,President,,DEM,Marianne Williamson,0,0,0,0
Comal,301,President,,DEM,John K. Delaney,0,0,1,1
Comal,301,President,,DEM,Elizabeth Warren,28,4,27,59
Comal,301,President,,DEM,Cory Booker,1,0,1,2
Comal,301,President,,DEM,Amy Klobuchar,1,2,4,7
Comal,301,President,,DEM,Joseph R. Biden,88,18,21,127
Comal,301,President,,DEM,Pete Buttigieg,2,4,12,18
Comal,301,President,,DEM,Juli치n Castro,3,0,2,5
Comal,301,President,,DEM,Tom Steyer,0,0,0,0
Comal,301,President,,DEM,Michael Bennet,0,0,0,0
Comal,301,President,,DEM,Michael R. Bloomberg,19,20,12,51
Comal,301,President,,DEM,Robby Wells,0,0,0,0
Comal,301,President,,DEM,"Roque ""Rocky"" De La Fuente",1,0,0,1
Comal,301,President,,DEM,Deval Patrick,0,0,0,0
Comal,301,President,,DEM,Bernie Sanders,104,8,61,173
Comal,301,President,,DEM,Andrew Yang,2,0,0,2
Comal,301,Ballots Cast,,DEM,,252,56,141,449
Comal,301,President,,DEM,Under Votes,3,0,0,3
Comal,301,President,,DEM,Over Votes,0,0,0,0
Comal,301,U.S. Senate,,DEM,Royce West,12,5,5,22
Comal,301,U.S. Senate,,DEM,Chris Bell,18,5,12,35
Comal,301,U.S. Senate,,DEM,Amanda K. Edwards,23,1,14,38
Comal,301,U.S. Senate,,DEM,Sema Hernandez,60,8,19,87
Comal,301,U.S. Senate,,DEM,Jack Daniel Foster Jr,5,3,4,12
Comal,301,U.S. Senate,,DEM,D.R. Hunter,4,0,3,7
Comal,301,U.S. Senate,,DEM,Adrian Ocegueda,7,1,6,14
Comal,301,U.S. Senate,,DEM,"Mary ""MJ"" Hegar",34,9,29,72
Comal,301,U.S. Senate,,DEM,Cristina Tzintzun Ramirez,22,14,15,51
Comal,301,U.S. Senate,,DEM,Michael Cooper,3,0,0,3
Comal,301,U.S. Senate,,DEM,Victor Hugo Harris,5,0,2,7
Comal,301,U.S. Senate,,DEM,"Annie ""Mam치"" Garcia",28,7,17,52
Comal,301,U.S. Senate,,DEM,Cast Votes:,221,53,126,400
Comal,301,U.S. Senate,,DEM,Under Votes,34,3,15,52
Comal,301,U.S. Senate,,DEM,Over Votes,0,0,0,0
Comal,301,U.S. House,35,DEM,Rafael Alcoser III,116,9,35,160
Comal,301,U.S. House,35,DEM,Lloyd Doggett,118,42,95,255
Comal,301,U.S. House,35,DEM,Cast Votes:,234,51,130,415
Comal,301,U.S. House,35,DEM,Under Votes,21,5,11,37
Comal,301,U.S. House,35,DEM,Over Votes,0,0,0,0
Comal,301,Railroad Commissioner,,DEM,Mark Watson,23,8,14,45
Comal,301,Railroad Commissioner,,DEM,Chrysta Casta침eda,73,19,52,144
Comal,301,Railroad Commissioner,,DEM,Kelly Stone,46,6,24,76
Comal,301,Railroad Commissioner,,DEM,"Roberto R. ""Beto"" Alonzo",76,19,37,132
Comal,301,Railroad Commissioner,,DEM,Cast Votes:,218,52,127,397
Comal,301,Railroad Commissioner,,DEM,Under Votes,37,4,14,55
Comal,301,Railroad Commissioner,,DEM,Over Votes,0,0,0,0
Comal,301,"Chief Justice, Supreme Court",,DEM,Amy Clark Meachum,177,39,108,324
Comal,301,"Chief Justice, Supreme Court",,DEM,Jerry Zimmerer,38,9,18,65
Comal,301,"Chief Justice, Supreme Court",,DEM,Cast Votes:,215,48,126,389
Comal,301,"Chief Justice, Supreme Court",,DEM,Under Votes,40,8,15,63
Comal,301,"Chief Justice, Supreme Court",,DEM,Over Votes,0,0,0,0
Comal,301,"Justice, Supreme Court, Place 6 Unexpired Term",,DEM,Larry Praeger,38,18,19,75
Comal,301,"Justice, Supreme Court, Place 6 Unexpired Term",,DEM,Kathy Cheng,169,31,109,309
Comal,301,"Justice, Supreme Court, Place 6 Unexpired Term",,DEM,Cast Votes:,207,49,128,384
Comal,301,"Justice, Supreme Court, Place 6 Unexpired Term",,DEM,Under Votes,48,7,13,68
Comal,301,"Justice, Supreme Court, Place 6 Unexpired Term",,DEM,Over Votes,0,0,0,0
Comal,301,"Justice, Supreme Court, Place 7",,DEM,Staci Williams,147,31,84,262
Comal,301,"Justice, Supreme Court, Place 7",,DEM,Brandy Voss,62,16,42,120
Comal,301,"Justice, Supreme Court, Place 7",,DEM,Cast Votes:,209,47,126,382
Comal,301,"Justice, Supreme Court, Place 7",,DEM,Under Votes,46,9,15,70
Comal,301,"Justice, Supreme Court, Place 7",,DEM,Over Votes,0,0,0,0
Comal,301,"Justice, Supreme Court, Place 8",,DEM,Peter Kelly,48,13,21,82
Comal,301,"Justice, Supreme Court, Place 8",,DEM,Gisela D. Triana,161,37,107,305
Comal,301,"Justice, Supreme Court, Place 8",,DEM,Cast Votes:,209,50,128,387
Comal,301,"Justice, Supreme Court, Place 8",,DEM,Under Votes,46,6,13,65
Comal,301,"Justice, Supreme Court, Place 8",,DEM,Over Votes,0,0,0,0
Comal,301,"Judge, Court of Criminal Appeals, Place 3",,DEM,Elizabeth Davis Frizell,152,32,96,280
Comal,301,"Judge, Court of Criminal Appeals, Place 3",,DEM,William Pieratt Demond,17,5,17,39
Comal,301,"Judge, Court of Criminal Appeals, Place 3",,DEM,Dan Wood,33,12,14,59
Comal,301,"Judge, Court of Criminal Appeals, Place 3",,DEM,Cast Votes:,202,49,127,378
Comal,301,"Judge, Court of Criminal Appeals, Place 3",,DEM,Under Votes,53,7,14,74
Comal,301,"Judge, Court of Criminal Appeals, Place 3",,DEM,Over Votes,0,0,0,0
Comal,301,"Judge, Court of Criminal Appeals, Place 4",,DEM,Tina Clinton,155,39,103,297
Comal,301,"Judge, Court of Criminal Appeals, Place 4",,DEM,Steven Miears,46,10,23,79
Comal,301,"Judge, Court of Criminal Appeals, Place 4",,DEM,Cast Votes:,201,49,126,376
Comal,301,"Judge, Court of Criminal Appeals, Place 4",,DEM,Under Votes,54,7,15,76
Comal,301,"Judge, Court of Criminal Appeals, Place 4",,DEM,Over Votes,0,0,0,0
Comal,301,"Judge, Court of Criminal Appeals, Place 9",,DEM,Brandon Birmingham,187,44,113,344
Comal,301,"Judge, Court of Criminal Appeals, Place 9",,DEM,Cast Votes:,187,44,113,344
Comal,301,"Judge, Court of Criminal Appeals, Place 9",,DEM,Under Votes,68,12,28,108
Comal,301,"Judge, Court of Criminal Appeals, Place 9",,DEM,Over Votes,0,0,0,0
Comal,301,"Member, State Board of Education, District 5",,DEM,Rebecca Bell-Metereau,113,28,78,219
Comal,301,"Member, State Board of Education, District 5",,DEM,Letti Bresnahan,92,22,44,158
Comal,301,"Member, State Board of Education, District 5",,DEM,Cast Votes:,205,50,122,377
Comal,301,"Member, State Board of Education, District 5",,DEM,Under Votes,50,6,19,75
Comal,301,"Member, State Board of Education, District 5",,DEM,Over Votes,0,0,0,0
Comal,301,State Representative,73,DEM,Stephanie Phillips,198,46,116,360
Comal,301,State Representative,73,DEM,Cast Votes:,198,46,116,360
Comal,301,State Representative,73,DEM,Under Votes,57,10,25,92
Comal,301,State Representative,73,DEM,Over Votes,0,0,0,0
Comal,301,"Chief Justice, 3rd Court of Appeals District",,DEM,Darlene Byrne,161,36,107,304
Comal,301,"Chief Justice, 3rd Court of Appeals District",,DEM,Keith S. Hampton,44,13,18,75
Comal,301,"Chief Justice, 3rd Court of Appeals District",,DEM,Cast Votes:,205,49,125,379
Comal,301,"Chief Justice, 3rd Court of Appeals District",,DEM,Under Votes,50,7,16,73
Comal,301,"Chief Justice, 3rd Court of Appeals District",,DEM,Over Votes,0,0,0,0
Comal,301,"County Commissioner, Precinct 3",,DEM,Colette Nies,189,47,118,354
Comal,301,"County Commissioner, Precinct 3",,DEM,Cast Votes:,189,47,118,354
Comal,301,"County Commissioner, Precinct 3",,DEM,Under Votes,66,9,23,98
Comal,301,"County Commissioner, Precinct 3",,DEM,Over Votes,0,0,0,0
Comal,301,County Chairman,,DEM,Gloria Meehan,189,47,120,356
Comal,301,County Chairman,,DEM,Cast Votes:,189,47,120,356
Comal,301,County Chairman,,DEM,Under Votes,66,9,21,96
Comal,301,County Chairman,,DEM,Over Votes,0,0,0,0
Comal,301,Proposition #1,,DEM,Yes,245,52,134,431
Comal,301,Proposition #1,,DEM,No,6,1,4,11
Comal,301,Proposition #1,,DEM,Cast Votes:,251,53,138,442
Comal,301,Proposition #1,,DEM,Under Votes,4,3,3,10
Comal,301,Proposition #1,,DEM,Over Votes,0,0,0,0
Comal,301,Proposition #2,,DEM,Yes,243,53,134,430
Comal,301,Proposition #2,,DEM,No,5,0,4,9
Comal,301,Proposition #2,,DEM,Cast Votes:,248,53,138,439
Comal,301,Proposition #2,,DEM,Under Votes,7,3,3,13
Comal,301,Proposition #2,,DEM,Over Votes,0,0,0,0
Comal,301,Proposition #3,,DEM,Yes,244,54,136,434
Comal,301,Proposition #3,,DEM,No,4,0,3,7
Comal,301,Proposition #3,,DEM,Cast Votes:,248,54,139,441
Comal,301,Proposition #3,,DEM,Under Votes,7,2,2,11
Comal,301,Proposition #3,,DEM,Over Votes,0,0,0,0
Comal,301,Proposition #4,,DEM,Yes,244,54,134,432
Comal,301,Proposition #4,,DEM,No,5,0,5,10
Comal,301,Proposition #4,,DEM,Cast Votes:,249,54,139,442
Comal,301,Proposition #4,,DEM,Under Votes,6,2,2,10
Comal,301,Proposition #4,,DEM,Over Votes,0,0,0,0
Comal,301,Proposition #5,,DEM,Yes,245,54,136,435
Comal,301,Proposition #5,,DEM,No,4,0,3,7
Comal,301,Proposition #5,,DEM,Cast Votes:,249,54,139,442
Comal,301,Proposition #5,,DEM,Under Votes,6,1,2,9
Comal,301,Proposition #5,,DEM,Over Votes,0,1,0,1
Comal,301,Proposition #6,,DEM,Yes,243,54,134,431
Comal,301,Proposition #6,,DEM,No,5,0,3,8
Comal,301,Proposition #6,,DEM,Cast Votes:,248,54,137,439
Comal,301,Proposition #6,,DEM,Under Votes,7,2,4,13
Comal,301,Proposition #6,,DEM,Over Votes,0,0,0,0
Comal,301,Proposition #7,,DEM,Yes,238,52,134,424
Comal,301,Proposition #7,,DEM,No,5,0,6,11
Comal,301,Proposition #7,,DEM,Cast Votes:,243,52,140,435
Comal,301,Proposition #7,,DEM,Under Votes,12,4,1,17
Comal,301,Proposition #7,,DEM,Over Votes,0,0,0,0
Comal,301,Proposition #8,,DEM,Yes,243,53,132,428
Comal,301,Proposition #8,,DEM,No,6,0,6,12
Comal,301,Proposition #8,,DEM,Cast Votes:,249,53,138,440
Comal,301,Proposition #8,,DEM,Under Votes,6,2,3,11
Comal,301,Proposition #8,,DEM,Over Votes,0,0,0,0
Comal,301,Proposition #9,,DEM,Yes,245,54,135,434
Comal,301,Proposition #9,,DEM,No,5,0,3,8
Comal,301,Proposition #9,,DEM,Cast Votes:,250,54,138,442
Comal,301,Proposition #9,,DEM,Under Votes,5,1,3,9
Comal,301,Proposition #9,,DEM,Over Votes,0,0,0,0
Comal,301,Proposition #10,,DEM,Yes,240,51,132,423
Comal,301,Proposition #10,,DEM,No,9,1,8,18
Comal,301,Proposition #10,,DEM,Cast Votes:,249,52,140,441
Comal,301,Proposition #10,,DEM,Under Votes,6,3,1,10
Comal,301,Proposition #10,,DEM,Over Votes,0,0,0,0
Comal,301,Proposition #11,,DEM,Yes,232,48,127,407
Comal,301,Proposition #11,,DEM,No,13,3,11,27
Comal,301,Proposition #11,,DEM,Cast Votes:,245,51,138,434
Comal,301,Proposition #11,,DEM,Under Votes,10,4,3,17
Comal,301,Proposition #11,,DEM,Over Votes,0,0,0,0
Comal,302,President,,DEM,Tulsi Gabbard,1,0,1,2
Comal,302,President,,DEM,Marianne Williamson,1,0,0,1
Comal,302,President,,DEM,John K. Delaney,3,0,0,3
Comal,302,President,,DEM,Elizabeth Warren,44,9,40,93
Comal,302,President,,DEM,Cory Booker,0,0,1,1
Comal,302,President,,DEM,Amy Klobuchar,2,5,14,21
Comal,302,President,,DEM,Joseph R. Biden,116,18,42,176
Comal,302,President,,DEM,Pete Buttigieg,0,6,23,29
Comal,302,President,,DEM,Juli치n Castro,0,0,1,1
Comal,302,President,,DEM,Tom Steyer,1,0,4,5
Comal,302,President,,DEM,Michael Bennet,0,0,0,0
Comal,302,President,,DEM,Michael R. Bloomberg,25,23,24,72
Comal,302,President,,DEM,Robby Wells,0,0,0,0
Comal,302,President,,DEM,"Roque ""Rocky"" De La Fuente",0,0,0,0
Comal,302,President,,DEM,Deval Patrick,0,0,0,0
Comal,302,President,,DEM,Bernie Sanders,106,9,70,185
Comal,302,President,,DEM,Andrew Yang,0,1,0,1
Comal,302,Ballots Cast,,DEM,,299,71,220,590
Comal,302,President,,DEM,Under Votes,1,1,2,4
Comal,302,President,,DEM,Over Votes,0,0,0,0
Comal,302,U.S. Senate,,DEM,Royce West,11,7,12,30
Comal,302,U.S. Senate,,DEM,Chris Bell,20,8,20,48
Comal,302,U.S. Senate,,DEM,Amanda K. Edwards,38,11,21,70
Comal,302,U.S. Senate,,DEM,Sema Hernandez,45,7,17,69
Comal,302,U.S. Senate,,DEM,Jack Daniel Foster Jr,9,0,1,10
Comal,302,U.S. Senate,,DEM,D.R. Hunter,3,1,1,5
Comal,302,U.S. Senate,,DEM,Adrian Ocegueda,6,2,5,13
Comal,302,U.S. Senate,,DEM,"Mary ""MJ"" Hegar",61,16,83,160
Comal,302,U.S. Senate,,DEM,Cristina Tzintzun Ramirez,29,9,29,67
Comal,302,U.S. Senate,,DEM,Michael Cooper,1,0,1,2
Comal,302,U.S. Senate,,DEM,Victor Hugo Harris,1,0,3,4
Comal,302,U.S. Senate,,DEM,"Annie ""Mam치"" Garcia",32,6,10,48
Comal,302,U.S. Senate,,DEM,Cast Votes:,256,67,203,526
Comal,302,U.S. Senate,,DEM,Under Votes,44,5,19,68
Comal,302,U.S. Senate,,DEM,Over Votes,0,0,0,0
Comal,302,U.S. House,35,DEM,Rafael Alcoser III,79,16,44,139
Comal,302,U.S. House,35,DEM,Lloyd Doggett,185,50,162,397
Comal,302,U.S. House,35,DEM,Cast Votes:,264,66,206,536
Comal,302,U.S. House,35,DEM,Under Votes,36,6,15,57
Comal,302,U.S. House,35,DEM,Over Votes,0,0,1,1
Comal,302,Railroad Commissioner,,DEM,Mark Watson,43,12,24,79
Comal,302,Railroad Commissioner,,DEM,Chrysta Casta침eda,93,27,78,198
Comal,302,Railroad Commissioner,,DEM,Kelly Stone,54,7,51,112
Comal,302,Railroad Commissioner,,DEM,"Roberto R. ""Beto"" Alonzo",60,15,32,107
Comal,302,Railroad Commissioner,,DEM,Cast Votes:,250,61,185,496
Comal,302,Railroad Commissioner,,DEM,Under Votes,50,11,37,98
Comal,302,Railroad Commissioner,,DEM,Over Votes,0,0,0,0
Comal,302,"Chief Justice, Supreme Court",,DEM,Amy Clark Meachum,213,55,166,434
Comal,302,"Chief Justice, Supreme Court",,DEM,Jerry Zimmerer,34,7,21,62
Comal,302,"Chief Justice, Supreme Court",,DEM,Cast Votes:,247,62,187,496
Comal,302,"Chief Justice, Supreme Court",,DEM,Under Votes,53,10,35,98
Comal,302,"Chief Justice, Supreme Court",,DEM,Over Votes,0,0,0,0
Comal,302,"Justice, Supreme Court, Place 6 Unexpired Term",,DEM,Larry Praeger,45,18,55,118
Comal,302,"Justice, Supreme Court, Place 6 Unexpired Term",,DEM,Kathy Cheng,200,42,130,372
Comal,302,"Justice, Supreme Court, Place 6 Unexpired Term",,DEM,Cast Votes:,245,60,185,490
Comal,302,"Justice, Supreme Court, Place 6 Unexpired Term",,DEM,Under Votes,55,12,37,104
Comal,302,"Justice, Supreme Court, Place 6 Unexpired Term",,DEM,Over Votes,0,0,0,0
Comal,302,"Justice, Supreme Court, Place 7",,DEM,Staci Williams,151,31,110,292
Comal,302,"Justice, Supreme Court, Place 7",,DEM,Brandy Voss,90,29,68,187
Comal,302,"Justice, Supreme Court, Place 7",,DEM,Cast Votes:,241,60,178,479
Comal,302,"Justice, Supreme Court, Place 7",,DEM,Under Votes,59,12,44,115
Comal,302,"Justice, Supreme Court, Place 7",,DEM,Over Votes,0,0,0,0
Comal,302,"Justice, Supreme Court, Place 8",,DEM,Peter Kelly,58,20,39,117
Comal,302,"Justice, Supreme Court, Place 8",,DEM,Gisela D. Triana,187,39,141,367
Comal,302,"Justice, Supreme Court, Place 8",,DEM,Cast Votes:,245,59,180,484
Comal,302,"Justice, Supreme Court, Place 8",,DEM,Under Votes,55,13,42,110
Comal,302,"Justice, Supreme Court, Place 8",,DEM,Over Votes,0,0,0,0
Comal,302,"Judge, Court of Criminal Appeals, Place 3",,DEM,Elizabeth Davis Frizell,179,42,138,359
Comal,302,"Judge, Court of Criminal Appeals, Place 3",,DEM,William Pieratt Demond,23,10,13,46
Comal,302,"Judge, Court of Criminal Appeals, Place 3",,DEM,Dan Wood,38,10,21,69
Comal,302,"Judge, Court of Criminal Appeals, Place 3",,DEM,Cast Votes:,240,62,172,474
Comal,302,"Judge, Court of Criminal Appeals, Place 3",,DEM,Under Votes,60,10,50,120
Comal,302,"Judge, Court of Criminal Appeals, Place 3",,DEM,Over Votes,0,0,0,0
Comal,302,"Judge, Court of Criminal Appeals, Place 4",,DEM,Tina Clinton,205,47,140,392
Comal,302,"Judge, Court of Criminal Appeals, Place 4",,DEM,Steven Miears,38,12,34,84
Comal,302,"Judge, Court of Criminal Appeals, Place 4",,DEM,Cast Votes:,243,59,174,476
Comal,302,"Judge, Court of Criminal Appeals, Place 4",,DEM,Under Votes,57,13,48,118
Comal,302,"Judge, Court of Criminal Appeals, Place 4",,DEM,Over Votes,0,0,0,0
Comal,302,"Judge, Court of Criminal Appeals, Place 9",,DEM,Brandon Birmingham,221,52,155,428
Comal,302,"Judge, Court of Criminal Appeals, Place 9",,DEM,Cast Votes:,221,52,155,428
Comal,302,"Judge, Court of Criminal Appeals, Place 9",,DEM,Under Votes,79,20,67,166
Comal,302,"Judge, Court of Criminal Appeals, Place 9",,DEM,Over Votes,0,0,0,0
Comal,302,"Member, State Board of Education, District 5",,DEM,Rebecca Bell-Metereau,151,43,128,322
Comal,302,"Member, State Board of Education, District 5",,DEM,Letti Bresnahan,85,21,46,152
Comal,302,"Member, State Board of Education, District 5",,DEM,Cast Votes:,236,64,174,474
Comal,302,"Member, State Board of Education, District 5",,DEM,Under Votes,64,8,48,120
Comal,302,"Member, State Board of Education, District 5",,DEM,Over Votes,0,0,0,0
Comal,302,State Representative,73,DEM,Stephanie Phillips,236,57,173,466
Comal,302,State Representative,73,DEM,Cast Votes:,236,57,173,466
Comal,302,State Representative,73,DEM,Under Votes,64,15,49,128
Comal,302,State Representative,73,DEM,Over Votes,0,0,0,0
Comal,302,"Chief Justice, 3rd Court of Appeals District",,DEM,Darlene Byrne,184,43,138,365
Comal,302,"Chief Justice, 3rd Court of Appeals District",,DEM,Keith S. Hampton,54,16,30,100
Comal,302,"Chief Justice, 3rd Court of Appeals District",,DEM,Cast Votes:,238,59,168,465
Comal,302,"Chief Justice, 3rd Court of Appeals District",,DEM,Under Votes,62,13,54,129
Comal,302,"Chief Justice, 3rd Court of Appeals District",,DEM,Over Votes,0,0,0,0
Comal,302,"County Commissioner, Precinct 3",,DEM,Colette Nies,232,57,170,459
Comal,302,"County Commissioner, Precinct 3",,DEM,Cast Votes:,232,57,170,459
Comal,302,"County Commissioner, Precinct 3",,DEM,Under Votes,68,15,52,135
Comal,302,"County Commissioner, Precinct 3",,DEM,Over Votes,0,0,0,0
Comal,302,County Chairman,,DEM,Gloria Meehan,228,59,165,452
Comal,302,County Chairman,,DEM,Cast Votes:,228,59,165,452
Comal,302,County Chairman,,DEM,Under Votes,72,13,57,142
Comal,302,County Chairman,,DEM,Over Votes,0,0,0,0
Comal,302,Proposition #1,,DEM,Yes,280,66,203,549
Comal,302,Proposition #1,,DEM,No,11,1,13,25
Comal,302,Proposition #1,,DEM,Cast Votes:,291,67,216,574
Comal,302,Proposition #1,,DEM,Under Votes,9,5,6,20
Comal,302,Proposition #1,,DEM,Over Votes,0,0,0,0
Comal,302,Proposition #2,,DEM,Yes,277,65,201,543
Comal,302,Proposition #2,,DEM,No,13,2,14,29
Comal,302,Proposition #2,,DEM,Cast Votes:,290,67,215,572
Comal,302,Proposition #2,,DEM,Under Votes,10,5,7,22
Comal,302,Proposition #2,,DEM,Over Votes,0,0,0,0
Comal,302,Proposition #3,,DEM,Yes,291,66,213,570
Comal,302,Proposition #3,,DEM,No,2,1,4,7
Comal,302,Proposition #3,,DEM,Cast Votes:,293,67,217,577
Comal,302,Proposition #3,,DEM,Under Votes,7,5,5,17
Comal,302,Proposition #3,,DEM,Over Votes,0,0,0,0
Comal,302,Proposition #4,,DEM,Yes,279,62,202,543
Comal,302,Proposition #4,,DEM,No,13,3,14,30
Comal,302,Proposition #4,,DEM,Cast Votes:,292,65,216,573
Comal,302,Proposition #4,,DEM,Under Votes,8,7,6,21
Comal,302,Proposition #4,,DEM,Over Votes,0,0,0,0
Comal,302,Proposition #5,,DEM,Yes,286,65,209,560
Comal,302,Proposition #5,,DEM,No,2,1,5,8
Comal,302,Proposition #5,,DEM,Cast Votes:,288,66,214,568
Comal,302,Proposition #5,,DEM,Under Votes,12,6,8,26
Comal,302,Proposition #5,,DEM,Over Votes,0,0,0,0
Comal,302,Proposition #6,,DEM,Yes,281,65,205,551
Comal,302,Proposition #6,,DEM,No,2,1,6,9
Comal,302,Proposition #6,,DEM,Cast Votes:,283,66,211,560
Comal,302,Proposition #6,,DEM,Under Votes,17,6,11,34
Comal,302,Proposition #6,,DEM,Over Votes,0,0,0,0
Comal,302,Proposition #7,,DEM,Yes,275,60,202,537
Comal,302,Proposition #7,,DEM,No,9,5,10,24
Comal,302,Proposition #7,,DEM,Cast Votes:,284,65,212,561
Comal,302,Proposition #7,,DEM,Under Votes,16,7,10,33
Comal,302,Proposition #7,,DEM,Over Votes,0,0,0,0
Comal,302,Proposition #8,,DEM,Yes,278,67,210,555
Comal,302,Proposition #8,,DEM,No,9,0,5,14
Comal,302,Proposition #8,,DEM,Cast Votes:,287,67,215,569
Comal,302,Proposition #8,,DEM,Under Votes,13,4,7,24
Comal,302,Proposition #8,,DEM,Over Votes,0,0,0,0
Comal,302,Proposition #9,,DEM,Yes,284,63,210,557
Comal,302,Proposition #9,,DEM,No,3,3,3,9
Comal,302,Proposition #9,,DEM,Cast Votes:,287,66,213,566
Comal,302,Proposition #9,,DEM,Under Votes,13,5,9,27
Comal,302,Proposition #9,,DEM,Over Votes,0,0,0,0
Comal,302,Proposition #10,,DEM,Yes,283,64,211,558
Comal,302,Proposition #10,,DEM,No,7,2,4,13
Comal,302,Proposition #10,,DEM,Cast Votes:,290,66,215,571
Comal,302,Proposition #10,,DEM,Under Votes,10,5,7,22
Comal,302,Proposition #10,,DEM,Over Votes,0,0,0,0
Comal,302,Proposition #11,,DEM,Yes,269,59,196,524
Comal,302,Proposition #11,,DEM,No,19,7,15,41
Comal,302,Proposition #11,,DEM,Cast Votes:,288,66,211,565
Comal,302,Proposition #11,,DEM,Under Votes,12,5,11,28
Comal,302,Proposition #11,,DEM,Over Votes,0,0,0,0
Comal,101,President,,DEM,Tulsi Gabbard,2,1,0,3
Comal,101,President,,DEM,Marianne Williamson,0,0,0,0
Comal,101,President,,DEM,John K. Delaney,0,0,0,0
Comal,101,President,,DEM,Elizabeth Warren,34,4,38,76
Comal,101,President,,DEM,Cory Booker,0,0,0,0
Comal,101,President,,DEM,Amy Klobuchar,0,3,15,18
Comal,101,President,,DEM,Joseph R. Biden,126,13,34,173
Comal,101,President,,DEM,Pete Buttigieg,2,5,25,32
Comal,101,President,,DEM,Juli치n Castro,0,0,0,0
Comal,101,President,,DEM,Tom Steyer,1,0,3,4
Comal,101,President,,DEM,Michael Bennet,0,0,0,0
Comal,101,President,,DEM,Michael R. Bloomberg,14,20,19,53
Comal,101,President,,DEM,Robby Wells,0,0,0,0
Comal,101,President,,DEM,"Roque ""Rocky"" De La Fuente",1,0,0,1
Comal,101,President,,DEM,Deval Patrick,0,0,0,0
Comal,101,President,,DEM,Bernie Sanders,65,4,55,124
Comal,101,President,,DEM,Andrew Yang,0,0,0,0
Comal,101,Ballots Cast,,DEM,,245,50,189,484
Comal,101,President,,DEM,Under Votes,1,1,1,3
Comal,101,President,,DEM,Over Votes,0,0,0,0
Comal,101,U.S. Senate,,DEM,Royce West,10,2,13,25
Comal,101,U.S. Senate,,DEM,Chris Bell,22,8,16,46
Comal,101,U.S. Senate,,DEM,Amanda K. Edwards,22,4,34,60
Comal,101,U.S. Senate,,DEM,Sema Hernandez,23,4,11,38
Comal,101,U.S. Senate,,DEM,Jack Daniel Foster Jr,6,0,1,7
Comal,101,U.S. Senate,,DEM,D.R. Hunter,5,0,4,9
Comal,101,U.S. Senate,,DEM,Adrian Ocegueda,4,0,2,6
Comal,101,U.S. Senate,,DEM,"Mary ""MJ"" Hegar",76,17,63,156
Comal,101,U.S. Senate,,DEM,Cristina Tzintzun Ramirez,17,5,21,43
Comal,101,U.S. Senate,,DEM,Michael Cooper,1,2,2,5
Comal,101,U.S. Senate,,DEM,Victor Hugo Harris,2,0,1,3
Comal,101,U.S. Senate,,DEM,"Annie ""Mam치"" Garcia",12,5,9,26
Comal,101,U.S. Senate,,DEM,Cast Votes:,200,47,177,424
Comal,101,U.S. Senate,,DEM,Under Votes,46,4,13,63
Comal,101,U.S. Senate,,DEM,Over Votes,0,0,0,0
Comal,101,U.S. House,21,DEM,Wendy R. Davis,173,44,142,359
Comal,101,U.S. House,21,DEM,Jennie Lou Leeder,31,5,35,71
Comal,101,U.S. House,21,DEM,Cast Votes:,204,49,177,430
Comal,101,U.S. House,21,DEM,Under Votes,42,1,12,55
Comal,101,U.S. House,21,DEM,Over Votes,0,1,1,2
Comal,101,Railroad Commissioner,,DEM,Mark Watson,35,10,46,91
Comal,101,Railroad Commissioner,,DEM,Chrysta Casta침eda,65,17,64,146
Comal,101,Railroad Commissioner,,DEM,Kelly Stone,48,10,35,93
Comal,101,Railroad Commissioner,,DEM,"Roberto R. ""Beto"" Alonzo",33,7,23,63
Comal,101,Railroad Commissioner,,DEM,Cast Votes:,181,44,168,393
Comal,101,Railroad Commissioner,,DEM,Under Votes,65,6,22,93
Comal,101,Railroad Commissioner,,DEM,Over Votes,0,1,0,1
Comal,101,"Chief Justice, Supreme Court",,DEM,Amy Clark Meachum,161,38,148,347
Comal,101,"Chief Justice, Supreme Court",,DEM,Jerry Zimmerer,31,6,23,60
Comal,101,"Chief Justice, Supreme Court",,DEM,Cast Votes:,192,44,171,407
Comal,101,"Chief Justice, Supreme Court",,DEM,Under Votes,54,7,19,80
Comal,101,"Chief Justice, Supreme Court",,DEM,Over Votes,0,0,0,0
Comal,101,"Justice, Supreme Court, Place 6 Unexpired Term",,DEM,Larry Praeger,43,11,40,94
Comal,101,"Justice, Supreme Court, Place 6 Unexpired Term",,DEM,Kathy Cheng,144,32,131,307
Comal,101,"Justice, Supreme Court, Place 6 Unexpired Term",,DEM,Cast Votes:,187,43,171,401
Comal,101,"Justice, Supreme Court, Place 6 Unexpired Term",,DEM,Under Votes,59,8,19,86
Comal,101,"Justice, Supreme Court, Place 6 Unexpired Term",,DEM,Over Votes,0,0,0,0
Comal,101,"Justice, Supreme Court, Place 7",,DEM,Staci Williams,112,29,109,250
Comal,101,"Justice, Supreme Court, Place 7",,DEM,Brandy Voss,66,14,60,140
Comal,101,"Justice, Supreme Court, Place 7",,DEM,Cast Votes:,178,43,169,390
Comal,101,"Justice, Supreme Court, Place 7",,DEM,Under Votes,68,8,21,97
Comal,101,"Justice, Supreme Court, Place 7",,DEM,Over Votes,0,0,0,0
Comal,101,"Justice, Supreme Court, Place 8",,DEM,Peter Kelly,49,12,52,113
Comal,101,"Justice, Supreme Court, Place 8",,DEM,Gisela D. Triana,133,32,114,279
Comal,101,"Justice, Supreme Court, Place 8",,DEM,Cast Votes:,182,44,166,392
Comal,101,"Justice, Supreme Court, Place 8",,DEM,Under Votes,64,7,24,95
Comal,101,"Justice, Supreme Court, Place 8",,DEM,Over Votes,0,0,0,0
Comal,101,"Judge, Court of Criminal Appeals, Place 3",,DEM,Elizabeth Davis Frizell,146,34,138,318
Comal,101,"Judge, Court of Criminal Appeals, Place 3",,DEM,William Pieratt Demond,13,2,7,22
Comal,101,"Judge, Court of Criminal Appeals, Place 3",,DEM,Dan Wood,24,8,20,52
Comal,101,"Judge, Court of Criminal Appeals, Place 3",,DEM,Cast Votes:,183,44,165,392
Comal,101,"Judge, Court of Criminal Appeals, Place 3",,DEM,Under Votes,63,7,25,95
Comal,101,"Judge, Court of Criminal Appeals, Place 3",,DEM,Over Votes,0,0,0,0
Comal,101,"Judge, Court of Criminal Appeals, Place 4",,DEM,Tina Clinton,149,39,132,320
Comal,101,"Judge, Court of Criminal Appeals, Place 4",,DEM,Steven Miears,33,5,33,71
Comal,101,"Judge, Court of Criminal Appeals, Place 4",,DEM,Cast Votes:,182,44,165,391
Comal,101,"Judge, Court of Criminal Appeals, Place 4",,DEM,Under Votes,64,7,25,96
Comal,101,"Judge, Court of Criminal Appeals, Place 4",,DEM,Over Votes,0,0,0,0
Comal,101,"Judge, Court of Criminal Appeals, Place 9",,DEM,Brandon Birmingham,161,41,150,352
Comal,101,"Judge, Court of Criminal Appeals, Place 9",,DEM,Cast Votes:,161,41,150,352
Comal,101,"Judge, Court of Criminal Appeals, Place 9",,DEM,Under Votes,85,10,40,135
Comal,101,"Judge, Court of Criminal Appeals, Place 9",,DEM,Over Votes,0,0,0,0
Comal,101,"Member, State Board of Education, District 5",,DEM,Rebecca Bell-Metereau,115,27,111,253
Comal,101,"Member, State Board of Education, District 5",,DEM,Letti Bresnahan,62,19,49,130
Comal,101,"Member, State Board of Education, District 5",,DEM,Cast Votes:,177,46,160,383
Comal,101,"Member, State Board of Education, District 5",,DEM,Under Votes,69,5,30,104
Comal,101,"Member, State Board of Education, District 5",,DEM,Over Votes,0,0,0,0
Comal,101,State Representative,73,DEM,Stephanie Phillips,176,43,157,376
Comal,101,State Representative,73,DEM,Cast Votes:,176,43,157,376
Comal,101,State Representative,73,DEM,Under Votes,70,8,33,111
Comal,101,State Representative,73,DEM,Over Votes,0,0,0,0
Comal,101,"Chief Justice, 3rd Court of Appeals District",,DEM,Darlene Byrne,143,32,128,303
Comal,101,"Chief Justice, 3rd Court of Appeals District",,DEM,Keith S. Hampton,29,12,30,71
Comal,101,"Chief Justice, 3rd Court of Appeals District",,DEM,Cast Votes:,172,44,158,374
Comal,101,"Chief Justice, 3rd Court of Appeals District",,DEM,Under Votes,74,7,32,113
Comal,101,"Chief Justice, 3rd Court of Appeals District",,DEM,Over Votes,0,0,0,0
Comal,101,"County Commissioner, Precinct 1",,DEM,Lindsay Poisel,163,44,152,359
Comal,101,"County Commissioner, Precinct 1",,DEM,Cast Votes:,163,44,152,359
Comal,101,"County Commissioner, Precinct 1",,DEM,Under Votes,83,7,38,128
Comal,101,"County Commissioner, Precinct 1",,DEM,Over Votes,0,0,0,0
Comal,101,County Chairman,,DEM,Gloria Meehan,170,45,150,365
Comal,101,County Chairman,,DEM,Cast Votes:,170,45,150,365
Comal,101,County Chairman,,DEM,Under Votes,76,6,40,122
Comal,101,County Chairman,,DEM,Over Votes,0,0,0,0
Comal,101,Proposition #1,,DEM,Yes,220,48,173,441
Comal,101,Proposition #1,,DEM,No,12,1,14,27
Comal,101,Proposition #1,,DEM,Cast Votes:,232,49,187,468
Comal,101,Proposition #1,,DEM,Under Votes,14,2,3,19
Comal,101,Proposition #1,,DEM,Over Votes,0,0,0,0
Comal,101,Proposition #2,,DEM,Yes,223,47,167,437
Comal,101,Proposition #2,,DEM,No,9,4,17,30
Comal,101,Proposition #2,,DEM,Cast Votes:,232,51,184,467
Comal,101,Proposition #2,,DEM,Under Votes,14,0,6,20
Comal,101,Proposition #2,,DEM,Over Votes,0,0,0,0
Comal,101,Proposition #3,,DEM,Yes,230,50,181,461
Comal,101,Proposition #3,,DEM,No,6,1,4,11
Comal,101,Proposition #3,,DEM,Cast Votes:,236,51,185,472
Comal,101,Proposition #3,,DEM,Under Votes,10,0,5,15
Comal,101,Proposition #3,,DEM,Over Votes,0,0,0,0
Comal,101,Proposition #4,,DEM,Yes,217,49,166,432
Comal,101,Proposition #4,,DEM,No,14,2,17,33
Comal,101,Proposition #4,,DEM,Cast Votes:,231,51,183,465
Comal,101,Proposition #4,,DEM,Under Votes,15,0,7,22
Comal,101,Proposition #4,,DEM,Over Votes,0,0,0,0
Comal,101,Proposition #5,,DEM,Yes,222,49,179,450
Comal,101,Proposition #5,,DEM,No,9,2,3,14
Comal,101,Proposition #5,,DEM,Cast Votes:,231,51,182,464
Comal,101,Proposition #5,,DEM,Under Votes,15,0,8,23
Comal,101,Proposition #5,,DEM,Over Votes,0,0,0,0
Comal,101,Proposition #6,,DEM,Yes,224,49,180,453
Comal,101,Proposition #6,,DEM,No,7,2,4,13
Comal,101,Proposition #6,,DEM,Cast Votes:,231,51,184,466
Comal,101,Proposition #6,,DEM,Under Votes,15,0,6,21
Comal,101,Proposition #6,,DEM,Over Votes,0,0,0,0
Comal,101,Proposition #7,,DEM,Yes,217,49,174,440
Comal,101,Proposition #7,,DEM,No,15,2,9,26
Comal,101,Proposition #7,,DEM,Cast Votes:,232,51,183,466
Comal,101,Proposition #7,,DEM,Under Votes,14,0,7,21
Comal,101,Proposition #7,,DEM,Over Votes,0,0,0,0
Comal,101,Proposition #8,,DEM,Yes,221,50,176,447
Comal,101,Proposition #8,,DEM,No,11,1,8,20
Comal,101,Proposition #8,,DEM,Cast Votes:,232,51,184,467
Comal,101,Proposition #8,,DEM,Under Votes,14,0,6,20
Comal,101,Proposition #8,,DEM,Over Votes,0,0,0,0
Comal,101,Proposition #9,,DEM,Yes,226,50,179,455
Comal,101,Proposition #9,,DEM,No,5,1,4,10
Comal,101,Proposition #9,,DEM,Cast Votes:,231,51,183,465
Comal,101,Proposition #9,,DEM,Under Votes,15,0,7,22
Comal,101,Proposition #9,,DEM,Over Votes,0,0,0,0
Comal,101,Proposition #10,,DEM,Yes,224,50,177,451
Comal,101,Proposition #10,,DEM,No,9,1,8,18
Comal,101,Proposition #10,,DEM,Cast Votes:,233,51,185,469
Comal,101,Proposition #10,,DEM,Under Votes,13,0,5,18
Comal,101,Proposition #10,,DEM,Over Votes,0,0,0,0
Comal,101,Proposition #11,,DEM,Yes,205,44,174,423
Comal,101,Proposition #11,,DEM,No,19,5,9,33
Comal,101,Proposition #11,,DEM,Cast Votes:,224,49,183,456
Comal,101,Proposition #11,,DEM,Under Votes,22,1,7,30
Comal,101,Proposition #11,,DEM,Over Votes,0,1,0,1
Comal,303,President,,DEM,Tulsi Gabbard,2,0,0,2
Comal,303,President,,DEM,Marianne Williamson,0,0,0,0
Comal,303,President,,DEM,John K. Delaney,0,0,2,2
Comal,303,President,,DEM,Elizabeth Warren,7,1,7,15
Comal,303,President,,DEM,Cory Booker,0,0,0,0
Comal,303,President,,DEM,Amy Klobuchar,1,0,5,6
Comal,303,President,,DEM,Joseph R. Biden,34,2,6,42
Comal,303,President,,DEM,Pete Buttigieg,0,2,5,7
Comal,303,President,,DEM,Juli치n Castro,0,1,0,1
Comal,303,President,,DEM,Tom Steyer,1,0,0,1
Comal,303,President,,DEM,Michael Bennet,0,0,0,0
Comal,303,President,,DEM,Michael R. Bloomberg,12,4,8,24
Comal,303,President,,DEM,Robby Wells,0,0,0,0
Comal,303,President,,DEM,"Roque ""Rocky"" De La Fuente",0,1,0,1
Comal,303,President,,DEM,Deval Patrick,0,0,0,0
Comal,303,President,,DEM,Bernie Sanders,18,5,16,39
Comal,303,President,,DEM,Andrew Yang,1,0,0,1
Comal,303,Ballots Cast,,DEM,,76,16,49,141
Comal,303,President,,DEM,Under Votes,1,0,0,1
Comal,303,President,,DEM,Over Votes,0,0,0,0
Comal,303,U.S. Senate,,DEM,Royce West,5,3,5,13
Comal,303,U.S. Senate,,DEM,Chris Bell,3,0,7,10
Comal,303,U.S. Senate,,DEM,Amanda K. Edwards,4,2,2,8
Comal,303,U.S. Senate,,DEM,Sema Hernandez,17,4,4,25
Comal,303,U.S. Senate,,DEM,Jack Daniel Foster Jr,1,2,1,4
Comal,303,U.S. Senate,,DEM,D.R. Hunter,2,0,2,4
Comal,303,U.S. Senate,,DEM,Adrian Ocegueda,2,0,2,4
Comal,303,U.S. Senate,,DEM,"Mary ""MJ"" Hegar",20,4,14,38
Comal,303,U.S. Senate,,DEM,Cristina Tzintzun Ramirez,4,0,3,7
Comal,303,U.S. Senate,,DEM,Michael Cooper,1,1,1,3
Comal,303,U.S. Senate,,DEM,Victor Hugo Harris,0,0,1,1
Comal,303,U.S. Senate,,DEM,"Annie ""Mam치"" Garcia",5,0,5,10
Comal,303,U.S. Senate,,DEM,Cast Votes:,64,16,47,127
Comal,303,U.S. Senate,,DEM,Under Votes,13,0,2,15
Comal,303,U.S. Senate,,DEM,Over Votes,0,0,0,0
Comal,303,U.S. House,35,DEM,Rafael Alcoser III,21,4,7,32
Comal,303,U.S. House,35,DEM,Lloyd Doggett,48,12,37,97
Comal,303,U.S. House,35,DEM,Cast Votes:,69,16,44,129
Comal,303,U.S. House,35,DEM,Under Votes,8,0,5,13
Comal,303,U.S. House,35,DEM,Over Votes,0,0,0,0
Comal,303,Railroad Commissioner,,DEM,Mark Watson,5,4,9,18
Comal,303,Railroad Commissioner,,DEM,Chrysta Casta침eda,27,7,20,54
Comal,303,Railroad Commissioner,,DEM,Kelly Stone,10,1,10,21
Comal,303,Railroad Commissioner,,DEM,"Roberto R. ""Beto"" Alonzo",22,3,4,29
Comal,303,Railroad Commissioner,,DEM,Cast Votes:,64,15,43,122
Comal,303,Railroad Commissioner,,DEM,Under Votes,13,1,6,20
Comal,303,Railroad Commissioner,,DEM,Over Votes,0,0,0,0
Comal,303,"Chief Justice, Supreme Court",,DEM,Amy Clark Meachum,55,8,35,98
Comal,303,"Chief Justice, Supreme Court",,DEM,Jerry Zimmerer,9,7,9,25
Comal,303,"Chief Justice, Supreme Court",,DEM,Cast Votes:,64,15,44,123
Comal,303,"Chief Justice, Supreme Court",,DEM,Under Votes,13,1,5,19
Comal,303,"Chief Justice, Supreme Court",,DEM,Over Votes,0,0,0,0
Comal,303,"Justice, Supreme Court, Place 6 Unexpired Term",,DEM,Larry Praeger,18,9,16,43
Comal,303,"Justice, Supreme Court, Place 6 Unexpired Term",,DEM,Kathy Cheng,45,6,25,76
Comal,303,"Justice, Supreme Court, Place 6 Unexpired Term",,DEM,Cast Votes:,63,15,41,119
Comal,303,"Justice, Supreme Court, Place 6 Unexpired Term",,DEM,Under Votes,14,1,8,23
Comal,303,"Justice, Supreme Court, Place 6 Unexpired Term",,DEM,Over Votes,0,0,0,0
Comal,303,"Justice, Supreme Court, Place 7",,DEM,Staci Williams,47,9,30,86
Comal,303,"Justice, Supreme Court, Place 7",,DEM,Brandy Voss,17,7,13,37
Comal,303,"Justice, Supreme Court, Place 7",,DEM,Cast Votes:,64,16,43,123
Comal,303,"Justice, Supreme Court, Place 7",,DEM,Under Votes,13,0,6,19
Comal,303,"Justice, Supreme Court, Place 7",,DEM,Over Votes,0,0,0,0
Comal,303,"Justice, Supreme Court, Place 8",,DEM,Peter Kelly,17,7,16,40
Comal,303,"Justice, Supreme Court, Place 8",,DEM,Gisela D. Triana,43,8,27,78
Comal,303,"Justice, Supreme Court, Place 8",,DEM,Cast Votes:,60,15,43,118
Comal,303,"Justice, Supreme Court, Place 8",,DEM,Under Votes,17,1,6,24
Comal,303,"Justice, Supreme Court, Place 8",,DEM,Over Votes,0,0,0,0
Comal,303,"Judge, Court of Criminal Appeals, Place 3",,DEM,Elizabeth Davis Frizell,45,10,27,82
Comal,303,"Judge, Court of Criminal Appeals, Place 3",,DEM,William Pieratt Demond,5,2,6,13
Comal,303,"Judge, Court of Criminal Appeals, Place 3",,DEM,Dan Wood,10,3,8,21
Comal,303,"Judge, Court of Criminal Appeals, Place 3",,DEM,Cast Votes:,60,15,41,116
Comal,303,"Judge, Court of Criminal Appeals, Place 3",,DEM,Under Votes,17,1,8,26
Comal,303,"Judge, Court of Criminal Appeals, Place 3",,DEM,Over Votes,0,0,0,0
Comal,303,"Judge, Court of Criminal Appeals, Place 4",,DEM,Tina Clinton,43,9,30,82
Comal,303,"Judge, Court of Criminal Appeals, Place 4",,DEM,Steven Miears,19,6,11,36
Comal,303,"Judge, Court of Criminal Appeals, Place 4",,DEM,Cast Votes:,62,15,41,118
Comal,303,"Judge, Court of Criminal Appeals, Place 4",,DEM,Under Votes,15,1,8,24
Comal,303,"Judge, Court of Criminal Appeals, Place 4",,DEM,Over Votes,0,0,0,0
Comal,303,"Judge, Court of Criminal Appeals, Place 9",,DEM,Brandon Birmingham,54,14,39,107
Comal,303,"Judge, Court of Criminal Appeals, Place 9",,DEM,Cast Votes:,54,14,39,107
Comal,303,"Judge, Court of Criminal Appeals, Place 9",,DEM,Under Votes,23,2,10,35
Comal,303,"Judge, Court of Criminal Appeals, Place 9",,DEM,Over Votes,0,0,0,0
Comal,303,"Member, State Board of Education, District 5",,DEM,Rebecca Bell-Metereau,34,9,23,66
Comal,303,"Member, State Board of Education, District 5",,DEM,Letti Bresnahan,26,6,17,49
Comal,303,"Member, State Board of Education, District 5",,DEM,Cast Votes:,60,15,40,115
Comal,303,"Member, State Board of Education, District 5",,DEM,Under Votes,17,1,9,27
Comal,303,"Member, State Board of Education, District 5",,DEM,Over Votes,0,0,0,0
Comal,303,State Representative,73,DEM,Stephanie Phillips,57,15,38,110
Comal,303,State Representative,73,DEM,Cast Votes:,57,15,38,110
Comal,303,State Representative,73,DEM,Under Votes,20,1,11,32
Comal,303,State Representative,73,DEM,Over Votes,0,0,0,0
Comal,303,"Chief Justice, 3rd Court of Appeals District",,DEM,Darlene Byrne,44,10,28,82
Comal,303,"Chief Justice, 3rd Court of Appeals District",,DEM,Keith S. Hampton,17,4,13,34
Comal,303,"Chief Justice, 3rd Court of Appeals District",,DEM,Cast Votes:,61,14,41,116
Comal,303,"Chief Justice, 3rd Court of Appeals District",,DEM,Under Votes,16,2,8,26
Comal,303,"Chief Justice, 3rd Court of Appeals District",,DEM,Over Votes,0,0,0,0
Comal,303,"County Commissioner, Precinct 3",,DEM,Colette Nies,57,15,38,110
Comal,303,"County Commissioner, Precinct 3",,DEM,Cast Votes:,57,15,38,110
Comal,303,"County Commissioner, Precinct 3",,DEM,Under Votes,20,1,11,32
Comal,303,"County Commissioner, Precinct 3",,DEM,Over Votes,0,0,0,0
Comal,303,County Chairman,,DEM,Gloria Meehan,61,15,38,114
Comal,303,County Chairman,,DEM,Cast Votes:,61,15,38,114
Comal,303,County Chairman,,DEM,Under Votes,16,1,11,28
Comal,303,County Chairman,,DEM,Over Votes,0,0,0,0
Comal,303,Proposition #1,,DEM,Yes,72,13,44,129
Comal,303,Proposition #1,,DEM,No,4,2,4,10
Comal,303,Proposition #1,,DEM,Cast Votes:,76,15,48,139
Comal,303,Proposition #1,,DEM,Under Votes,1,1,1,3
Comal,303,Proposition #1,,DEM,Over Votes,0,0,0,0
Comal,303,Proposition #2,,DEM,Yes,73,16,43,132
Comal,303,Proposition #2,,DEM,No,3,0,4,7
Comal,303,Proposition #2,,DEM,Cast Votes:,76,16,47,139
Comal,303,Proposition #2,,DEM,Under Votes,1,0,2,3
Comal,303,Proposition #2,,DEM,Over Votes,0,0,0,0
Comal,303,Proposition #3,,DEM,Yes,72,16,44,132
Comal,303,Proposition #3,,DEM,No,2,0,1,3
Comal,303,Proposition #3,,DEM,Cast Votes:,74,16,45,135
Comal,303,Proposition #3,,DEM,Under Votes,3,0,4,7
Comal,303,Proposition #3,,DEM,Over Votes,0,0,0,0
Comal,303,Proposition #4,,DEM,Yes,69,13,41,123
Comal,303,Proposition #4,,DEM,No,5,3,4,12
Comal,303,Proposition #4,,DEM,Cast Votes:,74,16,45,135
Comal,303,Proposition #4,,DEM,Under Votes,3,0,4,7
Comal,303,Proposition #4,,DEM,Over Votes,0,0,0,0
Comal,303,Proposition #5,,DEM,Yes,71,14,45,130
Comal,303,Proposition #5,,DEM,No,2,2,1,5
Comal,303,Proposition #5,,DEM,Cast Votes:,73,16,46,135
Comal,303,Proposition #5,,DEM,Under Votes,4,0,3,7
Comal,303,Proposition #5,,DEM,Over Votes,0,0,0,0
Comal,303,Proposition #6,,DEM,Yes,73,14,45,132
Comal,303,Proposition #6,,DEM,No,2,2,0,4
Comal,303,Proposition #6,,DEM,Cast Votes:,75,16,45,136
Comal,303,Proposition #6,,DEM,Under Votes,2,0,4,6
Comal,303,Proposition #6,,DEM,Over Votes,0,0,0,0
Comal,303,Proposition #7,,DEM,Yes,73,12,40,125
Comal,303,Proposition #7,,DEM,No,2,3,3,8
Comal,303,Proposition #7,,DEM,Cast Votes:,75,15,43,133
Comal,303,Proposition #7,,DEM,Under Votes,2,1,6,9
Comal,303,Proposition #7,,DEM,Over Votes,0,0,0,0
Comal,303,Proposition #8,,DEM,Yes,72,16,43,131
Comal,303,Proposition #8,,DEM,No,2,0,2,4
Comal,303,Proposition #8,,DEM,Cast Votes:,74,16,45,135
Comal,303,Proposition #8,,DEM,Under Votes,3,0,4,7
Comal,303,Proposition #8,,DEM,Over Votes,0,0,0,0
Comal,303,Proposition #9,,DEM,Yes,74,14,44,132
Comal,303,Proposition #9,,DEM,No,2,2,1,5
Comal,303,Proposition #9,,DEM,Cast Votes:,76,16,45,137
Comal,303,Proposition #9,,DEM,Under Votes,1,0,4,5
Comal,303,Proposition #9,,DEM,Over Votes,0,0,0,0
Comal,303,Proposition #10,,DEM,Yes,72,16,42,130
Comal,303,Proposition #10,,DEM,No,4,0,1,5
Comal,303,Proposition #10,,DEM,Cast Votes:,76,16,43,135
Comal,303,Proposition #10,,DEM,Under Votes,1,0,6,7
Comal,303,Proposition #10,,DEM,Over Votes,0,0,0,0
Comal,303,Proposition #11,,DEM,Yes,68,14,41,123
Comal,303,Proposition #11,,DEM,No,5,2,5,12
Comal,303,Proposition #11,,DEM,Cast Votes:,73,16,46,135
Comal,303,Proposition #11,,DEM,Under Votes,4,0,3,7
Comal,303,Proposition #11,,DEM,Over Votes,0,0,0,0
Comal,304,President,,DEM,Tulsi Gabbard,2,0,0,2
Comal,304,President,,DEM,Marianne Williamson,1,0,0,1
Comal,304,President,,DEM,John K. Delaney,1,0,0,1
Comal,304,President,,DEM,Elizabeth Warren,31,4,23,58
Comal,304,President,,DEM,Cory Booker,0,0,1,1
Comal,304,President,,DEM,Amy Klobuchar,1,0,10,11
Comal,304,President,,DEM,Joseph R. Biden,74,8,20,102
Comal,304,President,,DEM,Pete Buttigieg,0,5,18,23
Comal,304,President,,DEM,Juli치n Castro,4,1,1,6
Comal,304,President,,DEM,Tom Steyer,1,2,0,3
Comal,304,President,,DEM,Michael Bennet,0,0,0,0
Comal,304,President,,DEM,Michael R. Bloomberg,20,6,12,38
Comal,304,President,,DEM,Robby Wells,0,0,0,0
Comal,304,President,,DEM,"Roque ""Rocky"" De La Fuente",1,0,0,1
Comal,304,President,,DEM,Deval Patrick,0,0,0,0
Comal,304,President,,DEM,Bernie Sanders,88,8,54,150
Comal,304,President,,DEM,Andrew Yang,1,0,0,1
Comal,304,Ballots Cast,,DEM,,225,34,139,398
Comal,304,President,,DEM,Under Votes,1,0,1,2
Comal,304,President,,DEM,Over Votes,0,0,0,0
Comal,304,U.S. Senate,,DEM,Royce West,11,1,8,20
Comal,304,U.S. Senate,,DEM,Chris Bell,16,5,8,29
Comal,304,U.S. Senate,,DEM,Amanda K. Edwards,23,0,15,38
Comal,304,U.S. Senate,,DEM,Sema Hernandez,40,9,27,76
Comal,304,U.S. Senate,,DEM,Jack Daniel Foster Jr,6,1,4,11
Comal,304,U.S. Senate,,DEM,D.R. Hunter,2,0,3,5
Comal,304,U.S. Senate,,DEM,Adrian Ocegueda,9,0,3,12
Comal,304,U.S. Senate,,DEM,"Mary ""MJ"" Hegar",42,8,25,75
Comal,304,U.S. Senate,,DEM,Cristina Tzintzun Ramirez,17,2,18,37
Comal,304,U.S. Senate,,DEM,Michael Cooper,0,2,2,4
Comal,304,U.S. Senate,,DEM,Victor Hugo Harris,4,2,3,9
Comal,304,U.S. Senate,,DEM,"Annie ""Mam치"" Garcia",17,2,14,33
Comal,304,U.S. Senate,,DEM,Cast Votes:,187,32,130,349
Comal,304,U.S. Senate,,DEM,Under Votes,39,2,10,51
Comal,304,U.S. Senate,,DEM,Over Votes,0,0,0,0
Comal,304,U.S. House,35,DEM,Rafael Alcoser III,79,9,45,133
Comal,304,U.S. House,35,DEM,Lloyd Doggett,120,23,89,232
Comal,304,U.S. House,35,DEM,Cast Votes:,199,32,134,365
Comal,304,U.S. House,35,DEM,Under Votes,27,2,5,34
Comal,304,U.S. House,35,DEM,Over Votes,0,0,1,1
Comal,304,Railroad Commissioner,,DEM,Mark Watson,24,5,18,47
Comal,304,Railroad Commissioner,,DEM,Chrysta Casta침eda,74,8,52,134
Comal,304,Railroad Commissioner,,DEM,Kelly Stone,41,3,28,72
Comal,304,Railroad Commissioner,,DEM,"Roberto R. ""Beto"" Alonzo",48,16,27,91
Comal,304,Railroad Commissioner,,DEM,Cast Votes:,187,32,125,344
Comal,304,Railroad Commissioner,,DEM,Under Votes,39,2,15,56
Comal,304,Railroad Commissioner,,DEM,Over Votes,0,0,0,0
Comal,304,"Chief Justice, Supreme Court",,DEM,Amy Clark Meachum,158,22,103,283
Comal,304,"Chief Justice, Supreme Court",,DEM,Jerry Zimmerer,24,8,21,53
Comal,304,"Chief Justice, Supreme Court",,DEM,Cast Votes:,182,30,124,336
Comal,304,"Chief Justice, Supreme Court",,DEM,Under Votes,44,4,16,64
Comal,304,"Chief Justice, Supreme Court",,DEM,Over Votes,0,0,0,0
Comal,304,"Justice, Supreme Court, Place 6 Unexpired Term",,DEM,Larry Praeger,34,11,32,77
Comal,304,"Justice, Supreme Court, Place 6 Unexpired Term",,DEM,Kathy Cheng,146,20,91,257
Comal,304,"Justice, Supreme Court, Place 6 Unexpired Term",,DEM,Cast Votes:,180,31,123,334
Comal,304,"Justice, Supreme Court, Place 6 Unexpired Term",,DEM,Under Votes,46,3,17,66
Comal,304,"Justice, Supreme Court, Place 6 Unexpired Term",,DEM,Over Votes,0,0,0,0
Comal,304,"Justice, Supreme Court, Place 7",,DEM,Staci Williams,110,23,76,209
Comal,304,"Justice, Supreme Court, Place 7",,DEM,Brandy Voss,70,7,46,123
Comal,304,"Justice, Supreme Court, Place 7",,DEM,Cast Votes:,180,30,122,332
Comal,304,"Justice, Supreme Court, Place 7",,DEM,Under Votes,46,4,18,68
Comal,304,"Justice, Supreme Court, Place 7",,DEM,Over Votes,0,0,0,0
Comal,304,"Justice, Supreme Court, Place 8",,DEM,Peter Kelly,54,8,30,92
Comal,304,"Justice, Supreme Court, Place 8",,DEM,Gisela D. Triana,121,22,91,234
Comal,304,"Justice, Supreme Court, Place 8",,DEM,Cast Votes:,175,30,121,326
Comal,304,"Justice, Supreme Court, Place 8",,DEM,Under Votes,51,4,19,74
Comal,304,"Justice, Supreme Court, Place 8",,DEM,Over Votes,0,0,0,0
Comal,304,"Judge, Court of Criminal Appeals, Place 3",,DEM,Elizabeth Davis Frizell,130,17,93,240
Comal,304,"Judge, Court of Criminal Appeals, Place 3",,DEM,William Pieratt Demond,16,2,11,29
Comal,304,"Judge, Court of Criminal Appeals, Place 3",,DEM,Dan Wood,33,11,17,61
Comal,304,"Judge, Court of Criminal Appeals, Place 3",,DEM,Cast Votes:,179,30,121,330
Comal,304,"Judge, Court of Criminal Appeals, Place 3",,DEM,Under Votes,47,4,19,70
Comal,304,"Judge, Court of Criminal Appeals, Place 3",,DEM,Over Votes,0,0,0,0
Comal,304,"Judge, Court of Criminal Appeals, Place 4",,DEM,Tina Clinton,142,24,101,267
Comal,304,"Judge, Court of Criminal Appeals, Place 4",,DEM,Steven Miears,36,6,20,62
Comal,304,"Judge, Court of Criminal Appeals, Place 4",,DEM,Cast Votes:,178,30,121,329
Comal,304,"Judge, Court of Criminal Appeals, Place 4",,DEM,Under Votes,48,4,19,71
Comal,304,"Judge, Court of Criminal Appeals, Place 4",,DEM,Over Votes,0,0,0,0
Comal,304,"Judge, Court of Criminal Appeals, Place 9",,DEM,Brandon Birmingham,169,27,114,310
Comal,304,"Judge, Court of Criminal Appeals, Place 9",,DEM,Cast Votes:,169,27,114,310
Comal,304,"Judge, Court of Criminal Appeals, Place 9",,DEM,Under Votes,57,7,26,90
Comal,304,"Judge, Court of Criminal Appeals, Place 9",,DEM,Over Votes,0,0,0,0
Comal,304,"Member, State Board of Education, District 5",,DEM,Rebecca Bell-Metereau,122,17,87,226
Comal,304,"Member, State Board of Education, District 5",,DEM,Letti Bresnahan,59,13,37,109
Comal,304,"Member, State Board of Education, District 5",,DEM,Cast Votes:,181,30,124,335
Comal,304,"Member, State Board of Education, District 5",,DEM,Under Votes,45,4,16,65
Comal,304,"Member, State Board of Education, District 5",,DEM,Over Votes,0,0,0,0
Comal,304,State Representative,73,DEM,Stephanie Phillips,168,28,115,311
Comal,304,State Representative,73,DEM,Cast Votes:,168,28,115,311
Comal,304,State Representative,73,DEM,Under Votes,58,6,25,89
Comal,304,State Representative,73,DEM,Over Votes,0,0,0,0
Comal,304,"Chief Justice, 3rd Court of Appeals District",,DEM,Darlene Byrne,134,24,88,246
Comal,304,"Chief Justice, 3rd Court of Appeals District",,DEM,Keith S. Hampton,44,4,27,75
Comal,304,"Chief Justice, 3rd Court of Appeals District",,DEM,Cast Votes:,178,28,115,321
Comal,304,"Chief Justice, 3rd Court of Appeals District",,DEM,Under Votes,48,6,25,79
Comal,304,"Chief Justice, 3rd Court of Appeals District",,DEM,Over Votes,0,0,0,0
Comal,304,"County Commissioner, Precinct 3",,DEM,Colette Nies,167,27,111,305
Comal,304,"County Commissioner, Precinct 3",,DEM,Cast Votes:,167,27,111,305
Comal,304,"County Commissioner, Precinct 3",,DEM,Under Votes,59,7,29,95
Comal,304,"County Commissioner, Precinct 3",,DEM,Over Votes,0,0,0,0
Comal,304,County Chairman,,DEM,Gloria Meehan,168,30,110,308
Comal,304,County Chairman,,DEM,Cast Votes:,168,30,110,308
Comal,304,County Chairman,,DEM,Under Votes,58,4,30,92
Comal,304,County Chairman,,DEM,Over Votes,0,0,0,0
Comal,304,Proposition #1,,DEM,Yes,211,30,130,371
Comal,304,Proposition #1,,DEM,No,9,1,9,19
Comal,304,Proposition #1,,DEM,Cast Votes:,220,31,139,390
Comal,304,Proposition #1,,DEM,Under Votes,6,3,1,10
Comal,304,Proposition #1,,DEM,Over Votes,0,0,0,0
Comal,304,Proposition #2,,DEM,Yes,218,31,130,379
Comal,304,Proposition #2,,DEM,No,4,1,8,13
Comal,304,Proposition #2,,DEM,Cast Votes:,222,32,138,392
Comal,304,Proposition #2,,DEM,Under Votes,4,2,2,8
Comal,304,Proposition #2,,DEM,Over Votes,0,0,0,0
Comal,304,Proposition #3,,DEM,Yes,218,32,135,385
Comal,304,Proposition #3,,DEM,No,4,0,3,7
Comal,304,Proposition #3,,DEM,Cast Votes:,222,32,138,392
Comal,304,Proposition #3,,DEM,Under Votes,4,2,2,8
Comal,304,Proposition #3,,DEM,Over Votes,0,0,0,0
Comal,304,Proposition #4,,DEM,Yes,213,32,134,379
Comal,304,Proposition #4,,DEM,No,7,0,4,11
Comal,304,Proposition #4,,DEM,Cast Votes:,220,32,138,390
Comal,304,Proposition #4,,DEM,Under Votes,6,2,2,10
Comal,304,Proposition #4,,DEM,Over Votes,0,0,0,0
Comal,304,Proposition #5,,DEM,Yes,216,32,133,381
Comal,304,Proposition #5,,DEM,No,4,0,4,8
Comal,304,Proposition #5,,DEM,Cast Votes:,220,32,137,389
Comal,304,Proposition #5,,DEM,Under Votes,6,2,3,11
Comal,304,Proposition #5,,DEM,Over Votes,0,0,0,0
Comal,304,Proposition #6,,DEM,Yes,211,32,134,377
Comal,304,Proposition #6,,DEM,No,6,0,4,10
Comal,304,Proposition #6,,DEM,Cast Votes:,217,32,138,387
Comal,304,Proposition #6,,DEM,Under Votes,9,2,2,13
Comal,304,Proposition #6,,DEM,Over Votes,0,0,0,0
Comal,304,Proposition #7,,DEM,Yes,212,29,134,375
Comal,304,Proposition #7,,DEM,No,7,1,3,11
Comal,304,Proposition #7,,DEM,Cast Votes:,219,30,137,386
Comal,304,Proposition #7,,DEM,Under Votes,7,4,3,14
Comal,304,Proposition #7,,DEM,Over Votes,0,0,0,0
Comal,304,Proposition #8,,DEM,Yes,211,31,136,378
Comal,304,Proposition #8,,DEM,No,8,0,2,10
Comal,304,Proposition #8,,DEM,Cast Votes:,219,31,138,388
Comal,304,Proposition #8,,DEM,Under Votes,7,2,2,11
Comal,304,Proposition #8,,DEM,Over Votes,0,0,0,0
Comal,304,Proposition #9,,DEM,Yes,216,31,132,379
Comal,304,Proposition #9,,DEM,No,2,0,3,5
Comal,304,Proposition #9,,DEM,Cast Votes:,218,31,135,384
Comal,304,Proposition #9,,DEM,Under Votes,8,2,5,15
Comal,304,Proposition #9,,DEM,Over Votes,0,0,0,0
Comal,304,Proposition #10,,DEM,Yes,212,31,131,374
Comal,304,Proposition #10,,DEM,No,8,0,6,14
Comal,304,Proposition #10,,DEM,Cast Votes:,220,31,137,388
Comal,304,Proposition #10,,DEM,Under Votes,6,2,3,11
Comal,304,Proposition #10,,DEM,Over Votes,0,0,0,0
Comal,304,Proposition #11,,DEM,Yes,197,31,121,349
Comal,304,Proposition #11,,DEM,No,18,0,14,32
Comal,304,Proposition #11,,DEM,Cast Votes:,215,31,135,381
Comal,304,Proposition #11,,DEM,Under Votes,11,2,5,18
Comal,304,Proposition #11,,DEM,Over Votes,0,0,0,0
Comal,305,President,,DEM,Tulsi Gabbard,0,0,0,0
Comal,305,President,,DEM,Marianne Williamson,0,0,0,0
Comal,305,President,,DEM,John K. Delaney,0,0,0,0
Comal,305,President,,DEM,Elizabeth Warren,23,0,12,35
Comal,305,President,,DEM,Cory Booker,0,0,0,0
Comal,305,President,,DEM,Amy Klobuchar,0,0,3,3
Comal,305,President,,DEM,Joseph R. Biden,52,14,18,84
Comal,305,President,,DEM,Pete Buttigieg,2,2,7,11
Comal,305,President,,DEM,Juli치n Castro,2,0,1,3
Comal,305,President,,DEM,Tom Steyer,0,0,1,1
Comal,305,President,,DEM,Michael Bennet,0,0,0,0
Comal,305,President,,DEM,Michael R. Bloomberg,17,6,8,31
Comal,305,President,,DEM,Robby Wells,0,0,0,0
Comal,305,President,,DEM,"Roque ""Rocky"" De La Fuente",0,0,0,0
Comal,305,President,,DEM,Deval Patrick,0,0,0,0
Comal,305,President,,DEM,Bernie Sanders,45,4,33,82
Comal,305,President,,DEM,Andrew Yang,1,0,0,1
Comal,305,Ballots Cast,,DEM,,142,26,83,251
Comal,305,President,,DEM,Under Votes,0,0,0,0
Comal,305,President,,DEM,Over Votes,0,0,0,0
Comal,305,U.S. Senate,,DEM,Royce West,8,2,3,13
Comal,305,U.S. Senate,,DEM,Chris Bell,10,1,2,13
Comal,305,U.S. Senate,,DEM,Amanda K. Edwards,17,2,9,28
Comal,305,U.S. Senate,,DEM,Sema Hernandez,13,5,10,28
Comal,305,U.S. Senate,,DEM,Jack Daniel Foster Jr,3,1,0,4
Comal,305,U.S. Senate,,DEM,D.R. Hunter,3,0,2,5
Comal,305,U.S. Senate,,DEM,Adrian Ocegueda,3,0,2,5
Comal,305,U.S. Senate,,DEM,"Mary ""MJ"" Hegar",27,6,25,58
Comal,305,U.S. Senate,,DEM,Cristina Tzintzun Ramirez,13,5,13,31
Comal,305,U.S. Senate,,DEM,Michael Cooper,4,1,3,8
Comal,305,U.S. Senate,,DEM,Victor Hugo Harris,1,0,0,1
Comal,305,U.S. Senate,,DEM,"Annie ""Mam치"" Garcia",14,0,7,21
Comal,305,U.S. Senate,,DEM,Cast Votes:,116,23,76,215
Comal,305,U.S. Senate,,DEM,Under Votes,26,3,7,36
Comal,305,U.S. Senate,,DEM,Over Votes,0,0,0,0
Comal,305,U.S. House,21,DEM,Wendy R. Davis,102,18,67,187
Comal,305,U.S. House,21,DEM,Jennie Lou Leeder,20,4,12,36
Comal,305,U.S. House,21,DEM,Cast Votes:,122,22,79,223
Comal,305,U.S. House,21,DEM,Under Votes,20,4,4,28
Comal,305,U.S. House,21,DEM,Over Votes,0,0,0,0
Comal,305,Railroad Commissioner,,DEM,Mark Watson,18,4,10,32
Comal,305,Railroad Commissioner,,DEM,Chrysta Casta침eda,37,8,25,70
Comal,305,Railroad Commissioner,,DEM,Kelly Stone,17,4,15,36
Comal,305,Railroad Commissioner,,DEM,"Roberto R. ""Beto"" Alonzo",40,7,22,69
Comal,305,Railroad Commissioner,,DEM,Cast Votes:,112,23,72,207
Comal,305,Railroad Commissioner,,DEM,Under Votes,30,3,11,44
Comal,305,Railroad Commissioner,,DEM,Over Votes,0,0,0,0
Comal,305,"Chief Justice, Supreme Court",,DEM,Amy Clark Meachum,97,16,63,176
Comal,305,"Chief Justice, Supreme Court",,DEM,Jerry Zimmerer,18,7,11,36
Comal,305,"Chief Justice, Supreme Court",,DEM,Cast Votes:,115,23,74,212
Comal,305,"Chief Justice, Supreme Court",,DEM,Under Votes,27,3,9,39
Comal,305,"Chief Justice, Supreme Court",,DEM,Over Votes,0,0,0,0
Comal,305,"Justice, Supreme Court, Place 6 Unexpired Term",,DEM,Larry Praeger,23,9,12,44
Comal,305,"Justice, Supreme Court, Place 6 Unexpired Term",,DEM,Kathy Cheng,91,14,62,167
Comal,305,"Justice, Supreme Court, Place 6 Unexpired Term",,DEM,Cast Votes:,114,23,74,211
Comal,305,"Justice, Supreme Court, Place 6 Unexpired Term",,DEM,Under Votes,28,3,9,40
Comal,305,"Justice, Supreme Court, Place 6 Unexpired Term",,DEM,Over Votes,0,0,0,0
Comal,305,"Justice, Supreme Court, Place 7",,DEM,Staci Williams,85,12,52,149
Comal,305,"Justice, Supreme Court, Place 7",,DEM,Brandy Voss,28,11,20,59
Comal,305,"Justice, Supreme Court, Place 7",,DEM,Cast Votes:,113,23,72,208
Comal,305,"Justice, Supreme Court, Place 7",,DEM,Under Votes,29,3,11,43
Comal,305,"Justice, Supreme Court, Place 7",,DEM,Over Votes,0,0,0,0
Comal,305,"Justice, Supreme Court, Place 8",,DEM,Peter Kelly,23,8,15,46
Comal,305,"Justice, Supreme Court, Place 8",,DEM,Gisela D. Triana,90,15,58,163
Comal,305,"Justice, Supreme Court, Place 8",,DEM,Cast Votes:,113,23,73,209
Comal,305,"Justice, Supreme Court, Place 8",,DEM,Under Votes,29,3,10,42
Comal,305,"Justice, Supreme Court, Place 8",,DEM,Over Votes,0,0,0,0
Comal,305,"Judge, Court of Criminal Appeals, Place 3",,DEM,Elizabeth Davis Frizell,83,14,58,155
Comal,305,"Judge, Court of Criminal Appeals, Place 3",,DEM,William Pieratt Demond,15,3,4,22
Comal,305,"Judge, Court of Criminal Appeals, Place 3",,DEM,Dan Wood,13,5,9,27
Comal,305,"Judge, Court of Criminal Appeals, Place 3",,DEM,Cast Votes:,111,22,71,204
Comal,305,"Judge, Court of Criminal Appeals, Place 3",,DEM,Under Votes,31,4,12,47
Comal,305,"Judge, Court of Criminal Appeals, Place 3",,DEM,Over Votes,0,0,0,0
Comal,305,"Judge, Court of Criminal Appeals, Place 4",,DEM,Tina Clinton,87,17,58,162
Comal,305,"Judge, Court of Criminal Appeals, Place 4",,DEM,Steven Miears,23,5,12,40
Comal,305,"Judge, Court of Criminal Appeals, Place 4",,DEM,Cast Votes:,110,22,70,202
Comal,305,"Judge, Court of Criminal Appeals, Place 4",,DEM,Under Votes,32,4,13,49
Comal,305,"Judge, Court of Criminal Appeals, Place 4",,DEM,Over Votes,0,0,0,0
Comal,305,"Judge, Court of Criminal Appeals, Place 9",,DEM,Brandon Birmingham,107,23,65,195
Comal,305,"Judge, Court of Criminal Appeals, Place 9",,DEM,Cast Votes:,107,23,65,195
Comal,305,"Judge, Court of Criminal Appeals, Place 9",,DEM,Under Votes,35,3,18,56
Comal,305,"Judge, Court of Criminal Appeals, Place 9",,DEM,Over Votes,0,0,0,0
Comal,305,"Member, State Board of Education, District 5",,DEM,Rebecca Bell-Metereau,70,14,43,127
Comal,305,"Member, State Board of Education, District 5",,DEM,Letti Bresnahan,42,10,26,78
Comal,305,"Member, State Board of Education, District 5",,DEM,Cast Votes:,112,24,69,205
Comal,305,"Member, State Board of Education, District 5",,DEM,Under Votes,30,2,14,46
Comal,305,"Member, State Board of Education, District 5",,DEM,Over Votes,0,0,0,0
Comal,305,State Representative,73,DEM,Stephanie Phillips,112,23,67,202
Comal,305,State Representative,73,DEM,Cast Votes:,112,23,67,202
Comal,305,State Representative,73,DEM,Under Votes,30,3,16,49
Comal,305,State Representative,73,DEM,Over Votes,0,0,0,0
Comal,305,"Chief Justice, 3rd Court of Appeals District",,DEM,Darlene Byrne,81,17,56,154
Comal,305,"Chief Justice, 3rd Court of Appeals District",,DEM,Keith S. Hampton,21,5,10,36
Comal,305,"Chief Justice, 3rd Court of Appeals District",,DEM,Cast Votes:,102,22,66,190
Comal,305,"Chief Justice, 3rd Court of Appeals District",,DEM,Under Votes,40,4,17,61
Comal,305,"Chief Justice, 3rd Court of Appeals District",,DEM,Over Votes,0,0,0,0
Comal,305,"County Commissioner, Precinct 3",,DEM,Colette Nies,106,23,63,192
Comal,305,"County Commissioner, Precinct 3",,DEM,Cast Votes:,106,23,63,192
Comal,305,"County Commissioner, Precinct 3",,DEM,Under Votes,36,3,20,59
Comal,305,"County Commissioner, Precinct 3",,DEM,Over Votes,0,0,0,0
Comal,305,County Chairman,,DEM,Gloria Meehan,107,23,66,196
Comal,305,County Chairman,,DEM,Cast Votes:,107,23,66,196
Comal,305,County Chairman,,DEM,Under Votes,35,3,17,55
Comal,305,County Chairman,,DEM,Over Votes,0,0,0,0
Comal,305,Proposition #1,,DEM,Yes,133,22,78,233
Comal,305,Proposition #1,,DEM,No,5,0,1,6
Comal,305,Proposition #1,,DEM,Cast Votes:,138,22,79,239
Comal,305,Proposition #1,,DEM,Under Votes,4,4,4,12
Comal,305,Proposition #1,,DEM,Over Votes,0,0,0,0
Comal,305,Proposition #2,,DEM,Yes,135,23,77,235
Comal,305,Proposition #2,,DEM,No,4,0,2,6
Comal,305,Proposition #2,,DEM,Cast Votes:,139,23,79,241
Comal,305,Proposition #2,,DEM,Under Votes,3,3,4,10
Comal,305,Proposition #2,,DEM,Over Votes,0,0,0,0
Comal,305,Proposition #3,,DEM,Yes,138,23,80,241
Comal,305,Proposition #3,,DEM,No,0,0,0,0
Comal,305,Proposition #3,,DEM,Cast Votes:,138,23,80,241
Comal,305,Proposition #3,,DEM,Under Votes,4,3,3,10
Comal,305,Proposition #3,,DEM,Over Votes,0,0,0,0
Comal,305,Proposition #4,,DEM,Yes,134,22,79,235
Comal,305,Proposition #4,,DEM,No,5,0,0,5
Comal,305,Proposition #4,,DEM,Cast Votes:,139,22,79,240
Comal,305,Proposition #4,,DEM,Under Votes,3,4,4,11
Comal,305,Proposition #4,,DEM,Over Votes,0,0,0,0
Comal,305,Proposition #5,,DEM,Yes,135,22,80,237
Comal,305,Proposition #5,,DEM,No,3,0,0,3
Comal,305,Proposition #5,,DEM,Cast Votes:,138,22,80,240
Comal,305,Proposition #5,,DEM,Under Votes,4,4,3,11
Comal,305,Proposition #5,,DEM,Over Votes,0,0,0,0
Comal,305,Proposition #6,,DEM,Yes,137,21,80,238
Comal,305,Proposition #6,,DEM,No,2,1,0,3
Comal,305,Proposition #6,,DEM,Cast Votes:,139,22,80,241
Comal,305,Proposition #6,,DEM,Under Votes,3,4,3,10
Comal,305,Proposition #6,,DEM,Over Votes,0,0,0,0
Comal,305,Proposition #7,,DEM,Yes,133,22,79,234
Comal,305,Proposition #7,,DEM,No,4,0,1,5
Comal,305,Proposition #7,,DEM,Cast Votes:,137,22,80,239
Comal,305,Proposition #7,,DEM,Under Votes,5,4,3,12
Comal,305,Proposition #7,,DEM,Over Votes,0,0,0,0
Comal,305,Proposition #8,,DEM,Yes,137,22,78,237
Comal,305,Proposition #8,,DEM,No,1,0,1,2
Comal,305,Proposition #8,,DEM,Cast Votes:,138,22,79,239
Comal,305,Proposition #8,,DEM,Under Votes,4,4,4,12
Comal,305,Proposition #8,,DEM,Over Votes,0,0,0,0
Comal,305,Proposition #9,,DEM,Yes,137,22,78,237
Comal,305,Proposition #9,,DEM,No,2,0,0,2
Comal,305,Proposition #9,,DEM,Cast Votes:,139,22,78,239
Comal,305,Proposition #9,,DEM,Under Votes,3,4,5,12
Comal,305,Proposition #9,,DEM,Over Votes,0,0,0,0
Comal,305,Proposition #10,,DEM,Yes,133,22,77,232
Comal,305,Proposition #10,,DEM,No,5,0,2,7
Comal,305,Proposition #10,,DEM,Cast Votes:,138,22,79,239
Comal,305,Proposition #10,,DEM,Under Votes,4,4,4,12
Comal,305,Proposition #10,,DEM,Over Votes,0,0,0,0
Comal,305,Proposition #11,,DEM,Yes,126,20,73,219
Comal,305,Proposition #11,,DEM,No,11,2,5,18
Comal,305,Proposition #11,,DEM,Cast Votes:,137,22,78,237
Comal,305,Proposition #11,,DEM,Under Votes,5,4,5,14
Comal,305,Proposition #11,,DEM,Over Votes,0,0,0,0
Comal,306,President,,DEM,Tulsi Gabbard,0,0,0,0
Comal,306,President,,DEM,Marianne Williamson,0,0,0,0
Comal,306,President,,DEM,John K. Delaney,0,0,1,1
Comal,306,President,,DEM,Elizabeth Warren,8,0,13,21
Comal,306,President,,DEM,Cory Booker,0,0,0,0
Comal,306,President,,DEM,Amy Klobuchar,0,0,2,2
Comal,306,President,,DEM,Joseph R. Biden,37,3,4,44
Comal,306,President,,DEM,Pete Buttigieg,0,0,12,12
Comal,306,President,,DEM,Juli치n Castro,0,0,0,0
Comal,306,President,,DEM,Tom Steyer,0,0,1,1
Comal,306,President,,DEM,Michael Bennet,0,0,0,0
Comal,306,President,,DEM,Michael R. Bloomberg,9,2,5,16
Comal,306,President,,DEM,Robby Wells,0,0,0,0
Comal,306,President,,DEM,"Roque ""Rocky"" De La Fuente",0,0,0,0
Comal,306,President,,DEM,Deval Patrick,0,0,0,0
Comal,306,President,,DEM,Bernie Sanders,56,1,33,90
Comal,306,President,,DEM,Andrew Yang,1,0,0,1
Comal,306,Ballots Cast,,DEM,,111,6,71,188
Comal,306,President,,DEM,Under Votes,0,0,0,0
Comal,306,President,,DEM,Over Votes,0,0,0,0
Comal,306,U.S. Senate,,DEM,Royce West,8,0,1,9
Comal,306,U.S. Senate,,DEM,Chris Bell,2,0,12,14
Comal,306,U.S. Senate,,DEM,Amanda K. Edwards,13,0,10,23
Comal,306,U.S. Senate,,DEM,Sema Hernandez,17,1,8,26
Comal,306,U.S. Senate,,DEM,Jack Daniel Foster Jr,3,1,3,7
Comal,306,U.S. Senate,,DEM,D.R. Hunter,1,0,0,1
Comal,306,U.S. Senate,,DEM,Adrian Ocegueda,5,1,2,8
Comal,306,U.S. Senate,,DEM,"Mary ""MJ"" Hegar",13,2,15,30
Comal,306,U.S. Senate,,DEM,Cristina Tzintzun Ramirez,12,0,9,21
Comal,306,U.S. Senate,,DEM,Michael Cooper,2,1,1,4
Comal,306,U.S. Senate,,DEM,Victor Hugo Harris,1,0,0,1
Comal,306,U.S. Senate,,DEM,"Annie ""Mam치"" Garcia",12,0,3,15
Comal,306,U.S. Senate,,DEM,Cast Votes:,89,6,64,159
Comal,306,U.S. Senate,,DEM,Under Votes,22,0,7,29
Comal,306,U.S. Senate,,DEM,Over Votes,0,0,0,0
Comal,306,U.S. House,35,DEM,Rafael Alcoser III,48,0,25,73
Comal,306,U.S. House,35,DEM,Lloyd Doggett,44,5,38,87
Comal,306,U.S. House,35,DEM,Cast Votes:,92,5,63,160
Comal,306,U.S. House,35,DEM,Under Votes,19,1,8,28
Comal,306,U.S. House,35,DEM,Over Votes,0,0,0,0
Comal,306,Railroad Commissioner,,DEM,Mark Watson,14,2,8,24
Comal,306,Railroad Commissioner,,DEM,Chrysta Casta침eda,28,1,26,55
Comal,306,Railroad Commissioner,,DEM,Kelly Stone,16,1,18,35
Comal,306,Railroad Commissioner,,DEM,"Roberto R. ""Beto"" Alonzo",30,1,10,41
Comal,306,Railroad Commissioner,,DEM,Cast Votes:,88,5,62,155
Comal,306,Railroad Commissioner,,DEM,Under Votes,23,1,9,33
Comal,306,Railroad Commissioner,,DEM,Over Votes,0,0,0,0
Comal,306,"Chief Justice, Supreme Court",,DEM,Amy Clark Meachum,77,5,53,135
Comal,306,"Chief Justice, Supreme Court",,DEM,Jerry Zimmerer,13,0,7,20
Comal,306,"Chief Justice, Supreme Court",,DEM,Cast Votes:,90,5,60,155
Comal,306,"Chief Justice, Supreme Court",,DEM,Under Votes,21,1,11,33
Comal,306,"Chief Justice, Supreme Court",,DEM,Over Votes,0,0,0,0
Comal,306,"Justice, Supreme Court, Place 6 Unexpired Term",,DEM,Larry Praeger,16,1,10,27
Comal,306,"Justice, Supreme Court, Place 6 Unexpired Term",,DEM,Kathy Cheng,72,4,50,126
Comal,306,"Justice, Supreme Court, Place 6 Unexpired Term",,DEM,Cast Votes:,88,5,60,153
Comal,306,"Justice, Supreme Court, Place 6 Unexpired Term",,DEM,Under Votes,23,1,11,35
Comal,306,"Justice, Supreme Court, Place 6 Unexpired Term",,DEM,Over Votes,0,0,0,0
Comal,306,"Justice, Supreme Court, Place 7",,DEM,Staci Williams,59,4,38,101
Comal,306,"Justice, Supreme Court, Place 7",,DEM,Brandy Voss,30,1,19,50
Comal,306,"Justice, Supreme Court, Place 7",,DEM,Cast Votes:,89,5,57,151
Comal,306,"Justice, Supreme Court, Place 7",,DEM,Under Votes,22,1,14,37
Comal,306,"Justice, Supreme Court, Place 7",,DEM,Over Votes,0,0,0,0
Comal,306,"Justice, Supreme Court, Place 8",,DEM,Peter Kelly,20,3,17,40
Comal,306,"Justice, Supreme Court, Place 8",,DEM,Gisela D. Triana,64,2,41,107
Comal,306,"Justice, Supreme Court, Place 8",,DEM,Cast Votes:,84,5,58,147
Comal,306,"Justice, Supreme Court, Place 8",,DEM,Under Votes,27,1,13,41
Comal,306,"Justice, Supreme Court, Place 8",,DEM,Over Votes,0,0,0,0
Comal,306,"Judge, Court of Criminal Appeals, Place 3",,DEM,Elizabeth Davis Frizell,60,4,46,110
Comal,306,"Judge, Court of Criminal Appeals, Place 3",,DEM,William Pieratt Demond,9,0,5,14
Comal,306,"Judge, Court of Criminal Appeals, Place 3",,DEM,Dan Wood,17,1,8,26
Comal,306,"Judge, Court of Criminal Appeals, Place 3",,DEM,Cast Votes:,86,5,59,150
Comal,306,"Judge, Court of Criminal Appeals, Place 3",,DEM,Under Votes,25,1,12,38
Comal,306,"Judge, Court of Criminal Appeals, Place 3",,DEM,Over Votes,0,0,0,0
Comal,306,"Judge, Court of Criminal Appeals, Place 4",,DEM,Tina Clinton,67,5,47,119
Comal,306,"Judge, Court of Criminal Appeals, Place 4",,DEM,Steven Miears,18,0,12,30
Comal,306,"Judge, Court of Criminal Appeals, Place 4",,DEM,Cast Votes:,85,5,59,149
Comal,306,"Judge, Court of Criminal Appeals, Place 4",,DEM,Under Votes,26,1,12,39
Comal,306,"Judge, Court of Criminal Appeals, Place 4",,DEM,Over Votes,0,0,0,0
Comal,306,"Judge, Court of Criminal Appeals, Place 9",,DEM,Brandon Birmingham,79,5,57,141
Comal,306,"Judge, Court of Criminal Appeals, Place 9",,DEM,Cast Votes:,79,5,57,141
Comal,306,"Judge, Court of Criminal Appeals, Place 9",,DEM,Under Votes,32,1,14,47
Comal,306,"Judge, Court of Criminal Appeals, Place 9",,DEM,Over Votes,0,0,0,0
Comal,306,"Member, State Board of Education, District 5",,DEM,Rebecca Bell-Metereau,56,2,39,97
Comal,306,"Member, State Board of Education, District 5",,DEM,Letti Bresnahan,30,3,20,53
Comal,306,"Member, State Board of Education, District 5",,DEM,Cast Votes:,86,5,59,150
Comal,306,"Member, State Board of Education, District 5",,DEM,Under Votes,25,1,12,38
Comal,306,"Member, State Board of Education, District 5",,DEM,Over Votes,0,0,0,0
Comal,306,State Representative,73,DEM,Stephanie Phillips,87,5,55,147
Comal,306,State Representative,73,DEM,Cast Votes:,87,5,55,147
Comal,306,State Representative,73,DEM,Under Votes,24,1,16,41
Comal,306,State Representative,73,DEM,Over Votes,0,0,0,0
Comal,306,"Chief Justice, 3rd Court of Appeals District",,DEM,Darlene Byrne,63,4,41,108
Comal,306,"Chief Justice, 3rd Court of Appeals District",,DEM,Keith S. Hampton,20,1,15,36
Comal,306,"Chief Justice, 3rd Court of Appeals District",,DEM,Cast Votes:,83,5,56,144
Comal,306,"Chief Justice, 3rd Court of Appeals District",,DEM,Under Votes,28,1,15,44
Comal,306,"Chief Justice, 3rd Court of Appeals District",,DEM,Over Votes,0,0,0,0
Comal,306,"County Commissioner, Precinct 3",,DEM,Colette Nies,84,5,54,143
Comal,306,"County Commissioner, Precinct 3",,DEM,Cast Votes:,84,5,54,143
Comal,306,"County Commissioner, Precinct 3",,DEM,Under Votes,27,1,17,45
Comal,306,"County Commissioner, Precinct 3",,DEM,Over Votes,0,0,0,0
Comal,306,County Chairman,,DEM,Gloria Meehan,86,5,54,145
Comal,306,County Chairman,,DEM,Cast Votes:,86,5,54,145
Comal,306,County Chairman,,DEM,Under Votes,25,1,17,43
Comal,306,County Chairman,,DEM,Over Votes,0,0,0,0
Comal,306,Proposition #1,,DEM,Yes,101,6,70,177
Comal,306,Proposition #1,,DEM,No,7,0,1,8
Comal,306,Proposition #1,,DEM,Cast Votes:,108,6,71,185
Comal,306,Proposition #1,,DEM,Under Votes,3,0,0,3
Comal,306,Proposition #1,,DEM,Over Votes,0,0,0,0
Comal,306,Proposition #2,,DEM,Yes,103,6,69,178
Comal,306,Proposition #2,,DEM,No,4,0,2,6
Comal,306,Proposition #2,,DEM,Cast Votes:,107,6,71,184
Comal,306,Proposition #2,,DEM,Under Votes,4,0,0,4
Comal,306,Proposition #2,,DEM,Over Votes,0,0,0,0
Comal,306,Proposition #3,,DEM,Yes,105,6,70,181
Comal,306,Proposition #3,,DEM,No,3,0,1,4
Comal,306,Proposition #3,,DEM,Cast Votes:,108,6,71,185
Comal,306,Proposition #3,,DEM,Under Votes,3,0,0,3
Comal,306,Proposition #3,,DEM,Over Votes,0,0,0,0
Comal,306,Proposition #4,,DEM,Yes,98,6,69,173
Comal,306,Proposition #4,,DEM,No,5,0,2,7
Comal,306,Proposition #4,,DEM,Cast Votes:,103,6,71,180
Comal,306,Proposition #4,,DEM,Under Votes,8,0,0,8
Comal,306,Proposition #4,,DEM,Over Votes,0,0,0,0
Comal,306,Proposition #5,,DEM,Yes,106,6,70,182
Comal,306,Proposition #5,,DEM,No,0,0,0,0
Comal,306,Proposition #5,,DEM,Cast Votes:,106,6,70,182
Comal,306,Proposition #5,,DEM,Under Votes,5,0,1,6
Comal,306,Proposition #5,,DEM,Over Votes,0,0,0,0
Comal,306,Proposition #6,,DEM,Yes,105,6,67,178
Comal,306,Proposition #6,,DEM,No,1,0,2,3
Comal,306,Proposition #6,,DEM,Cast Votes:,106,6,69,181
Comal,306,Proposition #6,,DEM,Under Votes,5,0,2,7
Comal,306,Proposition #6,,DEM,Over Votes,0,0,0,0
Comal,306,Proposition #7,,DEM,Yes,97,6,68,171
Comal,306,Proposition #7,,DEM,No,8,0,2,10
Comal,306,Proposition #7,,DEM,Cast Votes:,105,6,70,181
Comal,306,Proposition #7,,DEM,Under Votes,6,0,1,7
Comal,306,Proposition #7,,DEM,Over Votes,0,0,0,0
Comal,306,Proposition #8,,DEM,Yes,104,6,67,177
Comal,306,Proposition #8,,DEM,No,2,0,3,5
Comal,306,Proposition #8,,DEM,Cast Votes:,106,6,70,182
Comal,306,Proposition #8,,DEM,Under Votes,5,0,1,6
Comal,306,Proposition #8,,DEM,Over Votes,0,0,0,0
Comal,306,Proposition #9,,DEM,Yes,105,6,70,181
Comal,306,Proposition #9,,DEM,No,2,0,0,2
Comal,306,Proposition #9,,DEM,Cast Votes:,107,6,70,183
Comal,306,Proposition #9,,DEM,Under Votes,4,0,1,5
Comal,306,Proposition #9,,DEM,Over Votes,0,0,0,0
Comal,306,Proposition #10,,DEM,Yes,106,6,67,179
Comal,306,Proposition #10,,DEM,No,1,0,3,4
Comal,306,Proposition #10,,DEM,Cast Votes:,107,6,70,183
Comal,306,Proposition #10,,DEM,Under Votes,4,0,1,5
Comal,306,Proposition #10,,DEM,Over Votes,0,0,0,0
Comal,306,Proposition #11,,DEM,Yes,101,6,69,176
Comal,306,Proposition #11,,DEM,No,3,0,1,4
Comal,306,Proposition #11,,DEM,Cast Votes:,104,6,70,180
Comal,306,Proposition #11,,DEM,Under Votes,7,0,1,8
Comal,306,Proposition #11,,DEM,Over Votes,0,0,0,0
Comal,401,President,,DEM,Tulsi Gabbard,1,1,1,3
Comal,401,President,,DEM,Marianne Williamson,0,0,0,0
Comal,401,President,,DEM,John K. Delaney,0,0,0,0
Comal,401,President,,DEM,Elizabeth Warren,22,3,14,39
Comal,401,President,,DEM,Cory Booker,0,0,0,0
Comal,401,President,,DEM,Amy Klobuchar,0,4,9,13
Comal,401,President,,DEM,Joseph R. Biden,74,11,20,105
Comal,401,President,,DEM,Pete Buttigieg,0,4,8,12
Comal,401,President,,DEM,Juli치n Castro,0,2,0,2
Comal,401,President,,DEM,Tom Steyer,0,0,1,1
Comal,401,President,,DEM,Michael Bennet,0,1,0,1
Comal,401,President,,DEM,Michael R. Bloomberg,13,15,18,46
Comal,401,President,,DEM,Robby Wells,0,0,0,0
Comal,401,President,,DEM,"Roque ""Rocky"" De La Fuente",0,0,0,0
Comal,401,President,,DEM,Deval Patrick,0,0,0,0
Comal,401,President,,DEM,Bernie Sanders,26,4,17,47
Comal,401,President,,DEM,Andrew Yang,0,1,1,2
Comal,401,Ballots Cast,,DEM,,136,46,89,271
Comal,401,President,,DEM,Under Votes,0,0,0,0
Comal,401,President,,DEM,Over Votes,0,0,0,0
Comal,401,U.S. Senate,,DEM,Royce West,11,2,7,20
Comal,401,U.S. Senate,,DEM,Chris Bell,12,7,7,26
Comal,401,U.S. Senate,,DEM,Amanda K. Edwards,19,8,9,36
Comal,401,U.S. Senate,,DEM,Sema Hernandez,2,1,6,9
Comal,401,U.S. Senate,,DEM,Jack Daniel Foster Jr,2,0,0,2
Comal,401,U.S. Senate,,DEM,D.R. Hunter,3,1,1,5
Comal,401,U.S. Senate,,DEM,Adrian Ocegueda,2,0,0,2
Comal,401,U.S. Senate,,DEM,"Mary ""MJ"" Hegar",34,17,40,91
Comal,401,U.S. Senate,,DEM,Cristina Tzintzun Ramirez,10,1,5,16
Comal,401,U.S. Senate,,DEM,Michael Cooper,1,0,0,1
Comal,401,U.S. Senate,,DEM,Victor Hugo Harris,2,4,0,6
Comal,401,U.S. Senate,,DEM,"Annie ""Mam치"" Garcia",8,2,5,15
Comal,401,U.S. Senate,,DEM,Cast Votes:,106,43,80,229
Comal,401,U.S. Senate,,DEM,Under Votes,30,3,9,42
Comal,401,U.S. Senate,,DEM,Over Votes,0,0,0,0
Comal,401,U.S. House,21,DEM,Wendy R. Davis,96,32,68,196
Comal,401,U.S. House,21,DEM,Jennie Lou Leeder,22,9,8,39
Comal,401,U.S. House,21,DEM,Cast Votes:,118,41,76,235
Comal,401,U.S. House,21,DEM,Under Votes,18,5,13,36
Comal,401,U.S. House,21,DEM,Over Votes,0,0,0,0
Comal,401,Railroad Commissioner,,DEM,Mark Watson,16,9,19,44
Comal,401,Railroad Commissioner,,DEM,Chrysta Casta침eda,39,20,32,91
Comal,401,Railroad Commissioner,,DEM,Kelly Stone,19,2,21,42
Comal,401,Railroad Commissioner,,DEM,"Roberto R. ""Beto"" Alonzo",21,6,4,31
Comal,401,Railroad Commissioner,,DEM,Cast Votes:,95,37,76,208
Comal,401,Railroad Commissioner,,DEM,Under Votes,41,9,13,63
Comal,401,Railroad Commissioner,,DEM,Over Votes,0,0,0,0
Comal,401,"Chief Justice, Supreme Court",,DEM,Amy Clark Meachum,83,33,73,189
Comal,401,"Chief Justice, Supreme Court",,DEM,Jerry Zimmerer,11,5,2,18
Comal,401,"Chief Justice, Supreme Court",,DEM,Cast Votes:,94,38,75,207
Comal,401,"Chief Justice, Supreme Court",,DEM,Under Votes,42,8,14,64
Comal,401,"Chief Justice, Supreme Court",,DEM,Over Votes,0,0,0,0
Comal,401,"Justice, Supreme Court, Place 6 Unexpired Term",,DEM,Larry Praeger,23,13,19,55
Comal,401,"Justice, Supreme Court, Place 6 Unexpired Term",,DEM,Kathy Cheng,71,24,57,152
Comal,401,"Justice, Supreme Court, Place 6 Unexpired Term",,DEM,Cast Votes:,94,37,76,207
Comal,401,"Justice, Supreme Court, Place 6 Unexpired Term",,DEM,Under Votes,42,9,13,64
Comal,401,"Justice, Supreme Court, Place 6 Unexpired Term",,DEM,Over Votes,0,0,0,0
Comal,401,"Justice, Supreme Court, Place 7",,DEM,Staci Williams,58,18,44,120
Comal,401,"Justice, Supreme Court, Place 7",,DEM,Brandy Voss,34,18,29,81
Comal,401,"Justice, Supreme Court, Place 7",,DEM,Cast Votes:,92,36,73,201
Comal,401,"Justice, Supreme Court, Place 7",,DEM,Under Votes,44,10,16,70
Comal,401,"Justice, Supreme Court, Place 7",,DEM,Over Votes,0,0,0,0
Comal,401,"Justice, Supreme Court, Place 8",,DEM,Peter Kelly,28,9,19,56
Comal,401,"Justice, Supreme Court, Place 8",,DEM,Gisela D. Triana,67,28,56,151
Comal,401,"Justice, Supreme Court, Place 8",,DEM,Cast Votes:,95,37,75,207
Comal,401,"Justice, Supreme Court, Place 8",,DEM,Under Votes,41,9,14,64
Comal,401,"Justice, Supreme Court, Place 8",,DEM,Over Votes,0,0,0,0
Comal,401,"Judge, Court of Criminal Appeals, Place 3",,DEM,Elizabeth Davis Frizell,76,25,59,160
Comal,401,"Judge, Court of Criminal Appeals, Place 3",,DEM,William Pieratt Demond,9,2,7,18
Comal,401,"Judge, Court of Criminal Appeals, Place 3",,DEM,Dan Wood,9,10,8,27
Comal,401,"Judge, Court of Criminal Appeals, Place 3",,DEM,Cast Votes:,94,37,74,205
Comal,401,"Judge, Court of Criminal Appeals, Place 3",,DEM,Under Votes,42,9,15,66
Comal,401,"Judge, Court of Criminal Appeals, Place 3",,DEM,Over Votes,0,0,0,0
Comal,401,"Judge, Court of Criminal Appeals, Place 4",,DEM,Tina Clinton,79,29,63,171
Comal,401,"Judge, Court of Criminal Appeals, Place 4",,DEM,Steven Miears,15,9,13,37
Comal,401,"Judge, Court of Criminal Appeals, Place 4",,DEM,Cast Votes:,94,38,76,208
Comal,401,"Judge, Court of Criminal Appeals, Place 4",,DEM,Under Votes,42,8,13,63
Comal,401,"Judge, Court of Criminal Appeals, Place 4",,DEM,Over Votes,0,0,0,0
Comal,401,"Judge, Court of Criminal Appeals, Place 9",,DEM,Brandon Birmingham,83,30,62,175
Comal,401,"Judge, Court of Criminal Appeals, Place 9",,DEM,Cast Votes:,83,30,62,175
Comal,401,"Judge, Court of Criminal Appeals, Place 9",,DEM,Under Votes,53,16,27,96
Comal,401,"Judge, Court of Criminal Appeals, Place 9",,DEM,Over Votes,0,0,0,0
Comal,401,"Member, State Board of Education, District 5",,DEM,Rebecca Bell-Metereau,67,30,53,150
Comal,401,"Member, State Board of Education, District 5",,DEM,Letti Bresnahan,28,8,21,57
Comal,401,"Member, State Board of Education, District 5",,DEM,Cast Votes:,95,38,74,207
Comal,401,"Member, State Board of Education, District 5",,DEM,Under Votes,41,8,15,64
Comal,401,"Member, State Board of Education, District 5",,DEM,Over Votes,0,0,0,0
Comal,401,State Representative,73,DEM,Stephanie Phillips,91,34,70,195
Comal,401,State Representative,73,DEM,Cast Votes:,91,34,70,195
Comal,401,State Representative,73,DEM,Under Votes,45,12,19,76
Comal,401,State Representative,73,DEM,Over Votes,0,0,0,0
Comal,401,"Chief Justice, 3rd Court of Appeals District",,DEM,Darlene Byrne,73,27,54,154
Comal,401,"Chief Justice, 3rd Court of Appeals District",,DEM,Keith S. Hampton,16,9,19,44
Comal,401,"Chief Justice, 3rd Court of Appeals District",,DEM,Cast Votes:,89,36,73,198
Comal,401,"Chief Justice, 3rd Court of Appeals District",,DEM,Under Votes,47,10,16,73
Comal,401,"Chief Justice, 3rd Court of Appeals District",,DEM,Over Votes,0,0,0,0
Comal,401,County Chairman,,DEM,Gloria Meehan,90,33,69,192
Comal,401,County Chairman,,DEM,Cast Votes:,90,33,69,192
Comal,401,County Chairman,,DEM,Under Votes,46,13,20,79
Comal,401,County Chairman,,DEM,Over Votes,0,0,0,0
Comal,401,Proposition #1,,DEM,Yes,119,39,82,240
Comal,401,Proposition #1,,DEM,No,7,4,7,18
Comal,401,Proposition #1,,DEM,Cast Votes:,126,43,89,258
Comal,401,Proposition #1,,DEM,Under Votes,10,3,0,13
Comal,401,Proposition #1,,DEM,Over Votes,0,0,0,0
Comal,401,Proposition #2,,DEM,Yes,116,39,81,236
Comal,401,Proposition #2,,DEM,No,9,4,8,21
Comal,401,Proposition #2,,DEM,Cast Votes:,125,43,89,257
Comal,401,Proposition #2,,DEM,Under Votes,11,3,0,14
Comal,401,Proposition #2,,DEM,Over Votes,0,0,0,0
Comal,401,Proposition #3,,DEM,Yes,125,42,85,252
Comal,401,Proposition #3,,DEM,No,4,2,2,8
Comal,401,Proposition #3,,DEM,Cast Votes:,129,44,87,260
Comal,401,Proposition #3,,DEM,Under Votes,7,2,2,11
Comal,401,Proposition #3,,DEM,Over Votes,0,0,0,0
Comal,401,Proposition #4,,DEM,Yes,117,43,84,244
Comal,401,Proposition #4,,DEM,No,9,2,4,15
Comal,401,Proposition #4,,DEM,Cast Votes:,126,45,88,259
Comal,401,Proposition #4,,DEM,Under Votes,10,1,1,12
Comal,401,Proposition #4,,DEM,Over Votes,0,0,0,0
Comal,401,Proposition #5,,DEM,Yes,124,43,84,251
Comal,401,Proposition #5,,DEM,No,4,2,3,9
Comal,401,Proposition #5,,DEM,Cast Votes:,128,45,87,260
Comal,401,Proposition #5,,DEM,Under Votes,8,1,2,11
Comal,401,Proposition #5,,DEM,Over Votes,0,0,0,0
Comal,401,Proposition #6,,DEM,Yes,125,43,84,252
Comal,401,Proposition #6,,DEM,No,4,2,3,9
Comal,401,Proposition #6,,DEM,Cast Votes:,129,45,87,261
Comal,401,Proposition #6,,DEM,Under Votes,7,1,2,10
Comal,401,Proposition #6,,DEM,Over Votes,0,0,0,0
Comal,401,Proposition #7,,DEM,Yes,120,39,80,239
Comal,401,Proposition #7,,DEM,No,9,4,6,19
Comal,401,Proposition #7,,DEM,Cast Votes:,129,43,86,258
Comal,401,Proposition #7,,DEM,Under Votes,7,3,3,13
Comal,401,Proposition #7,,DEM,Over Votes,0,0,0,0
Comal,401,Proposition #8,,DEM,Yes,122,42,81,245
Comal,401,Proposition #8,,DEM,No,4,1,8,13
Comal,401,Proposition #8,,DEM,Cast Votes:,126,43,89,258
Comal,401,Proposition #8,,DEM,Under Votes,10,2,0,12
Comal,401,Proposition #8,,DEM,Over Votes,0,0,0,0
Comal,401,Proposition #9,,DEM,Yes,125,40,84,249
Comal,401,Proposition #9,,DEM,No,4,2,3,9
Comal,401,Proposition #9,,DEM,Cast Votes:,129,42,87,258
Comal,401,Proposition #9,,DEM,Under Votes,7,3,2,12
Comal,401,Proposition #9,,DEM,Over Votes,0,0,0,0
Comal,401,Proposition #10,,DEM,Yes,121,39,83,243
Comal,401,Proposition #10,,DEM,No,4,3,3,10
Comal,401,Proposition #10,,DEM,Cast Votes:,125,42,86,253
Comal,401,Proposition #10,,DEM,Under Votes,11,3,3,17
Comal,401,Proposition #10,,DEM,Over Votes,0,0,0,0
Comal,401,Proposition #11,,DEM,Yes,114,37,82,233
Comal,401,Proposition #11,,DEM,No,10,3,3,16
Comal,401,Proposition #11,,DEM,Cast Votes:,124,40,85,249
Comal,401,Proposition #11,,DEM,Under Votes,12,5,4,21
Comal,401,Proposition #11,,DEM,Over Votes,0,0,0,0
Comal,402,President,,DEM,Tulsi Gabbard,0,0,1,1
Comal,402,President,,DEM,Marianne Williamson,0,0,1,1
Comal,402,President,,DEM,John K. Delaney,0,0,1,1
Comal,402,President,,DEM,Elizabeth Warren,18,10,43,71
Comal,402,President,,DEM,Cory Booker,1,0,2,3
Comal,402,President,,DEM,Amy Klobuchar,0,2,23,25
Comal,402,President,,DEM,Joseph R. Biden,111,7,53,171
Comal,402,President,,DEM,Pete Buttigieg,2,5,38,45
Comal,402,President,,DEM,Juli치n Castro,0,1,0,1
Comal,402,President,,DEM,Tom Steyer,0,0,4,4
Comal,402,President,,DEM,Michael Bennet,0,0,0,0
Comal,402,President,,DEM,Michael R. Bloomberg,24,10,32,66
Comal,402,President,,DEM,Robby Wells,0,0,0,0
Comal,402,President,,DEM,"Roque ""Rocky"" De La Fuente",0,0,0,0
Comal,402,President,,DEM,Deval Patrick,0,0,0,0
Comal,402,President,,DEM,Bernie Sanders,49,9,59,117
Comal,402,President,,DEM,Andrew Yang,0,0,2,2
Comal,402,Ballots Cast,,DEM,,205,44,259,508
Comal,402,President,,DEM,Under Votes,1,0,0,1
Comal,402,President,,DEM,Over Votes,0,0,0,0
Comal,402,U.S. Senate,,DEM,Royce West,10,0,10,20
Comal,402,U.S. Senate,,DEM,Chris Bell,27,4,24,55
Comal,402,U.S. Senate,,DEM,Amanda K. Edwards,35,6,22,63
Comal,402,U.S. Senate,,DEM,Sema Hernandez,16,1,14,31
Comal,402,U.S. Senate,,DEM,Jack Daniel Foster Jr,3,0,7,10
Comal,402,U.S. Senate,,DEM,D.R. Hunter,2,1,4,7
Comal,402,U.S. Senate,,DEM,Adrian Ocegueda,6,0,4,10
Comal,402,U.S. Senate,,DEM,"Mary ""MJ"" Hegar",57,25,114,196
Comal,402,U.S. Senate,,DEM,Cristina Tzintzun Ramirez,9,5,24,38
Comal,402,U.S. Senate,,DEM,Michael Cooper,4,0,3,7
Comal,402,U.S. Senate,,DEM,Victor Hugo Harris,1,0,0,1
Comal,402,U.S. Senate,,DEM,"Annie ""Mam치"" Garcia",10,0,4,14
Comal,402,U.S. Senate,,DEM,Cast Votes:,180,42,230,452
Comal,402,U.S. Senate,,DEM,Under Votes,26,2,29,57
Comal,402,U.S. Senate,,DEM,Over Votes,0,0,0,0
Comal,402,U.S. House,21,DEM,Wendy R. Davis,154,38,206,398
Comal,402,U.S. House,21,DEM,Jennie Lou Leeder,33,3,29,65
Comal,402,U.S. House,21,DEM,Cast Votes:,187,41,235,463
Comal,402,U.S. House,21,DEM,Under Votes,19,3,24,46
Comal,402,U.S. House,21,DEM,Over Votes,0,0,0,0
Comal,402,Railroad Commissioner,,DEM,Mark Watson,35,5,36,76
Comal,402,Railroad Commissioner,,DEM,Chrysta Casta침eda,60,18,87,165
Comal,402,Railroad Commissioner,,DEM,Kelly Stone,40,8,61,109
Comal,402,Railroad Commissioner,,DEM,"Roberto R. ""Beto"" Alonzo",34,4,36,74
Comal,402,Railroad Commissioner,,DEM,Cast Votes:,169,35,220,424
Comal,402,Railroad Commissioner,,DEM,Under Votes,37,9,39,85
Comal,402,Railroad Commissioner,,DEM,Over Votes,0,0,0,0
Comal,402,"Chief Justice, Supreme Court",,DEM,Amy Clark Meachum,143,30,198,371
Comal,402,"Chief Justice, Supreme Court",,DEM,Jerry Zimmerer,31,7,31,69
Comal,402,"Chief Justice, Supreme Court",,DEM,Cast Votes:,174,37,229,440
Comal,402,"Chief Justice, Supreme Court",,DEM,Under Votes,32,7,30,69
Comal,402,"Chief Justice, Supreme Court",,DEM,Over Votes,0,0,0,0
Comal,402,"Justice, Supreme Court, Place 6 Unexpired Term",,DEM,Larry Praeger,46,5,46,97
Comal,402,"Justice, Supreme Court, Place 6 Unexpired Term",,DEM,Kathy Cheng,127,29,172,328
Comal,402,"Justice, Supreme Court, Place 6 Unexpired Term",,DEM,Cast Votes:,173,34,218,425
Comal,402,"Justice, Supreme Court, Place 6 Unexpired Term",,DEM,Under Votes,33,10,41,84
Comal,402,"Justice, Supreme Court, Place 6 Unexpired Term",,DEM,Over Votes,0,0,0,0
Comal,402,"Justice, Supreme Court, Place 7",,DEM,Staci Williams,103,21,125,249
Comal,402,"Justice, Supreme Court, Place 7",,DEM,Brandy Voss,64,13,86,163
Comal,402,"Justice, Supreme Court, Place 7",,DEM,Cast Votes:,167,34,211,412
Comal,402,"Justice, Supreme Court, Place 7",,DEM,Under Votes,39,10,48,97
Comal,402,"Justice, Supreme Court, Place 7",,DEM,Over Votes,0,0,0,0
Comal,402,"Justice, Supreme Court, Place 8",,DEM,Peter Kelly,44,5,48,97
Comal,402,"Justice, Supreme Court, Place 8",,DEM,Gisela D. Triana,126,29,170,325
Comal,402,"Justice, Supreme Court, Place 8",,DEM,Cast Votes:,170,34,218,422
Comal,402,"Justice, Supreme Court, Place 8",,DEM,Under Votes,36,10,41,87
Comal,402,"Justice, Supreme Court, Place 8",,DEM,Over Votes,0,0,0,0
Comal,402,"Judge, Court of Criminal Appeals, Place 3",,DEM,Elizabeth Davis Frizell,134,22,170,326
Comal,402,"Judge, Court of Criminal Appeals, Place 3",,DEM,William Pieratt Demond,15,7,19,41
Comal,402,"Judge, Court of Criminal Appeals, Place 3",,DEM,Dan Wood,19,6,23,48
Comal,402,"Judge, Court of Criminal Appeals, Place 3",,DEM,Cast Votes:,168,35,212,415
Comal,402,"Judge, Court of Criminal Appeals, Place 3",,DEM,Under Votes,38,9,47,94
Comal,402,"Judge, Court of Criminal Appeals, Place 3",,DEM,Over Votes,0,0,0,0
Comal,402,"Judge, Court of Criminal Appeals, Place 4",,DEM,Tina Clinton,133,26,168,327
Comal,402,"Judge, Court of Criminal Appeals, Place 4",,DEM,Steven Miears,35,9,44,88
Comal,402,"Judge, Court of Criminal Appeals, Place 4",,DEM,Cast Votes:,168,35,212,415
Comal,402,"Judge, Court of Criminal Appeals, Place 4",,DEM,Under Votes,38,9,47,94
Comal,402,"Judge, Court of Criminal Appeals, Place 4",,DEM,Over Votes,0,0,0,0
Comal,402,"Judge, Court of Criminal Appeals, Place 9",,DEM,Brandon Birmingham,153,31,186,370
Comal,402,"Judge, Court of Criminal Appeals, Place 9",,DEM,Cast Votes:,153,31,186,370
Comal,402,"Judge, Court of Criminal Appeals, Place 9",,DEM,Under Votes,53,13,73,139
Comal,402,"Judge, Court of Criminal Appeals, Place 9",,DEM,Over Votes,0,0,0,0
Comal,402,"Member, State Board of Education, District 5",,DEM,Rebecca Bell-Metereau,116,20,144,280
Comal,402,"Member, State Board of Education, District 5",,DEM,Letti Bresnahan,53,16,70,139
Comal,402,"Member, State Board of Education, District 5",,DEM,Cast Votes:,169,36,214,419
Comal,402,"Member, State Board of Education, District 5",,DEM,Under Votes,37,8,45,90
Comal,402,"Member, State Board of Education, District 5",,DEM,Over Votes,0,0,0,0
Comal,402,State Representative,73,DEM,Stephanie Phillips,163,33,204,400
Comal,402,State Representative,73,DEM,Cast Votes:,163,33,204,400
Comal,402,State Representative,73,DEM,Under Votes,43,11,55,109
Comal,402,State Representative,73,DEM,Over Votes,0,0,0,0
Comal,402,"Chief Justice, 3rd Court of Appeals District",,DEM,Darlene Byrne,126,26,157,309
Comal,402,"Chief Justice, 3rd Court of Appeals District",,DEM,Keith S. Hampton,38,6,49,93
Comal,402,"Chief Justice, 3rd Court of Appeals District",,DEM,Cast Votes:,164,32,206,402
Comal,402,"Chief Justice, 3rd Court of Appeals District",,DEM,Under Votes,42,12,53,107
Comal,402,"Chief Justice, 3rd Court of Appeals District",,DEM,Over Votes,0,0,0,0
Comal,402,County Chairman,,DEM,Gloria Meehan,161,30,201,392
Comal,402,County Chairman,,DEM,Cast Votes:,161,30,201,392
Comal,402,County Chairman,,DEM,Under Votes,45,14,58,117
Comal,402,County Chairman,,DEM,Over Votes,0,0,0,0
Comal,402,Proposition #1,,DEM,Yes,180,42,238,460
Comal,402,Proposition #1,,DEM,No,18,2,9,29
Comal,402,Proposition #1,,DEM,Cast Votes:,198,44,247,489
Comal,402,Proposition #1,,DEM,Under Votes,8,0,12,20
Comal,402,Proposition #1,,DEM,Over Votes,0,0,0,0
Comal,402,Proposition #2,,DEM,Yes,185,44,239,468
Comal,402,Proposition #2,,DEM,No,14,0,10,24
Comal,402,Proposition #2,,DEM,Cast Votes:,199,44,249,492
Comal,402,Proposition #2,,DEM,Under Votes,7,0,10,17
Comal,402,Proposition #2,,DEM,Over Votes,0,0,0,0
Comal,402,Proposition #3,,DEM,Yes,188,44,247,479
Comal,402,Proposition #3,,DEM,No,7,0,4,11
Comal,402,Proposition #3,,DEM,Cast Votes:,195,44,251,490
Comal,402,Proposition #3,,DEM,Under Votes,11,0,8,19
Comal,402,Proposition #3,,DEM,Over Votes,0,0,0,0
Comal,402,Proposition #4,,DEM,Yes,183,41,232,456
Comal,402,Proposition #4,,DEM,No,15,2,16,33
Comal,402,Proposition #4,,DEM,Cast Votes:,198,43,248,489
Comal,402,Proposition #4,,DEM,Under Votes,8,1,11,20
Comal,402,Proposition #4,,DEM,Over Votes,0,0,0,0
Comal,402,Proposition #5,,DEM,Yes,192,43,247,482
Comal,402,Proposition #5,,DEM,No,6,1,4,11
Comal,402,Proposition #5,,DEM,Cast Votes:,198,44,251,493
Comal,402,Proposition #5,,DEM,Under Votes,8,0,8,16
Comal,402,Proposition #5,,DEM,Over Votes,0,0,0,0
Comal,402,Proposition #6,,DEM,Yes,185,44,241,470
Comal,402,Proposition #6,,DEM,No,12,0,4,16
Comal,402,Proposition #6,,DEM,Cast Votes:,197,44,245,486
Comal,402,Proposition #6,,DEM,Under Votes,9,0,14,23
Comal,402,Proposition #6,,DEM,Over Votes,0,0,0,0
Comal,402,Proposition #7,,DEM,Yes,185,42,233,460
Comal,402,Proposition #7,,DEM,No,11,0,9,20
Comal,402,Proposition #7,,DEM,Cast Votes:,196,42,242,480
Comal,402,Proposition #7,,DEM,Under Votes,10,2,17,29
Comal,402,Proposition #7,,DEM,Over Votes,0,0,0,0
Comal,402,Proposition #8,,DEM,Yes,190,42,239,471
Comal,402,Proposition #8,,DEM,No,10,1,9,20
Comal,402,Proposition #8,,DEM,Cast Votes:,200,43,248,491
Comal,402,Proposition #8,,DEM,Under Votes,6,1,11,18
Comal,402,Proposition #8,,DEM,Over Votes,0,0,0,0
Comal,402,Proposition #9,,DEM,Yes,189,43,243,475
Comal,402,Proposition #9,,DEM,No,10,0,5,15
Comal,402,Proposition #9,,DEM,Cast Votes:,199,43,248,490
Comal,402,Proposition #9,,DEM,Under Votes,7,1,11,19
Comal,402,Proposition #9,,DEM,Over Votes,0,0,0,0
Comal,402,Proposition #10,,DEM,Yes,189,41,241,471
Comal,402,Proposition #10,,DEM,No,11,1,9,21
Comal,402,Proposition #10,,DEM,Cast Votes:,200,42,250,492
Comal,402,Proposition #10,,DEM,Under Votes,6,2,9,17
Comal,402,Proposition #10,,DEM,Over Votes,0,0,0,0
Comal,402,Proposition #11,,DEM,Yes,182,35,233,450
Comal,402,Proposition #11,,DEM,No,14,6,16,36
Comal,402,Proposition #11,,DEM,Cast Votes:,196,41,249,486
Comal,402,Proposition #11,,DEM,Under Votes,10,3,10,23
Comal,402,Proposition #11,,DEM,Over Votes,0,0,0,0
Comal,403,President,,DEM,Tulsi Gabbard,2,0,6,8
Comal,403,President,,DEM,Marianne Williamson,0,0,1,1
Comal,403,President,,DEM,John K. Delaney,0,0,0,0
Comal,403,President,,DEM,Elizabeth Warren,33,3,42,78
Comal,403,President,,DEM,Cory Booker,0,0,0,0
Comal,403,President,,DEM,Amy Klobuchar,0,6,30,36
Comal,403,President,,DEM,Joseph R. Biden,138,18,60,216
Comal,403,President,,DEM,Pete Buttigieg,0,3,38,41
Comal,403,President,,DEM,Juli치n Castro,0,0,0,0
Comal,403,President,,DEM,Tom Steyer,0,1,2,3
Comal,403,President,,DEM,Michael Bennet,0,0,0,0
Comal,403,President,,DEM,Michael R. Bloomberg,30,17,31,78
Comal,403,President,,DEM,Robby Wells,0,0,0,0
Comal,403,President,,DEM,"Roque ""Rocky"" De La Fuente",0,1,0,1
Comal,403,President,,DEM,Deval Patrick,0,0,0,0
Comal,403,President,,DEM,Bernie Sanders,64,8,75,147
Comal,403,President,,DEM,Andrew Yang,0,0,1,1
Comal,403,Ballots Cast,,DEM,,267,57,286,610
Comal,403,President,,DEM,Under Votes,2,0,1,3
Comal,403,President,,DEM,Over Votes,0,0,0,0
Comal,403,U.S. Senate,,DEM,Royce West,14,6,22,42
Comal,403,U.S. Senate,,DEM,Chris Bell,27,8,28,63
Comal,403,U.S. Senate,,DEM,Amanda K. Edwards,26,1,26,53
Comal,403,U.S. Senate,,DEM,Sema Hernandez,19,4,15,38
Comal,403,U.S. Senate,,DEM,Jack Daniel Foster Jr,9,1,7,17
Comal,403,U.S. Senate,,DEM,D.R. Hunter,7,1,8,16
Comal,403,U.S. Senate,,DEM,Adrian Ocegueda,5,2,6,13
Comal,403,U.S. Senate,,DEM,"Mary ""MJ"" Hegar",78,19,107,204
Comal,403,U.S. Senate,,DEM,Cristina Tzintzun Ramirez,14,6,14,34
Comal,403,U.S. Senate,,DEM,Michael Cooper,0,0,5,5
Comal,403,U.S. Senate,,DEM,Victor Hugo Harris,3,1,2,6
Comal,403,U.S. Senate,,DEM,"Annie ""Mam치"" Garcia",17,4,13,34
Comal,403,U.S. Senate,,DEM,Cast Votes:,219,53,253,525
Comal,403,U.S. Senate,,DEM,Under Votes,50,4,34,88
Comal,403,U.S. Senate,,DEM,Over Votes,0,0,0,0
Comal,403,U.S. House,21,DEM,Wendy R. Davis,200,46,211,457
Comal,403,U.S. House,21,DEM,Jennie Lou Leeder,33,7,44,84
Comal,403,U.S. House,21,DEM,Cast Votes:,233,53,255,541
Comal,403,U.S. House,21,DEM,Under Votes,36,4,32,72
Comal,403,U.S. House,21,DEM,Over Votes,0,0,0,0
Comal,403,Railroad Commissioner,,DEM,Mark Watson,35,5,45,85
Comal,403,Railroad Commissioner,,DEM,Chrysta Casta침eda,81,27,87,195
Comal,403,Railroad Commissioner,,DEM,Kelly Stone,47,5,62,114
Comal,403,Railroad Commissioner,,DEM,"Roberto R. ""Beto"" Alonzo",41,9,46,96
Comal,403,Railroad Commissioner,,DEM,Cast Votes:,204,46,240,490
Comal,403,Railroad Commissioner,,DEM,Under Votes,65,11,47,123
Comal,403,Railroad Commissioner,,DEM,Over Votes,0,0,0,0
Comal,403,"Chief Justice, Supreme Court",,DEM,Amy Clark Meachum,179,42,209,430
Comal,403,"Chief Justice, Supreme Court",,DEM,Jerry Zimmerer,33,6,37,76
Comal,403,"Chief Justice, Supreme Court",,DEM,Cast Votes:,212,48,246,506
Comal,403,"Chief Justice, Supreme Court",,DEM,Under Votes,57,9,41,107
Comal,403,"Chief Justice, Supreme Court",,DEM,Over Votes,0,0,0,0
Comal,403,"Justice, Supreme Court, Place 6 Unexpired Term",,DEM,Larry Praeger,41,17,45,103
Comal,403,"Justice, Supreme Court, Place 6 Unexpired Term",,DEM,Kathy Cheng,161,31,198,390
Comal,403,"Justice, Supreme Court, Place 6 Unexpired Term",,DEM,Cast Votes:,202,48,243,493
Comal,403,"Justice, Supreme Court, Place 6 Unexpired Term",,DEM,Under Votes,67,9,44,120
Comal,403,"Justice, Supreme Court, Place 6 Unexpired Term",,DEM,Over Votes,0,0,0,0
Comal,403,"Justice, Supreme Court, Place 7",,DEM,Staci Williams,133,29,139,301
Comal,403,"Justice, Supreme Court, Place 7",,DEM,Brandy Voss,68,20,101,189
Comal,403,"Justice, Supreme Court, Place 7",,DEM,Cast Votes:,201,49,240,490
Comal,403,"Justice, Supreme Court, Place 7",,DEM,Under Votes,68,8,47,123
Comal,403,"Justice, Supreme Court, Place 7",,DEM,Over Votes,0,0,0,0
Comal,403,"Justice, Supreme Court, Place 8",,DEM,Peter Kelly,56,13,59,128
Comal,403,"Justice, Supreme Court, Place 8",,DEM,Gisela D. Triana,139,34,176,349
Comal,403,"Justice, Supreme Court, Place 8",,DEM,Cast Votes:,195,47,235,477
Comal,403,"Justice, Supreme Court, Place 8",,DEM,Under Votes,74,10,52,136
Comal,403,"Justice, Supreme Court, Place 8",,DEM,Over Votes,0,0,0,0
Comal,403,"Judge, Court of Criminal Appeals, Place 3",,DEM,Elizabeth Davis Frizell,152,36,177,365
Comal,403,"Judge, Court of Criminal Appeals, Place 3",,DEM,William Pieratt Demond,8,4,21,33
Comal,403,"Judge, Court of Criminal Appeals, Place 3",,DEM,Dan Wood,33,6,39,78
Comal,403,"Judge, Court of Criminal Appeals, Place 3",,DEM,Cast Votes:,193,46,237,476
Comal,403,"Judge, Court of Criminal Appeals, Place 3",,DEM,Under Votes,76,11,50,137
Comal,403,"Judge, Court of Criminal Appeals, Place 3",,DEM,Over Votes,0,0,0,0
Comal,403,"Judge, Court of Criminal Appeals, Place 4",,DEM,Tina Clinton,170,29,197,396
Comal,403,"Judge, Court of Criminal Appeals, Place 4",,DEM,Steven Miears,29,18,39,86
Comal,403,"Judge, Court of Criminal Appeals, Place 4",,DEM,Cast Votes:,199,47,236,482
Comal,403,"Judge, Court of Criminal Appeals, Place 4",,DEM,Under Votes,70,10,51,131
Comal,403,"Judge, Court of Criminal Appeals, Place 4",,DEM,Over Votes,0,0,0,0
Comal,403,"Judge, Court of Criminal Appeals, Place 9",,DEM,Brandon Birmingham,167,42,215,424
Comal,403,"Judge, Court of Criminal Appeals, Place 9",,DEM,Cast Votes:,167,42,215,424
Comal,403,"Judge, Court of Criminal Appeals, Place 9",,DEM,Under Votes,102,15,72,189
Comal,403,"Judge, Court of Criminal Appeals, Place 9",,DEM,Over Votes,0,0,0,0
Comal,403,"Member, State Board of Education, District 5",,DEM,Rebecca Bell-Metereau,126,29,156,311
Comal,403,"Member, State Board of Education, District 5",,DEM,Letti Bresnahan,68,18,86,172
Comal,403,"Member, State Board of Education, District 5",,DEM,Cast Votes:,194,47,242,483
Comal,403,"Member, State Board of Education, District 5",,DEM,Under Votes,75,10,45,130
Comal,403,"Member, State Board of Education, District 5",,DEM,Over Votes,0,0,0,0
Comal,403,State Representative,73,DEM,Stephanie Phillips,182,43,226,451
Comal,403,State Representative,73,DEM,Cast Votes:,182,43,226,451
Comal,403,State Representative,73,DEM,Under Votes,87,14,61,162
Comal,403,State Representative,73,DEM,Over Votes,0,0,0,0
Comal,403,"Chief Justice, 3rd Court of Appeals District",,DEM,Darlene Byrne,157,35,186,378
Comal,403,"Chief Justice, 3rd Court of Appeals District",,DEM,Keith S. Hampton,35,11,49,95
Comal,403,"Chief Justice, 3rd Court of Appeals District",,DEM,Cast Votes:,192,46,235,473
Comal,403,"Chief Justice, 3rd Court of Appeals District",,DEM,Under Votes,77,11,52,140
Comal,403,"Chief Justice, 3rd Court of Appeals District",,DEM,Over Votes,0,0,0,0
Comal,403,County Chairman,,DEM,Gloria Meehan,188,45,229,462
Comal,403,County Chairman,,DEM,Cast Votes:,188,45,229,462
Comal,403,County Chairman,,DEM,Under Votes,81,12,58,151
Comal,403,County Chairman,,DEM,Over Votes,0,0,0,0
Comal,403,Proposition #1,,DEM,Yes,240,50,245,535
Comal,403,Proposition #1,,DEM,No,19,2,26,47
Comal,403,Proposition #1,,DEM,Cast Votes:,259,52,271,582
Comal,403,Proposition #1,,DEM,Under Votes,10,5,16,31
Comal,403,Proposition #1,,DEM,Over Votes,0,0,0,0
Comal,403,Proposition #2,,DEM,Yes,229,50,239,518
Comal,403,Proposition #2,,DEM,No,29,1,31,61
Comal,403,Proposition #2,,DEM,Cast Votes:,258,51,270,579
Comal,403,Proposition #2,,DEM,Under Votes,11,6,17,34
Comal,403,Proposition #2,,DEM,Over Votes,0,0,0,0
Comal,403,Proposition #3,,DEM,Yes,251,52,260,563
Comal,403,Proposition #3,,DEM,No,9,1,14,24
Comal,403,Proposition #3,,DEM,Cast Votes:,260,53,274,587
Comal,403,Proposition #3,,DEM,Under Votes,9,4,13,26
Comal,403,Proposition #3,,DEM,Over Votes,0,0,0,0
Comal,403,Proposition #4,,DEM,Yes,232,50,246,528
Comal,403,Proposition #4,,DEM,No,23,2,27,52
Comal,403,Proposition #4,,DEM,Cast Votes:,255,52,273,580
Comal,403,Proposition #4,,DEM,Under Votes,14,5,14,33
Comal,403,Proposition #4,,DEM,Over Votes,0,0,0,0
Comal,403,Proposition #5,,DEM,Yes,252,53,261,566
Comal,403,Proposition #5,,DEM,No,9,1,10,20
Comal,403,Proposition #5,,DEM,Cast Votes:,261,54,271,586
Comal,403,Proposition #5,,DEM,Under Votes,8,3,16,27
Comal,403,Proposition #5,,DEM,Over Votes,0,0,0,0
Comal,403,Proposition #6,,DEM,Yes,244,51,263,558
Comal,403,Proposition #6,,DEM,No,12,1,9,22
Comal,403,Proposition #6,,DEM,Cast Votes:,256,52,272,580
Comal,403,Proposition #6,,DEM,Under Votes,13,5,15,33
Comal,403,Proposition #6,,DEM,Over Votes,0,0,0,0
Comal,403,Proposition #7,,DEM,Yes,232,50,249,531
Comal,403,Proposition #7,,DEM,No,19,1,19,39
Comal,403,Proposition #7,,DEM,Cast Votes:,251,51,268,570
Comal,403,Proposition #7,,DEM,Under Votes,18,6,19,43
Comal,403,Proposition #7,,DEM,Over Votes,0,0,0,0
Comal,403,Proposition #8,,DEM,Yes,248,51,253,552
Comal,403,Proposition #8,,DEM,No,12,2,18,32
Comal,403,Proposition #8,,DEM,Cast Votes:,260,53,271,584
Comal,403,Proposition #8,,DEM,Under Votes,9,4,16,29
Comal,403,Proposition #8,,DEM,Over Votes,0,0,0,0
Comal,403,Proposition #9,,DEM,Yes,249,53,259,561
Comal,403,Proposition #9,,DEM,No,7,1,7,15
Comal,403,Proposition #9,,DEM,Cast Votes:,256,54,266,576
Comal,403,Proposition #9,,DEM,Under Votes,13,3,21,37
Comal,403,Proposition #9,,DEM,Over Votes,0,0,0,0
Comal,403,Proposition #10,,DEM,Yes,243,53,249,545
Comal,403,Proposition #10,,DEM,No,15,1,20,36
Comal,403,Proposition #10,,DEM,Cast Votes:,258,54,269,581
Comal,403,Proposition #10,,DEM,Under Votes,11,3,18,32
Comal,403,Proposition #10,,DEM,Over Votes,0,0,0,0
Comal,403,Proposition #11,,DEM,Yes,226,45,238,509
Comal,403,Proposition #11,,DEM,No,22,7,29,58
Comal,403,Proposition #11,,DEM,Cast Votes:,248,52,267,567
Comal,403,Proposition #11,,DEM,Under Votes,21,5,20,46
Comal,403,Proposition #11,,DEM,Over Votes,0,0,0,0
Comal,404,President,,DEM,Tulsi Gabbard,0,0,2,2
Comal,404,President,,DEM,Marianne Williamson,0,0,0,0
Comal,404,President,,DEM,John K. Delaney,0,0,0,0
Comal,404,President,,DEM,Elizabeth Warren,8,3,16,27
Comal,404,President,,DEM,Cory Booker,0,0,1,1
Comal,404,President,,DEM,Amy Klobuchar,0,3,11,14
Comal,404,President,,DEM,Joseph R. Biden,61,6,20,87
Comal,404,President,,DEM,Pete Buttigieg,0,1,21,22
Comal,404,President,,DEM,Juli치n Castro,0,0,0,0
Comal,404,President,,DEM,Tom Steyer,0,0,2,2
Comal,404,President,,DEM,Michael Bennet,0,0,0,0
Comal,404,President,,DEM,Michael R. Bloomberg,15,3,29,47
Comal,404,President,,DEM,Robby Wells,0,0,0,0
Comal,404,President,,DEM,"Roque ""Rocky"" De La Fuente",1,0,0,1
Comal,404,President,,DEM,Deval Patrick,0,0,0,0
Comal,404,President,,DEM,Bernie Sanders,45,4,24,73
Comal,404,President,,DEM,Andrew Yang,1,0,0,1
Comal,404,Ballots Cast,,DEM,,131,20,126,277
Comal,404,President,,DEM,Under Votes,0,0,0,0
Comal,404,President,,DEM,Over Votes,0,0,0,0
Comal,404,U.S. Senate,,DEM,Royce West,4,1,6,11
Comal,404,U.S. Senate,,DEM,Chris Bell,6,3,11,20
Comal,404,U.S. Senate,,DEM,Amanda K. Edwards,14,2,15,31
Comal,404,U.S. Senate,,DEM,Sema Hernandez,15,3,17,35
Comal,404,U.S. Senate,,DEM,Jack Daniel Foster Jr,4,0,2,6
Comal,404,U.S. Senate,,DEM,D.R. Hunter,3,0,2,5
Comal,404,U.S. Senate,,DEM,Adrian Ocegueda,1,0,3,4
Comal,404,U.S. Senate,,DEM,"Mary ""MJ"" Hegar",34,5,36,75
Comal,404,U.S. Senate,,DEM,Cristina Tzintzun Ramirez,6,5,9,20
Comal,404,U.S. Senate,,DEM,Michael Cooper,0,0,3,3
Comal,404,U.S. Senate,,DEM,Victor Hugo Harris,3,0,1,4
Comal,404,U.S. Senate,,DEM,"Annie ""Mam치"" Garcia",18,0,3,21
Comal,404,U.S. Senate,,DEM,Cast Votes:,108,19,108,235
Comal,404,U.S. Senate,,DEM,Under Votes,23,1,18,42
Comal,404,U.S. Senate,,DEM,Over Votes,0,0,0,0
Comal,404,U.S. House,21,DEM,Wendy R. Davis,89,17,94,200
Comal,404,U.S. House,21,DEM,Jennie Lou Leeder,22,3,18,43
Comal,404,U.S. House,21,DEM,Cast Votes:,111,20,112,243
Comal,404,U.S. House,21,DEM,Under Votes,20,0,14,34
Comal,404,U.S. House,21,DEM,Over Votes,0,0,0,0
Comal,404,Railroad Commissioner,,DEM,Mark Watson,16,1,20,37
Comal,404,Railroad Commissioner,,DEM,Chrysta Casta침eda,26,8,47,81
Comal,404,Railroad Commissioner,,DEM,Kelly Stone,24,5,17,46
Comal,404,Railroad Commissioner,,DEM,"Roberto R. ""Beto"" Alonzo",34,3,18,55
Comal,404,Railroad Commissioner,,DEM,Cast Votes:,100,17,102,219
Comal,404,Railroad Commissioner,,DEM,Under Votes,31,3,24,58
Comal,404,Railroad Commissioner,,DEM,Over Votes,0,0,0,0
Comal,404,"Chief Justice, Supreme Court",,DEM,Amy Clark Meachum,90,15,91,196
Comal,404,"Chief Justice, Supreme Court",,DEM,Jerry Zimmerer,10,2,14,26
Comal,404,"Chief Justice, Supreme Court",,DEM,Cast Votes:,100,17,105,222
Comal,404,"Chief Justice, Supreme Court",,DEM,Under Votes,31,3,21,55
Comal,404,"Chief Justice, Supreme Court",,DEM,Over Votes,0,0,0,0
Comal,404,"Justice, Supreme Court, Place 6 Unexpired Term",,DEM,Larry Praeger,22,2,25,49
Comal,404,"Justice, Supreme Court, Place 6 Unexpired Term",,DEM,Kathy Cheng,76,15,76,167
Comal,404,"Justice, Supreme Court, Place 6 Unexpired Term",,DEM,Cast Votes:,98,17,101,216
Comal,404,"Justice, Supreme Court, Place 6 Unexpired Term",,DEM,Under Votes,33,3,25,61
Comal,404,"Justice, Supreme Court, Place 6 Unexpired Term",,DEM,Over Votes,0,0,0,0
Comal,404,"Justice, Supreme Court, Place 7",,DEM,Staci Williams,66,9,62,137
Comal,404,"Justice, Supreme Court, Place 7",,DEM,Brandy Voss,24,8,39,71
Comal,404,"Justice, Supreme Court, Place 7",,DEM,Cast Votes:,90,17,101,208
Comal,404,"Justice, Supreme Court, Place 7",,DEM,Under Votes,41,3,25,69
Comal,404,"Justice, Supreme Court, Place 7",,DEM,Over Votes,0,0,0,0
Comal,404,"Justice, Supreme Court, Place 8",,DEM,Peter Kelly,25,1,27,53
Comal,404,"Justice, Supreme Court, Place 8",,DEM,Gisela D. Triana,65,16,74,155
Comal,404,"Justice, Supreme Court, Place 8",,DEM,Cast Votes:,90,17,101,208
Comal,404,"Justice, Supreme Court, Place 8",,DEM,Under Votes,41,3,25,69
Comal,404,"Justice, Supreme Court, Place 8",,DEM,Over Votes,0,0,0,0
Comal,404,"Judge, Court of Criminal Appeals, Place 3",,DEM,Elizabeth Davis Frizell,71,10,76,157
Comal,404,"Judge, Court of Criminal Appeals, Place 3",,DEM,William Pieratt Demond,7,4,9,20
Comal,404,"Judge, Court of Criminal Appeals, Place 3",,DEM,Dan Wood,12,1,15,28
Comal,404,"Judge, Court of Criminal Appeals, Place 3",,DEM,Cast Votes:,90,15,100,205
Comal,404,"Judge, Court of Criminal Appeals, Place 3",,DEM,Under Votes,41,5,26,72
Comal,404,"Judge, Court of Criminal Appeals, Place 3",,DEM,Over Votes,0,0,0,0
Comal,404,"Judge, Court of Criminal Appeals, Place 4",,DEM,Tina Clinton,71,13,92,176
Comal,404,"Judge, Court of Criminal Appeals, Place 4",,DEM,Steven Miears,16,4,10,30
Comal,404,"Judge, Court of Criminal Appeals, Place 4",,DEM,Cast Votes:,87,17,102,206
Comal,404,"Judge, Court of Criminal Appeals, Place 4",,DEM,Under Votes,44,3,24,71
Comal,404,"Judge, Court of Criminal Appeals, Place 4",,DEM,Over Votes,0,0,0,0
Comal,404,"Judge, Court of Criminal Appeals, Place 9",,DEM,Brandon Birmingham,76,8,99,183
Comal,404,"Judge, Court of Criminal Appeals, Place 9",,DEM,Cast Votes:,76,8,99,183
Comal,404,"Judge, Court of Criminal Appeals, Place 9",,DEM,Under Votes,55,12,27,94
Comal,404,"Judge, Court of Criminal Appeals, Place 9",,DEM,Over Votes,0,0,0,0
Comal,404,"Member, State Board of Education, District 5",,DEM,Rebecca Bell-Metereau,63,10,74,147
Comal,404,"Member, State Board of Education, District 5",,DEM,Letti Bresnahan,27,7,30,64
Comal,404,"Member, State Board of Education, District 5",,DEM,Cast Votes:,90,17,104,211
Comal,404,"Member, State Board of Education, District 5",,DEM,Under Votes,41,3,22,66
Comal,404,"Member, State Board of Education, District 5",,DEM,Over Votes,0,0,0,0
Comal,404,State Representative,73,DEM,Stephanie Phillips,86,12,104,202
Comal,404,State Representative,73,DEM,Cast Votes:,86,12,104,202
Comal,404,State Representative,73,DEM,Under Votes,45,8,22,75
Comal,404,State Representative,73,DEM,Over Votes,0,0,0,0
Comal,404,"Chief Justice, 3rd Court of Appeals District",,DEM,Darlene Byrne,68,15,77,160
Comal,404,"Chief Justice, 3rd Court of Appeals District",,DEM,Keith S. Hampton,18,1,21,40
Comal,404,"Chief Justice, 3rd Court of Appeals District",,DEM,Cast Votes:,86,16,98,200
Comal,404,"Chief Justice, 3rd Court of Appeals District",,DEM,Under Votes,45,4,28,77
Comal,404,"Chief Justice, 3rd Court of Appeals District",,DEM,Over Votes,0,0,0,0
Comal,404,County Chairman,,DEM,Gloria Meehan,87,12,99,198
Comal,404,County Chairman,,DEM,Cast Votes:,87,12,99,198
Comal,404,County Chairman,,DEM,Under Votes,44,8,27,79
Comal,404,County Chairman,,DEM,Over Votes,0,0,0,0
Comal,404,Proposition #1,,DEM,Yes,111,19,112,242
Comal,404,Proposition #1,,DEM,No,14,0,12,26
Comal,404,Proposition #1,,DEM,Cast Votes:,125,19,124,268
Comal,404,Proposition #1,,DEM,Under Votes,6,1,2,9
Comal,404,Proposition #1,,DEM,Over Votes,0,0,0,0
Comal,404,Proposition #2,,DEM,Yes,116,19,111,246
Comal,404,Proposition #2,,DEM,No,11,0,12,23
Comal,404,Proposition #2,,DEM,Cast Votes:,127,19,123,269
Comal,404,Proposition #2,,DEM,Under Votes,4,1,3,8
Comal,404,Proposition #2,,DEM,Over Votes,0,0,0,0
Comal,404,Proposition #3,,DEM,Yes,119,20,121,260
Comal,404,Proposition #3,,DEM,No,5,0,4,9
Comal,404,Proposition #3,,DEM,Cast Votes:,124,20,125,269
Comal,404,Proposition #3,,DEM,Under Votes,7,0,1,8
Comal,404,Proposition #3,,DEM,Over Votes,0,0,0,0
Comal,404,Proposition #4,,DEM,Yes,111,19,115,245
Comal,404,Proposition #4,,DEM,No,12,0,8,20
Comal,404,Proposition #4,,DEM,Cast Votes:,123,19,123,265
Comal,404,Proposition #4,,DEM,Under Votes,8,1,3,12
Comal,404,Proposition #4,,DEM,Over Votes,0,0,0,0
Comal,404,Proposition #5,,DEM,Yes,117,19,120,256
Comal,404,Proposition #5,,DEM,No,5,0,3,8
Comal,404,Proposition #5,,DEM,Cast Votes:,122,19,123,264
Comal,404,Proposition #5,,DEM,Under Votes,9,1,3,13
Comal,404,Proposition #5,,DEM,Over Votes,0,0,0,0
Comal,404,Proposition #6,,DEM,Yes,123,19,116,258
Comal,404,Proposition #6,,DEM,No,4,0,4,8
Comal,404,Proposition #6,,DEM,Cast Votes:,127,19,120,266
Comal,404,Proposition #6,,DEM,Under Votes,4,1,6,11
Comal,404,Proposition #6,,DEM,Over Votes,0,0,0,0
Comal,404,Proposition #7,,DEM,Yes,117,18,116,251
Comal,404,Proposition #7,,DEM,No,9,0,7,16
Comal,404,Proposition #7,,DEM,Cast Votes:,126,18,123,267
Comal,404,Proposition #7,,DEM,Under Votes,5,2,3,10
Comal,404,Proposition #7,,DEM,Over Votes,0,0,0,0
Comal,404,Proposition #8,,DEM,Yes,115,19,120,254
Comal,404,Proposition #8,,DEM,No,9,0,4,13
Comal,404,Proposition #8,,DEM,Cast Votes:,124,19,124,267
Comal,404,Proposition #8,,DEM,Under Votes,7,1,2,10
Comal,404,Proposition #8,,DEM,Over Votes,0,0,0,0
Comal,404,Proposition #9,,DEM,Yes,120,19,119,258
Comal,404,Proposition #9,,DEM,No,5,0,4,9
Comal,404,Proposition #9,,DEM,Cast Votes:,125,19,123,267
Comal,404,Proposition #9,,DEM,Under Votes,6,1,3,10
Comal,404,Proposition #9,,DEM,Over Votes,0,0,0,0
Comal,404,Proposition #10,,DEM,Yes,113,20,119,252
Comal,404,Proposition #10,,DEM,No,10,0,6,16
Comal,404,Proposition #10,,DEM,Cast Votes:,123,20,125,268
Comal,404,Proposition #10,,DEM,Under Votes,8,0,1,9
Comal,404,Proposition #10,,DEM,Over Votes,0,0,0,0
Comal,404,Proposition #11,,DEM,Yes,107,19,111,237
Comal,404,Proposition #11,,DEM,No,11,0,11,22
Comal,404,Proposition #11,,DEM,Cast Votes:,118,19,122,259
Comal,404,Proposition #11,,DEM,Under Votes,13,1,4,18
Comal,404,Proposition #11,,DEM,Over Votes,0,0,0,0
Comal,405,President,,DEM,Tulsi Gabbard,0,0,0,0
Comal,405,President,,DEM,Marianne Williamson,0,0,0,0
Comal,405,President,,DEM,John K. Delaney,0,0,0,0
Comal,405,President,,DEM,Elizabeth Warren,15,3,22,40
Comal,405,President,,DEM,Cory Booker,0,0,0,0
Comal,405,President,,DEM,Amy Klobuchar,0,4,9,13
Comal,405,President,,DEM,Joseph R. Biden,66,14,29,109
Comal,405,President,,DEM,Pete Buttigieg,2,3,22,27
Comal,405,President,,DEM,Juli치n Castro,0,0,0,0
Comal,405,President,,DEM,Tom Steyer,0,0,1,1
Comal,405,President,,DEM,Michael Bennet,0,0,0,0
Comal,405,President,,DEM,Michael R. Bloomberg,25,10,21,56
Comal,405,President,,DEM,Robby Wells,0,0,0,0
Comal,405,President,,DEM,"Roque ""Rocky"" De La Fuente",0,0,0,0
Comal,405,President,,DEM,Deval Patrick,0,0,0,0
Comal,405,President,,DEM,Bernie Sanders,38,5,44,87
Comal,405,President,,DEM,Andrew Yang,0,0,0,0
Comal,405,Ballots Cast,,DEM,,146,39,148,333
Comal,405,President,,DEM,Under Votes,0,0,1,1
Comal,405,President,,DEM,Over Votes,0,0,0,0
Comal,405,U.S. Senate,,DEM,Royce West,7,1,12,20
Comal,405,U.S. Senate,,DEM,Chris Bell,8,5,9,22
Comal,405,U.S. Senate,,DEM,Amanda K. Edwards,19,7,24,50
Comal,405,U.S. Senate,,DEM,Sema Hernandez,10,3,18,31
Comal,405,U.S. Senate,,DEM,Jack Daniel Foster Jr,7,0,5,12
Comal,405,U.S. Senate,,DEM,D.R. Hunter,6,0,4,10
Comal,405,U.S. Senate,,DEM,Adrian Ocegueda,0,2,1,3
Comal,405,U.S. Senate,,DEM,"Mary ""MJ"" Hegar",42,9,38,89
Comal,405,U.S. Senate,,DEM,Cristina Tzintzun Ramirez,12,7,13,32
Comal,405,U.S. Senate,,DEM,Michael Cooper,3,2,1,6
Comal,405,U.S. Senate,,DEM,Victor Hugo Harris,3,1,2,6
Comal,405,U.S. Senate,,DEM,"Annie ""Mam치"" Garcia",10,0,9,19
Comal,405,U.S. Senate,,DEM,Cast Votes:,127,37,136,300
Comal,405,U.S. Senate,,DEM,Under Votes,19,2,13,34
Comal,405,U.S. Senate,,DEM,Over Votes,0,0,0,0
Comal,405,U.S. House,21,DEM,Wendy R. Davis,108,31,115,254
Comal,405,U.S. House,21,DEM,Jennie Lou Leeder,21,3,18,42
Comal,405,U.S. House,21,DEM,Cast Votes:,129,34,133,296
Comal,405,U.S. House,21,DEM,Under Votes,17,5,16,38
Comal,405,U.S. House,21,DEM,Over Votes,0,0,0,0
Comal,405,Railroad Commissioner,,DEM,Mark Watson,22,5,19,46
Comal,405,Railroad Commissioner,,DEM,Chrysta Casta침eda,34,18,70,122
Comal,405,Railroad Commissioner,,DEM,Kelly Stone,30,6,17,53
Comal,405,Railroad Commissioner,,DEM,"Roberto R. ""Beto"" Alonzo",37,7,23,67
Comal,405,Railroad Commissioner,,DEM,Cast Votes:,123,36,129,288
Comal,405,Railroad Commissioner,,DEM,Under Votes,23,3,20,46
Comal,405,Railroad Commissioner,,DEM,Over Votes,0,0,0,0
Comal,405,"Chief Justice, Supreme Court",,DEM,Amy Clark Meachum,100,32,117,249
Comal,405,"Chief Justice, Supreme Court",,DEM,Jerry Zimmerer,24,3,15,42
Comal,405,"Chief Justice, Supreme Court",,DEM,Cast Votes:,124,35,132,291
Comal,405,"Chief Justice, Supreme Court",,DEM,Under Votes,22,4,17,43
Comal,405,"Chief Justice, Supreme Court",,DEM,Over Votes,0,0,0,0
Comal,405,"Justice, Supreme Court, Place 6 Unexpired Term",,DEM,Larry Praeger,34,13,32,79
Comal,405,"Justice, Supreme Court, Place 6 Unexpired Term",,DEM,Kathy Cheng,81,23,98,202
Comal,405,"Justice, Supreme Court, Place 6 Unexpired Term",,DEM,Cast Votes:,115,36,130,281
Comal,405,"Justice, Supreme Court, Place 6 Unexpired Term",,DEM,Under Votes,31,3,19,53
Comal,405,"Justice, Supreme Court, Place 6 Unexpired Term",,DEM,Over Votes,0,0,0,0
Comal,405,"Justice, Supreme Court, Place 7",,DEM,Staci Williams,74,20,75,169
Comal,405,"Justice, Supreme Court, Place 7",,DEM,Brandy Voss,49,14,52,115
Comal,405,"Justice, Supreme Court, Place 7",,DEM,Cast Votes:,123,34,127,284
Comal,405,"Justice, Supreme Court, Place 7",,DEM,Under Votes,23,5,22,50
Comal,405,"Justice, Supreme Court, Place 7",,DEM,Over Votes,0,0,0,0
Comal,405,"Justice, Supreme Court, Place 8",,DEM,Peter Kelly,43,9,31,83
Comal,405,"Justice, Supreme Court, Place 8",,DEM,Gisela D. Triana,77,27,96,200
Comal,405,"Justice, Supreme Court, Place 8",,DEM,Cast Votes:,120,36,127,283
Comal,405,"Justice, Supreme Court, Place 8",,DEM,Under Votes,26,3,22,51
Comal,405,"Justice, Supreme Court, Place 8",,DEM,Over Votes,0,0,0,0
Comal,405,"Judge, Court of Criminal Appeals, Place 3",,DEM,Elizabeth Davis Frizell,86,29,104,219
Comal,405,"Judge, Court of Criminal Appeals, Place 3",,DEM,William Pieratt Demond,11,3,11,25
Comal,405,"Judge, Court of Criminal Appeals, Place 3",,DEM,Dan Wood,23,3,14,40
Comal,405,"Judge, Court of Criminal Appeals, Place 3",,DEM,Cast Votes:,120,35,129,284
Comal,405,"Judge, Court of Criminal Appeals, Place 3",,DEM,Under Votes,26,4,20,50
Comal,405,"Judge, Court of Criminal Appeals, Place 3",,DEM,Over Votes,0,0,0,0
Comal,405,"Judge, Court of Criminal Appeals, Place 4",,DEM,Tina Clinton,96,31,108,235
Comal,405,"Judge, Court of Criminal Appeals, Place 4",,DEM,Steven Miears,22,4,20,46
Comal,405,"Judge, Court of Criminal Appeals, Place 4",,DEM,Cast Votes:,118,35,128,281
Comal,405,"Judge, Court of Criminal Appeals, Place 4",,DEM,Under Votes,28,4,21,53
Comal,405,"Judge, Court of Criminal Appeals, Place 4",,DEM,Over Votes,0,0,0,0
Comal,405,"Judge, Court of Criminal Appeals, Place 9",,DEM,Brandon Birmingham,109,33,118,260
Comal,405,"Judge, Court of Criminal Appeals, Place 9",,DEM,Cast Votes:,109,33,118,260
Comal,405,"Judge, Court of Criminal Appeals, Place 9",,DEM,Under Votes,37,6,31,74
Comal,405,"Judge, Court of Criminal Appeals, Place 9",,DEM,Over Votes,0,0,0,0
Comal,405,"Member, State Board of Education, District 5",,DEM,Rebecca Bell-Metereau,70,19,73,162
Comal,405,"Member, State Board of Education, District 5",,DEM,Letti Bresnahan,47,14,53,114
Comal,405,"Member, State Board of Education, District 5",,DEM,Cast Votes:,117,33,126,276
Comal,405,"Member, State Board of Education, District 5",,DEM,Under Votes,29,6,23,58
Comal,405,"Member, State Board of Education, District 5",,DEM,Over Votes,0,0,0,0
Comal,405,State Representative,73,DEM,Stephanie Phillips,116,33,126,275
Comal,405,State Representative,73,DEM,Cast Votes:,116,33,126,275
Comal,405,State Representative,73,DEM,Under Votes,30,6,23,59
Comal,405,State Representative,73,DEM,Over Votes,0,0,0,0
Comal,405,"Chief Justice, 3rd Court of Appeals District",,DEM,Darlene Byrne,90,29,111,230
Comal,405,"Chief Justice, 3rd Court of Appeals District",,DEM,Keith S. Hampton,31,7,16,54
Comal,405,"Chief Justice, 3rd Court of Appeals District",,DEM,Cast Votes:,121,36,127,284
Comal,405,"Chief Justice, 3rd Court of Appeals District",,DEM,Under Votes,25,3,22,50
Comal,405,"Chief Justice, 3rd Court of Appeals District",,DEM,Over Votes,0,0,0,0
Comal,405,County Chairman,,DEM,Gloria Meehan,113,33,132,278
Comal,405,County Chairman,,DEM,Cast Votes:,113,33,132,278
Comal,405,County Chairman,,DEM,Under Votes,33,6,17,56
Comal,405,County Chairman,,DEM,Over Votes,0,0,0,0
Comal,405,Proposition #1,,DEM,Yes,132,37,136,305
Comal,405,Proposition #1,,DEM,No,8,2,8,18
Comal,405,Proposition #1,,DEM,Cast Votes:,140,39,144,323
Comal,405,Proposition #1,,DEM,Under Votes,6,0,5,11
Comal,405,Proposition #1,,DEM,Over Votes,0,0,0,0
Comal,405,Proposition #2,,DEM,Yes,137,36,135,308
Comal,405,Proposition #2,,DEM,No,6,2,8,16
Comal,405,Proposition #2,,DEM,Cast Votes:,143,38,143,324
Comal,405,Proposition #2,,DEM,Under Votes,3,1,6,10
Comal,405,Proposition #2,,DEM,Over Votes,0,0,0,0
Comal,405,Proposition #3,,DEM,Yes,141,39,141,321
Comal,405,Proposition #3,,DEM,No,1,0,3,4
Comal,405,Proposition #3,,DEM,Cast Votes:,142,39,144,325
Comal,405,Proposition #3,,DEM,Under Votes,4,0,5,9
Comal,405,Proposition #3,,DEM,Over Votes,0,0,0,0
Comal,405,Proposition #4,,DEM,Yes,133,35,137,305
Comal,405,Proposition #4,,DEM,No,9,2,5,16
Comal,405,Proposition #4,,DEM,Cast Votes:,142,37,142,321
Comal,405,Proposition #4,,DEM,Under Votes,4,2,7,13
Comal,405,Proposition #4,,DEM,Over Votes,0,0,0,0
Comal,405,Proposition #5,,DEM,Yes,136,37,143,316
Comal,405,Proposition #5,,DEM,No,6,1,1,8
Comal,405,Proposition #5,,DEM,Cast Votes:,142,38,144,324
Comal,405,Proposition #5,,DEM,Under Votes,4,1,5,10
Comal,405,Proposition #5,,DEM,Over Votes,0,0,0,0
Comal,405,Proposition #6,,DEM,Yes,135,39,142,316
Comal,405,Proposition #6,,DEM,No,3,0,2,5
Comal,405,Proposition #6,,DEM,Cast Votes:,138,39,144,321
Comal,405,Proposition #6,,DEM,Under Votes,8,0,5,13
Comal,405,Proposition #6,,DEM,Over Votes,0,0,0,0
Comal,405,Proposition #7,,DEM,Yes,132,38,140,310
Comal,405,Proposition #7,,DEM,No,10,1,3,14
Comal,405,Proposition #7,,DEM,Cast Votes:,142,39,143,324
Comal,405,Proposition #7,,DEM,Under Votes,4,0,6,10
Comal,405,Proposition #7,,DEM,Over Votes,0,0,0,0
Comal,405,Proposition #8,,DEM,Yes,137,38,137,312
Comal,405,Proposition #8,,DEM,No,3,0,2,5
Comal,405,Proposition #8,,DEM,Cast Votes:,140,38,139,317
Comal,405,Proposition #8,,DEM,Under Votes,6,0,10,16
Comal,405,Proposition #8,,DEM,Over Votes,0,0,0,0
Comal,405,Proposition #9,,DEM,Yes,136,38,137,311
Comal,405,Proposition #9,,DEM,No,5,0,5,10
Comal,405,Proposition #9,,DEM,Cast Votes:,141,38,142,321
Comal,405,Proposition #9,,DEM,Under Votes,5,0,7,12
Comal,405,Proposition #9,,DEM,Over Votes,0,0,0,0
Comal,405,Proposition #10,,DEM,Yes,134,38,137,309
Comal,405,Proposition #10,,DEM,No,8,0,4,12
Comal,405,Proposition #10,,DEM,Cast Votes:,142,38,141,321
Comal,405,Proposition #10,,DEM,Under Votes,4,0,8,12
Comal,405,Proposition #10,,DEM,Over Votes,0,0,0,0
Comal,405,Proposition #11,,DEM,Yes,129,36,137,302
Comal,405,Proposition #11,,DEM,No,8,0,4,12
Comal,405,Proposition #11,,DEM,Cast Votes:,137,36,141,314
Comal,405,Proposition #11,,DEM,Under Votes,9,2,8,19
Comal,405,Proposition #11,,DEM,Over Votes,0,0,0,0
Comal,406,President,,DEM,Tulsi Gabbard,1,1,1,3
Comal,406,President,,DEM,Marianne Williamson,0,0,0,0
Comal,406,President,,DEM,John K. Delaney,2,0,1,3
Comal,406,President,,DEM,Elizabeth Warren,59,9,39,107
Comal,406,President,,DEM,Cory Booker,1,0,0,1
Comal,406,President,,DEM,Amy Klobuchar,0,11,13,24
Comal,406,President,,DEM,Joseph R. Biden,103,23,43,169
Comal,406,President,,DEM,Pete Buttigieg,2,9,25,36
Comal,406,President,,DEM,Juli치n Castro,1,0,0,1
Comal,406,President,,DEM,Tom Steyer,0,0,0,0
Comal,406,President,,DEM,Michael Bennet,0,1,0,1
Comal,406,President,,DEM,Michael R. Bloomberg,31,29,28,88
Comal,406,President,,DEM,Robby Wells,0,1,0,1
Comal,406,President,,DEM,"Roque ""Rocky"" De La Fuente",0,0,0,0
Comal,406,President,,DEM,Deval Patrick,0,0,0,0
Comal,406,President,,DEM,Bernie Sanders,66,12,48,126
Comal,406,President,,DEM,Andrew Yang,1,0,0,1
Comal,406,Ballots Cast,,DEM,,267,96,198,561
Comal,406,President,,DEM,Under Votes,0,0,0,0
Comal,406,President,,DEM,Over Votes,0,1,0,1
Comal,406,U.S. Senate,,DEM,Royce West,13,4,10,27
Comal,406,U.S. Senate,,DEM,Chris Bell,20,19,14,53
Comal,406,U.S. Senate,,DEM,Amanda K. Edwards,29,15,23,67
Comal,406,U.S. Senate,,DEM,Sema Hernandez,23,1,19,43
Comal,406,U.S. Senate,,DEM,Jack Daniel Foster Jr,7,3,4,14
Comal,406,U.S. Senate,,DEM,D.R. Hunter,4,1,2,7
Comal,406,U.S. Senate,,DEM,Adrian Ocegueda,3,0,1,4
Comal,406,U.S. Senate,,DEM,"Mary ""MJ"" Hegar",76,30,75,181
Comal,406,U.S. Senate,,DEM,Cristina Tzintzun Ramirez,23,10,14,47
Comal,406,U.S. Senate,,DEM,Michael Cooper,3,2,1,6
Comal,406,U.S. Senate,,DEM,Victor Hugo Harris,2,0,1,3
Comal,406,U.S. Senate,,DEM,"Annie ""Mam치"" Garcia",18,4,8,30
Comal,406,U.S. Senate,,DEM,Cast Votes:,221,89,172,482
Comal,406,U.S. Senate,,DEM,Under Votes,46,7,26,79
Comal,406,U.S. Senate,,DEM,Over Votes,0,1,0,1
Comal,406,U.S. House,21,DEM,Wendy R. Davis,193,74,153,420
Comal,406,U.S. House,21,DEM,Jennie Lou Leeder,35,16,22,73
Comal,406,U.S. House,21,DEM,Cast Votes:,228,90,175,493
Comal,406,U.S. House,21,DEM,Under Votes,39,6,23,68
Comal,406,U.S. House,21,DEM,Over Votes,0,1,0,1
Comal,406,Railroad Commissioner,,DEM,Mark Watson,31,20,37,88
Comal,406,Railroad Commissioner,,DEM,Chrysta Casta침eda,90,31,67,188
Comal,406,Railroad Commissioner,,DEM,Kelly Stone,56,16,31,103
Comal,406,Railroad Commissioner,,DEM,"Roberto R. ""Beto"" Alonzo",36,13,25,74
Comal,406,Railroad Commissioner,,DEM,Cast Votes:,213,80,160,453
Comal,406,Railroad Commissioner,,DEM,Under Votes,54,17,38,109
Comal,406,Railroad Commissioner,,DEM,Over Votes,0,0,0,0
Comal,406,"Chief Justice, Supreme Court",,DEM,Amy Clark Meachum,196,73,154,423
Comal,406,"Chief Justice, Supreme Court",,DEM,Jerry Zimmerer,19,9,13,41
Comal,406,"Chief Justice, Supreme Court",,DEM,Cast Votes:,215,82,167,464
Comal,406,"Chief Justice, Supreme Court",,DEM,Under Votes,52,15,31,98
Comal,406,"Chief Justice, Supreme Court",,DEM,Over Votes,0,0,0,0
Comal,406,"Justice, Supreme Court, Place 6 Unexpired Term",,DEM,Larry Praeger,33,29,38,100
Comal,406,"Justice, Supreme Court, Place 6 Unexpired Term",,DEM,Kathy Cheng,188,54,124,366
Comal,406,"Justice, Supreme Court, Place 6 Unexpired Term",,DEM,Cast Votes:,221,83,162,466
Comal,406,"Justice, Supreme Court, Place 6 Unexpired Term",,DEM,Under Votes,46,14,36,96
Comal,406,"Justice, Supreme Court, Place 6 Unexpired Term",,DEM,Over Votes,0,0,0,0
Comal,406,"Justice, Supreme Court, Place 7",,DEM,Staci Williams,131,45,105,281
Comal,406,"Justice, Supreme Court, Place 7",,DEM,Brandy Voss,82,36,60,178
Comal,406,"Justice, Supreme Court, Place 7",,DEM,Cast Votes:,213,81,165,459
Comal,406,"Justice, Supreme Court, Place 7",,DEM,Under Votes,54,16,33,103
Comal,406,"Justice, Supreme Court, Place 7",,DEM,Over Votes,0,0,0,0
Comal,406,"Justice, Supreme Court, Place 8",,DEM,Peter Kelly,45,29,35,109
Comal,406,"Justice, Supreme Court, Place 8",,DEM,Gisela D. Triana,177,53,126,356
Comal,406,"Justice, Supreme Court, Place 8",,DEM,Cast Votes:,222,82,161,465
Comal,406,"Justice, Supreme Court, Place 8",,DEM,Under Votes,45,15,37,97
Comal,406,"Justice, Supreme Court, Place 8",,DEM,Over Votes,0,0,0,0
Comal,406,"Judge, Court of Criminal Appeals, Place 3",,DEM,Elizabeth Davis Frizell,178,54,138,370
Comal,406,"Judge, Court of Criminal Appeals, Place 3",,DEM,William Pieratt Demond,8,10,8,26
Comal,406,"Judge, Court of Criminal Appeals, Place 3",,DEM,Dan Wood,30,18,16,64
Comal,406,"Judge, Court of Criminal Appeals, Place 3",,DEM,Cast Votes:,216,82,162,460
Comal,406,"Judge, Court of Criminal Appeals, Place 3",,DEM,Under Votes,51,15,36,102
Comal,406,"Judge, Court of Criminal Appeals, Place 3",,DEM,Over Votes,0,0,0,0
Comal,406,"Judge, Court of Criminal Appeals, Place 4",,DEM,Tina Clinton,191,61,144,396
Comal,406,"Judge, Court of Criminal Appeals, Place 4",,DEM,Steven Miears,22,19,18,59
Comal,406,"Judge, Court of Criminal Appeals, Place 4",,DEM,Cast Votes:,213,80,162,455
Comal,406,"Judge, Court of Criminal Appeals, Place 4",,DEM,Under Votes,54,17,36,107
Comal,406,"Judge, Court of Criminal Appeals, Place 4",,DEM,Over Votes,0,0,0,0
Comal,406,"Judge, Court of Criminal Appeals, Place 9",,DEM,Brandon Birmingham,184,66,136,386
Comal,406,"Judge, Court of Criminal Appeals, Place 9",,DEM,Cast Votes:,184,66,136,386
Comal,406,"Judge, Court of Criminal Appeals, Place 9",,DEM,Under Votes,83,31,62,176
Comal,406,"Judge, Court of Criminal Appeals, Place 9",,DEM,Over Votes,0,0,0,0
Comal,406,"Member, State Board of Education, District 5",,DEM,Rebecca Bell-Metereau,144,49,108,301
Comal,406,"Member, State Board of Education, District 5",,DEM,Letti Bresnahan,58,32,49,139
Comal,406,"Member, State Board of Education, District 5",,DEM,Cast Votes:,202,81,157,440
Comal,406,"Member, State Board of Education, District 5",,DEM,Under Votes,65,16,41,122
Comal,406,"Member, State Board of Education, District 5",,DEM,Over Votes,0,0,0,0
Comal,406,State Representative,73,DEM,Stephanie Phillips,202,69,146,417
Comal,406,State Representative,73,DEM,Cast Votes:,202,69,146,417
Comal,406,State Representative,73,DEM,Under Votes,65,28,52,145
Comal,406,State Representative,73,DEM,Over Votes,0,0,0,0
Comal,406,"Chief Justice, 3rd Court of Appeals District",,DEM,Darlene Byrne,168,65,125,358
Comal,406,"Chief Justice, 3rd Court of Appeals District",,DEM,Keith S. Hampton,38,18,27,83
Comal,406,"Chief Justice, 3rd Court of Appeals District",,DEM,Cast Votes:,206,83,152,441
Comal,406,"Chief Justice, 3rd Court of Appeals District",,DEM,Under Votes,61,14,46,121
Comal,406,"Chief Justice, 3rd Court of Appeals District",,DEM,Over Votes,0,0,0,0
Comal,406,County Chairman,,DEM,Gloria Meehan,199,67,145,411
Comal,406,County Chairman,,DEM,Cast Votes:,199,67,145,411
Comal,406,County Chairman,,DEM,Under Votes,68,30,53,151
Comal,406,County Chairman,,DEM,Over Votes,0,0,0,0
Comal,406,Proposition #1,,DEM,Yes,230,85,181,496
Comal,406,Proposition #1,,DEM,No,28,6,13,47
Comal,406,Proposition #1,,DEM,Cast Votes:,258,91,194,543
Comal,406,Proposition #1,,DEM,Under Votes,9,6,4,19
Comal,406,Proposition #1,,DEM,Over Votes,0,0,0,0
Comal,406,Proposition #2,,DEM,Yes,233,90,176,499
Comal,406,Proposition #2,,DEM,No,25,3,17,45
Comal,406,Proposition #2,,DEM,Cast Votes:,258,93,193,544
Comal,406,Proposition #2,,DEM,Under Votes,9,4,5,18
Comal,406,Proposition #2,,DEM,Over Votes,0,0,0,0
Comal,406,Proposition #3,,DEM,Yes,247,91,188,526
Comal,406,Proposition #3,,DEM,No,12,1,7,20
Comal,406,Proposition #3,,DEM,Cast Votes:,259,92,195,546
Comal,406,Proposition #3,,DEM,Under Votes,8,5,3,16
Comal,406,Proposition #3,,DEM,Over Votes,0,0,0,0
Comal,406,Proposition #4,,DEM,Yes,227,84,179,490
Comal,406,Proposition #4,,DEM,No,27,4,14,45
Comal,406,Proposition #4,,DEM,Cast Votes:,254,88,193,535
Comal,406,Proposition #4,,DEM,Under Votes,13,9,5,27
Comal,406,Proposition #4,,DEM,Over Votes,0,0,0,0
Comal,406,Proposition #5,,DEM,Yes,247,90,189,526
Comal,406,Proposition #5,,DEM,No,10,1,6,17
Comal,406,Proposition #5,,DEM,Cast Votes:,257,91,195,543
Comal,406,Proposition #5,,DEM,Under Votes,10,6,3,19
Comal,406,Proposition #5,,DEM,Over Votes,0,0,0,0
Comal,406,Proposition #6,,DEM,Yes,244,92,188,524
Comal,406,Proposition #6,,DEM,No,13,1,7,21
Comal,406,Proposition #6,,DEM,Cast Votes:,257,93,195,545
Comal,406,Proposition #6,,DEM,Under Votes,10,4,3,17
Comal,406,Proposition #6,,DEM,Over Votes,0,0,0,0
Comal,406,Proposition #7,,DEM,Yes,228,87,182,497
Comal,406,Proposition #7,,DEM,No,27,3,13,43
Comal,406,Proposition #7,,DEM,Cast Votes:,255,90,195,540
Comal,406,Proposition #7,,DEM,Under Votes,12,7,3,22
Comal,406,Proposition #7,,DEM,Over Votes,0,0,0,0
Comal,406,Proposition #8,,DEM,Yes,234,90,183,507
Comal,406,Proposition #8,,DEM,No,18,3,10,31
Comal,406,Proposition #8,,DEM,Cast Votes:,252,93,193,538
Comal,406,Proposition #8,,DEM,Under Votes,15,2,5,22
Comal,406,Proposition #8,,DEM,Over Votes,0,0,0,0
Comal,406,Proposition #9,,DEM,Yes,240,92,188,520
Comal,406,Proposition #9,,DEM,No,16,1,7,24
Comal,406,Proposition #9,,DEM,Cast Votes:,256,93,195,544
Comal,406,Proposition #9,,DEM,Under Votes,11,2,3,16
Comal,406,Proposition #9,,DEM,Over Votes,0,0,0,0
Comal,406,Proposition #10,,DEM,Yes,236,90,178,504
Comal,406,Proposition #10,,DEM,No,21,2,15,38
Comal,406,Proposition #10,,DEM,Cast Votes:,257,92,193,542
Comal,406,Proposition #10,,DEM,Under Votes,10,3,5,18
Comal,406,Proposition #10,,DEM,Over Votes,0,0,0,0
Comal,406,Proposition #11,,DEM,Yes,229,86,171,486
Comal,406,Proposition #11,,DEM,No,23,7,18,48
Comal,406,Proposition #11,,DEM,Cast Votes:,252,93,189,534
Comal,406,Proposition #11,,DEM,Under Votes,15,2,9,26
Comal,406,Proposition #11,,DEM,Over Votes,0,0,0,0
Comal,102,President,,DEM,Tulsi Gabbard,5,1,0,6
Comal,102,President,,DEM,Marianne Williamson,0,0,1,1
Comal,102,President,,DEM,John K. Delaney,0,0,0,0
Comal,102,President,,DEM,Elizabeth Warren,18,1,13,32
Comal,102,President,,DEM,Cory Booker,0,0,0,0
Comal,102,President,,DEM,Amy Klobuchar,0,1,7,8
Comal,102,President,,DEM,Joseph R. Biden,73,12,38,123
Comal,102,President,,DEM,Pete Buttigieg,1,6,18,25
Comal,102,President,,DEM,Juli치n Castro,0,0,1,1
Comal,102,President,,DEM,Tom Steyer,0,1,1,2
Comal,102,President,,DEM,Michael Bennet,0,0,0,0
Comal,102,President,,DEM,Michael R. Bloomberg,12,4,15,31
Comal,102,President,,DEM,Robby Wells,0,0,0,0
Comal,102,President,,DEM,"Roque ""Rocky"" De La Fuente",0,0,0,0
Comal,102,President,,DEM,Deval Patrick,0,0,0,0
Comal,102,President,,DEM,Bernie Sanders,30,1,25,56
Comal,102,President,,DEM,Andrew Yang,0,0,0,0
Comal,102,Ballots Cast,,DEM,,139,27,119,285
Comal,102,President,,DEM,Under Votes,1,0,0,1
Comal,102,President,,DEM,Over Votes,0,0,0,0
Comal,102,U.S. Senate,,DEM,Royce West,4,4,3,11
Comal,102,U.S. Senate,,DEM,Chris Bell,14,4,8,26
Comal,102,U.S. Senate,,DEM,Amanda K. Edwards,22,1,17,40
Comal,102,U.S. Senate,,DEM,Sema Hernandez,17,1,15,33
Comal,102,U.S. Senate,,DEM,Jack Daniel Foster Jr,4,1,1,6
Comal,102,U.S. Senate,,DEM,D.R. Hunter,1,0,0,1
Comal,102,U.S. Senate,,DEM,Adrian Ocegueda,0,0,1,1
Comal,102,U.S. Senate,,DEM,"Mary ""MJ"" Hegar",30,8,52,90
Comal,102,U.S. Senate,,DEM,Cristina Tzintzun Ramirez,8,1,8,17
Comal,102,U.S. Senate,,DEM,Michael Cooper,3,2,0,5
Comal,102,U.S. Senate,,DEM,Victor Hugo Harris,1,0,1,2
Comal,102,U.S. Senate,,DEM,"Annie ""Mam치"" Garcia",9,2,3,14
Comal,102,U.S. Senate,,DEM,Cast Votes:,113,24,109,246
Comal,102,U.S. Senate,,DEM,Under Votes,27,3,10,40
Comal,102,U.S. Senate,,DEM,Over Votes,0,0,0,0
Comal,102,U.S. House,21,DEM,Wendy R. Davis,88,18,87,193
Comal,102,U.S. House,21,DEM,Jennie Lou Leeder,29,7,22,58
Comal,102,U.S. House,21,DEM,Cast Votes:,117,25,109,251
Comal,102,U.S. House,21,DEM,Under Votes,23,2,10,35
Comal,102,U.S. House,21,DEM,Over Votes,0,0,0,0
Comal,102,Railroad Commissioner,,DEM,Mark Watson,24,4,6,34
Comal,102,Railroad Commissioner,,DEM,Chrysta Casta침eda,37,9,48,94
Comal,102,Railroad Commissioner,,DEM,Kelly Stone,25,4,19,48
Comal,102,Railroad Commissioner,,DEM,"Roberto R. ""Beto"" Alonzo",26,9,25,60
Comal,102,Railroad Commissioner,,DEM,Cast Votes:,112,26,98,236
Comal,102,Railroad Commissioner,,DEM,Under Votes,28,1,21,50
Comal,102,Railroad Commissioner,,DEM,Over Votes,0,0,0,0
Comal,102,"Chief Justice, Supreme Court",,DEM,Amy Clark Meachum,95,21,89,205
Comal,102,"Chief Justice, Supreme Court",,DEM,Jerry Zimmerer,20,3,12,35
Comal,102,"Chief Justice, Supreme Court",,DEM,Cast Votes:,115,24,101,240
Comal,102,"Chief Justice, Supreme Court",,DEM,Under Votes,25,3,18,46
Comal,102,"Chief Justice, Supreme Court",,DEM,Over Votes,0,0,0,0
Comal,102,"Justice, Supreme Court, Place 6 Unexpired Term",,DEM,Larry Praeger,23,6,12,41
Comal,102,"Justice, Supreme Court, Place 6 Unexpired Term",,DEM,Kathy Cheng,91,20,86,197
Comal,102,"Justice, Supreme Court, Place 6 Unexpired Term",,DEM,Cast Votes:,114,26,98,238
Comal,102,"Justice, Supreme Court, Place 6 Unexpired Term",,DEM,Under Votes,26,1,21,48
Comal,102,"Justice, Supreme Court, Place 6 Unexpired Term",,DEM,Over Votes,0,0,0,0
Comal,102,"Justice, Supreme Court, Place 7",,DEM,Staci Williams,57,15,58,130
Comal,102,"Justice, Supreme Court, Place 7",,DEM,Brandy Voss,48,11,42,101
Comal,102,"Justice, Supreme Court, Place 7",,DEM,Cast Votes:,105,26,100,231
Comal,102,"Justice, Supreme Court, Place 7",,DEM,Under Votes,35,1,19,55
Comal,102,"Justice, Supreme Court, Place 7",,DEM,Over Votes,0,0,0,0
Comal,102,"Justice, Supreme Court, Place 8",,DEM,Peter Kelly,39,7,16,62
Comal,102,"Justice, Supreme Court, Place 8",,DEM,Gisela D. Triana,72,19,84,175
Comal,102,"Justice, Supreme Court, Place 8",,DEM,Cast Votes:,111,26,100,237
Comal,102,"Justice, Supreme Court, Place 8",,DEM,Under Votes,29,1,19,49
Comal,102,"Justice, Supreme Court, Place 8",,DEM,Over Votes,0,0,0,0
Comal,102,"Judge, Court of Criminal Appeals, Place 3",,DEM,Elizabeth Davis Frizell,75,18,82,175
Comal,102,"Judge, Court of Criminal Appeals, Place 3",,DEM,William Pieratt Demond,3,3,7,13
Comal,102,"Judge, Court of Criminal Appeals, Place 3",,DEM,Dan Wood,31,5,11,47
Comal,102,"Judge, Court of Criminal Appeals, Place 3",,DEM,Cast Votes:,109,26,100,235
Comal,102,"Judge, Court of Criminal Appeals, Place 3",,DEM,Under Votes,31,1,19,51
Comal,102,"Judge, Court of Criminal Appeals, Place 3",,DEM,Over Votes,0,0,0,0
Comal,102,"Judge, Court of Criminal Appeals, Place 4",,DEM,Tina Clinton,90,22,87,199
Comal,102,"Judge, Court of Criminal Appeals, Place 4",,DEM,Steven Miears,19,5,14,38
Comal,102,"Judge, Court of Criminal Appeals, Place 4",,DEM,Cast Votes:,109,27,101,237
Comal,102,"Judge, Court of Criminal Appeals, Place 4",,DEM,Under Votes,31,0,18,49
Comal,102,"Judge, Court of Criminal Appeals, Place 4",,DEM,Over Votes,0,0,0,0
Comal,102,"Judge, Court of Criminal Appeals, Place 9",,DEM,Brandon Birmingham,101,24,96,221
Comal,102,"Judge, Court of Criminal Appeals, Place 9",,DEM,Cast Votes:,101,24,96,221
Comal,102,"Judge, Court of Criminal Appeals, Place 9",,DEM,Under Votes,39,3,23,65
Comal,102,"Judge, Court of Criminal Appeals, Place 9",,DEM,Over Votes,0,0,0,0
Comal,102,"Member, State Board of Education, District 5",,DEM,Rebecca Bell-Metereau,69,13,57,139
Comal,102,"Member, State Board of Education, District 5",,DEM,Letti Bresnahan,41,13,44,98
Comal,102,"Member, State Board of Education, District 5",,DEM,Cast Votes:,110,26,101,237
Comal,102,"Member, State Board of Education, District 5",,DEM,Under Votes,30,1,18,49
Comal,102,"Member, State Board of Education, District 5",,DEM,Over Votes,0,0,0,0
Comal,102,State Representative,73,DEM,Stephanie Phillips,102,24,97,223
Comal,102,State Representative,73,DEM,Cast Votes:,102,24,97,223
Comal,102,State Representative,73,DEM,Under Votes,38,3,22,63
Comal,102,State Representative,73,DEM,Over Votes,0,0,0,0
Comal,102,"Chief Justice, 3rd Court of Appeals District",,DEM,Darlene Byrne,81,14,91,186
Comal,102,"Chief Justice, 3rd Court of Appeals District",,DEM,Keith S. Hampton,25,10,9,44
Comal,102,"Chief Justice, 3rd Court of Appeals District",,DEM,Cast Votes:,106,24,100,230
Comal,102,"Chief Justice, 3rd Court of Appeals District",,DEM,Under Votes,34,3,19,56
Comal,102,"Chief Justice, 3rd Court of Appeals District",,DEM,Over Votes,0,0,0,0
Comal,102,"County Commissioner, Precinct 1",,DEM,Lindsay Poisel,100,25,98,223
Comal,102,"County Commissioner, Precinct 1",,DEM,Cast Votes:,100,25,98,223
Comal,102,"County Commissioner, Precinct 1",,DEM,Under Votes,40,2,21,63
Comal,102,"County Commissioner, Precinct 1",,DEM,Over Votes,0,0,0,0
Comal,102,County Chairman,,DEM,Gloria Meehan,101,25,97,223
Comal,102,County Chairman,,DEM,Cast Votes:,101,25,97,223
Comal,102,County Chairman,,DEM,Under Votes,39,2,22,63
Comal,102,County Chairman,,DEM,Over Votes,0,0,0,0
Comal,102,Proposition #1,,DEM,Yes,120,24,103,247
Comal,102,Proposition #1,,DEM,No,16,2,11,29
Comal,102,Proposition #1,,DEM,Cast Votes:,136,26,114,276
Comal,102,Proposition #1,,DEM,Under Votes,4,1,5,10
Comal,102,Proposition #1,,DEM,Over Votes,0,0,0,0
Comal,102,Proposition #2,,DEM,Yes,120,25,110,255
Comal,102,Proposition #2,,DEM,No,17,1,5,23
Comal,102,Proposition #2,,DEM,Cast Votes:,137,26,115,278
Comal,102,Proposition #2,,DEM,Under Votes,3,1,4,8
Comal,102,Proposition #2,,DEM,Over Votes,0,0,0,0
Comal,102,Proposition #3,,DEM,Yes,129,26,113,268
Comal,102,Proposition #3,,DEM,No,8,0,1,9
Comal,102,Proposition #3,,DEM,Cast Votes:,137,26,114,277
Comal,102,Proposition #3,,DEM,Under Votes,3,1,5,9
Comal,102,Proposition #3,,DEM,Over Votes,0,0,0,0
Comal,102,Proposition #4,,DEM,Yes,121,26,103,250
Comal,102,Proposition #4,,DEM,No,14,0,11,25
Comal,102,Proposition #4,,DEM,Cast Votes:,135,26,114,275
Comal,102,Proposition #4,,DEM,Under Votes,5,1,5,11
Comal,102,Proposition #4,,DEM,Over Votes,0,0,0,0
Comal,102,Proposition #5,,DEM,Yes,129,26,115,270
Comal,102,Proposition #5,,DEM,No,4,0,1,5
Comal,102,Proposition #5,,DEM,Cast Votes:,133,26,116,275
Comal,102,Proposition #5,,DEM,Under Votes,7,1,3,11
Comal,102,Proposition #5,,DEM,Over Votes,0,0,0,0
Comal,102,Proposition #6,,DEM,Yes,128,25,114,267
Comal,102,Proposition #6,,DEM,No,6,1,1,8
Comal,102,Proposition #6,,DEM,Cast Votes:,134,26,115,275
Comal,102,Proposition #6,,DEM,Under Votes,6,1,4,11
Comal,102,Proposition #6,,DEM,Over Votes,0,0,0,0
Comal,102,Proposition #7,,DEM,Yes,115,25,107,247
Comal,102,Proposition #7,,DEM,No,17,0,6,23
Comal,102,Proposition #7,,DEM,Cast Votes:,132,25,113,270
Comal,102,Proposition #7,,DEM,Under Votes,8,2,6,16
Comal,102,Proposition #7,,DEM,Over Votes,0,0,0,0
Comal,102,Proposition #8,,DEM,Yes,127,25,110,262
Comal,102,Proposition #8,,DEM,No,7,1,5,13
Comal,102,Proposition #8,,DEM,Cast Votes:,134,26,115,275
Comal,102,Proposition #8,,DEM,Under Votes,6,1,4,11
Comal,102,Proposition #8,,DEM,Over Votes,0,0,0,0
Comal,102,Proposition #9,,DEM,Yes,127,25,114,266
Comal,102,Proposition #9,,DEM,No,6,1,1,8
Comal,102,Proposition #9,,DEM,Cast Votes:,133,26,115,274
Comal,102,Proposition #9,,DEM,Under Votes,7,1,4,12
Comal,102,Proposition #9,,DEM,Over Votes,0,0,0,0
Comal,102,Proposition #10,,DEM,Yes,124,24,110,258
Comal,102,Proposition #10,,DEM,No,8,2,3,13
Comal,102,Proposition #10,,DEM,Cast Votes:,132,26,113,271
Comal,102,Proposition #10,,DEM,Under Votes,8,1,6,15
Comal,102,Proposition #10,,DEM,Over Votes,0,0,0,0
Comal,102,Proposition #11,,DEM,Yes,118,25,102,245
Comal,102,Proposition #11,,DEM,No,14,1,9,24
Comal,102,Proposition #11,,DEM,Cast Votes:,132,26,111,269
Comal,102,Proposition #11,,DEM,Under Votes,8,1,8,17
Comal,102,Proposition #11,,DEM,Over Votes,0,0,0,0
Comal,407,President,,DEM,Tulsi Gabbard,1,0,0,1
Comal,407,President,,DEM,Marianne Williamson,0,0,0,0
Comal,407,President,,DEM,John K. Delaney,1,0,0,1
Comal,407,President,,DEM,Elizabeth Warren,17,3,20,40
Comal,407,President,,DEM,Cory Booker,0,0,0,0
Comal,407,President,,DEM,Amy Klobuchar,1,6,15,22
Comal,407,President,,DEM,Joseph R. Biden,82,1,27,110
Comal,407,President,,DEM,Pete Buttigieg,1,5,22,28
Comal,407,President,,DEM,Juli치n Castro,0,0,0,0
Comal,407,President,,DEM,Tom Steyer,0,0,0,0
Comal,407,President,,DEM,Michael Bennet,0,0,0,0
Comal,407,President,,DEM,Michael R. Bloomberg,20,11,24,55
Comal,407,President,,DEM,Robby Wells,0,0,0,0
Comal,407,President,,DEM,"Roque ""Rocky"" De La Fuente",0,0,0,0
Comal,407,President,,DEM,Deval Patrick,0,0,0,0
Comal,407,President,,DEM,Bernie Sanders,32,1,18,51
Comal,407,President,,DEM,Andrew Yang,0,0,0,0
Comal,407,Ballots Cast,,DEM,,155,27,126,308
Comal,407,President,,DEM,Under Votes,1,0,0,1
Comal,407,President,,DEM,Over Votes,0,0,0,0
Comal,407,U.S. Senate,,DEM,Royce West,12,0,9,21
Comal,407,U.S. Senate,,DEM,Chris Bell,8,0,12,20
Comal,407,U.S. Senate,,DEM,Amanda K. Edwards,26,8,18,52
Comal,407,U.S. Senate,,DEM,Sema Hernandez,8,0,10,18
Comal,407,U.S. Senate,,DEM,Jack Daniel Foster Jr,3,1,0,4
Comal,407,U.S. Senate,,DEM,D.R. Hunter,7,0,2,9
Comal,407,U.S. Senate,,DEM,Adrian Ocegueda,2,0,1,3
Comal,407,U.S. Senate,,DEM,"Mary ""MJ"" Hegar",38,15,49,102
Comal,407,U.S. Senate,,DEM,Cristina Tzintzun Ramirez,6,2,8,16
Comal,407,U.S. Senate,,DEM,Michael Cooper,3,0,0,3
Comal,407,U.S. Senate,,DEM,Victor Hugo Harris,2,0,2,4
Comal,407,U.S. Senate,,DEM,"Annie ""Mam치"" Garcia",8,0,2,10
Comal,407,U.S. Senate,,DEM,Cast Votes:,123,26,113,262
Comal,407,U.S. Senate,,DEM,Under Votes,33,1,13,47
Comal,407,U.S. Senate,,DEM,Over Votes,0,0,0,0
Comal,407,U.S. House,21,DEM,Wendy R. Davis,114,25,87,226
Comal,407,U.S. House,21,DEM,Jennie Lou Leeder,13,1,21,35
Comal,407,U.S. House,21,DEM,Cast Votes:,127,26,108,261
Comal,407,U.S. House,21,DEM,Under Votes,29,1,18,48
Comal,407,U.S. House,21,DEM,Over Votes,0,0,0,0
Comal,407,Railroad Commissioner,,DEM,Mark Watson,23,0,15,38
Comal,407,Railroad Commissioner,,DEM,Chrysta Casta침eda,37,10,34,81
Comal,407,Railroad Commissioner,,DEM,Kelly Stone,25,10,30,65
Comal,407,Railroad Commissioner,,DEM,"Roberto R. ""Beto"" Alonzo",30,4,26,60
Comal,407,Railroad Commissioner,,DEM,Cast Votes:,115,24,105,244
Comal,407,Railroad Commissioner,,DEM,Under Votes,41,3,21,65
Comal,407,Railroad Commissioner,,DEM,Over Votes,0,0,0,0
Comal,407,"Chief Justice, Supreme Court",,DEM,Amy Clark Meachum,106,25,88,219
Comal,407,"Chief Justice, Supreme Court",,DEM,Jerry Zimmerer,12,1,14,27
Comal,407,"Chief Justice, Supreme Court",,DEM,Cast Votes:,118,26,102,246
Comal,407,"Chief Justice, Supreme Court",,DEM,Under Votes,38,1,24,63
Comal,407,"Chief Justice, Supreme Court",,DEM,Over Votes,0,0,0,0
Comal,407,"Justice, Supreme Court, Place 6 Unexpired Term",,DEM,Larry Praeger,27,4,16,47
Comal,407,"Justice, Supreme Court, Place 6 Unexpired Term",,DEM,Kathy Cheng,87,20,87,194
Comal,407,"Justice, Supreme Court, Place 6 Unexpired Term",,DEM,Cast Votes:,114,24,103,241
Comal,407,"Justice, Supreme Court, Place 6 Unexpired Term",,DEM,Under Votes,42,3,23,68
Comal,407,"Justice, Supreme Court, Place 6 Unexpired Term",,DEM,Over Votes,0,0,0,0
Comal,407,"Justice, Supreme Court, Place 7",,DEM,Staci Williams,72,17,61,150
Comal,407,"Justice, Supreme Court, Place 7",,DEM,Brandy Voss,40,6,39,85
Comal,407,"Justice, Supreme Court, Place 7",,DEM,Cast Votes:,112,23,100,235
Comal,407,"Justice, Supreme Court, Place 7",,DEM,Under Votes,44,4,26,74
Comal,407,"Justice, Supreme Court, Place 7",,DEM,Over Votes,0,0,0,0
Comal,407,"Justice, Supreme Court, Place 8",,DEM,Peter Kelly,33,9,18,60
Comal,407,"Justice, Supreme Court, Place 8",,DEM,Gisela D. Triana,82,14,85,181
Comal,407,"Justice, Supreme Court, Place 8",,DEM,Cast Votes:,115,23,103,241
Comal,407,"Justice, Supreme Court, Place 8",,DEM,Under Votes,41,4,23,68
Comal,407,"Justice, Supreme Court, Place 8",,DEM,Over Votes,0,0,0,0
Comal,407,"Judge, Court of Criminal Appeals, Place 3",,DEM,Elizabeth Davis Frizell,87,19,82,188
Comal,407,"Judge, Court of Criminal Appeals, Place 3",,DEM,William Pieratt Demond,7,3,1,11
Comal,407,"Judge, Court of Criminal Appeals, Place 3",,DEM,Dan Wood,21,0,17,38
Comal,407,"Judge, Court of Criminal Appeals, Place 3",,DEM,Cast Votes:,115,22,100,237
Comal,407,"Judge, Court of Criminal Appeals, Place 3",,DEM,Under Votes,41,5,26,72
Comal,407,"Judge, Court of Criminal Appeals, Place 3",,DEM,Over Votes,0,0,0,0
Comal,407,"Judge, Court of Criminal Appeals, Place 4",,DEM,Tina Clinton,91,19,77,187
Comal,407,"Judge, Court of Criminal Appeals, Place 4",,DEM,Steven Miears,22,3,20,45
Comal,407,"Judge, Court of Criminal Appeals, Place 4",,DEM,Cast Votes:,113,22,97,232
Comal,407,"Judge, Court of Criminal Appeals, Place 4",,DEM,Under Votes,43,5,29,77
Comal,407,"Judge, Court of Criminal Appeals, Place 4",,DEM,Over Votes,0,0,0,0
Comal,407,"Judge, Court of Criminal Appeals, Place 9",,DEM,Brandon Birmingham,99,21,89,209
Comal,407,"Judge, Court of Criminal Appeals, Place 9",,DEM,Cast Votes:,99,21,89,209
Comal,407,"Judge, Court of Criminal Appeals, Place 9",,DEM,Under Votes,57,6,37,100
Comal,407,"Judge, Court of Criminal Appeals, Place 9",,DEM,Over Votes,0,0,0,0
Comal,407,"Member, State Board of Education, District 5",,DEM,Rebecca Bell-Metereau,75,17,77,169
Comal,407,"Member, State Board of Education, District 5",,DEM,Letti Bresnahan,39,7,23,69
Comal,407,"Member, State Board of Education, District 5",,DEM,Cast Votes:,114,24,100,238
Comal,407,"Member, State Board of Education, District 5",,DEM,Under Votes,42,3,26,71
Comal,407,"Member, State Board of Education, District 5",,DEM,Over Votes,0,0,0,0
Comal,407,State Representative,73,DEM,Stephanie Phillips,105,24,97,226
Comal,407,State Representative,73,DEM,Cast Votes:,105,24,97,226
Comal,407,State Representative,73,DEM,Under Votes,51,3,29,83
Comal,407,State Representative,73,DEM,Over Votes,0,0,0,0
Comal,407,"Chief Justice, 3rd Court of Appeals District",,DEM,Darlene Byrne,89,22,82,193
Comal,407,"Chief Justice, 3rd Court of Appeals District",,DEM,Keith S. Hampton,21,2,15,38
Comal,407,"Chief Justice, 3rd Court of Appeals District",,DEM,Cast Votes:,110,24,97,231
Comal,407,"Chief Justice, 3rd Court of Appeals District",,DEM,Under Votes,46,3,29,78
Comal,407,"Chief Justice, 3rd Court of Appeals District",,DEM,Over Votes,0,0,0,0
Comal,407,County Chairman,,DEM,Gloria Meehan,106,24,97,227
Comal,407,County Chairman,,DEM,Cast Votes:,106,24,97,227
Comal,407,County Chairman,,DEM,Under Votes,50,3,29,82
Comal,407,County Chairman,,DEM,Over Votes,0,0,0,0
Comal,407,Proposition #1,,DEM,Yes,124,24,103,251
Comal,407,Proposition #1,,DEM,No,19,3,15,37
Comal,407,Proposition #1,,DEM,Cast Votes:,143,27,118,288
Comal,407,Proposition #1,,DEM,Under Votes,13,0,8,21
Comal,407,Proposition #1,,DEM,Over Votes,0,0,0,0
Comal,407,Proposition #2,,DEM,Yes,125,27,102,254
Comal,407,Proposition #2,,DEM,No,18,0,16,34
Comal,407,Proposition #2,,DEM,Cast Votes:,143,27,118,288
Comal,407,Proposition #2,,DEM,Under Votes,13,0,8,21
Comal,407,Proposition #2,,DEM,Over Votes,0,0,0,0
Comal,407,Proposition #3,,DEM,Yes,139,27,116,282
Comal,407,Proposition #3,,DEM,No,8,0,5,13
Comal,407,Proposition #3,,DEM,Cast Votes:,147,27,121,295
Comal,407,Proposition #3,,DEM,Under Votes,9,0,5,14
Comal,407,Proposition #3,,DEM,Over Votes,0,0,0,0
Comal,407,Proposition #4,,DEM,Yes,123,27,107,257
Comal,407,Proposition #4,,DEM,No,19,0,13,32
Comal,407,Proposition #4,,DEM,Cast Votes:,142,27,120,289
Comal,407,Proposition #4,,DEM,Under Votes,14,0,6,20
Comal,407,Proposition #4,,DEM,Over Votes,0,0,0,0
Comal,407,Proposition #5,,DEM,Yes,137,27,117,281
Comal,407,Proposition #5,,DEM,No,7,0,4,11
Comal,407,Proposition #5,,DEM,Cast Votes:,144,27,121,292
Comal,407,Proposition #5,,DEM,Under Votes,12,0,5,17
Comal,407,Proposition #5,,DEM,Over Votes,0,0,0,0
Comal,407,Proposition #6,,DEM,Yes,138,26,115,279
Comal,407,Proposition #6,,DEM,No,5,0,5,10
Comal,407,Proposition #6,,DEM,Cast Votes:,143,26,120,289
Comal,407,Proposition #6,,DEM,Under Votes,13,1,6,20
Comal,407,Proposition #6,,DEM,Over Votes,0,0,0,0
Comal,407,Proposition #7,,DEM,Yes,129,27,109,265
Comal,407,Proposition #7,,DEM,No,15,0,9,24
Comal,407,Proposition #7,,DEM,Cast Votes:,144,27,118,289
Comal,407,Proposition #7,,DEM,Under Votes,12,0,8,20
Comal,407,Proposition #7,,DEM,Over Votes,0,0,0,0
Comal,407,Proposition #8,,DEM,Yes,133,28,111,272
Comal,407,Proposition #8,,DEM,No,12,0,9,21
Comal,407,Proposition #8,,DEM,Cast Votes:,145,28,120,293
Comal,407,Proposition #8,,DEM,Under Votes,11,0,6,17
Comal,407,Proposition #8,,DEM,Over Votes,0,0,0,0
Comal,407,Proposition #9,,DEM,Yes,136,28,115,279
Comal,407,Proposition #9,,DEM,No,9,0,3,12
Comal,407,Proposition #9,,DEM,Cast Votes:,145,28,118,291
Comal,407,Proposition #9,,DEM,Under Votes,11,0,8,19
Comal,407,Proposition #9,,DEM,Over Votes,0,0,0,0
Comal,407,Proposition #10,,DEM,Yes,137,28,114,279
Comal,407,Proposition #10,,DEM,No,11,0,6,17
Comal,407,Proposition #10,,DEM,Cast Votes:,148,28,120,296
Comal,407,Proposition #10,,DEM,Under Votes,8,0,6,14
Comal,407,Proposition #10,,DEM,Over Votes,0,0,0,0
Comal,407,Proposition #11,,DEM,Yes,122,27,109,258
Comal,407,Proposition #11,,DEM,No,20,1,11,32
Comal,407,Proposition #11,,DEM,Cast Votes:,142,28,120,290
Comal,407,Proposition #11,,DEM,Under Votes,14,0,6,20
Comal,407,Proposition #11,,DEM,Over Votes,0,0,0,0
Comal,103,President,,DEM,Tulsi Gabbard,1,0,2,3
Comal,103,President,,DEM,Marianne Williamson,0,0,0,0
Comal,103,President,,DEM,John K. Delaney,0,0,0,0
Comal,103,President,,DEM,Elizabeth Warren,23,5,29,57
Comal,103,President,,DEM,Cory Booker,0,0,0,0
Comal,103,President,,DEM,Amy Klobuchar,0,2,12,14
Comal,103,President,,DEM,Joseph R. Biden,73,11,30,114
Comal,103,President,,DEM,Pete Buttigieg,1,1,22,24
Comal,103,President,,DEM,Juli치n Castro,0,0,0,0
Comal,103,President,,DEM,Tom Steyer,0,0,0,0
Comal,103,President,,DEM,Michael Bennet,0,0,0,0
Comal,103,President,,DEM,Michael R. Bloomberg,11,8,18,37
Comal,103,President,,DEM,Robby Wells,0,0,0,0
Comal,103,President,,DEM,"Roque ""Rocky"" De La Fuente",0,0,0,0
Comal,103,President,,DEM,Deval Patrick,0,0,0,0
Comal,103,President,,DEM,Bernie Sanders,41,2,21,64
Comal,103,President,,DEM,Andrew Yang,0,0,0,0
Comal,103,Ballots Cast,,DEM,,150,29,134,313
Comal,103,President,,DEM,Under Votes,2,0,1,3
Comal,103,President,,DEM,Over Votes,0,0,0,0
Comal,103,U.S. Senate,,DEM,Royce West,9,2,4,15
Comal,103,U.S. Senate,,DEM,Chris Bell,14,2,9,25
Comal,103,U.S. Senate,,DEM,Amanda K. Edwards,18,4,11,33
Comal,103,U.S. Senate,,DEM,Sema Hernandez,17,0,14,31
Comal,103,U.S. Senate,,DEM,Jack Daniel Foster Jr,3,0,6,9
Comal,103,U.S. Senate,,DEM,D.R. Hunter,1,0,4,5
Comal,103,U.S. Senate,,DEM,Adrian Ocegueda,2,1,3,6
Comal,103,U.S. Senate,,DEM,"Mary ""MJ"" Hegar",39,11,48,98
Comal,103,U.S. Senate,,DEM,Cristina Tzintzun Ramirez,7,3,11,21
Comal,103,U.S. Senate,,DEM,Michael Cooper,3,1,0,4
Comal,103,U.S. Senate,,DEM,Victor Hugo Harris,2,0,0,2
Comal,103,U.S. Senate,,DEM,"Annie ""Mam치"" Garcia",4,1,1,6
Comal,103,U.S. Senate,,DEM,Cast Votes:,119,25,111,255
Comal,103,U.S. Senate,,DEM,Under Votes,33,4,24,61
Comal,103,U.S. Senate,,DEM,Over Votes,0,0,0,0
Comal,103,U.S. House,21,DEM,Wendy R. Davis,109,24,107,240
Comal,103,U.S. House,21,DEM,Jennie Lou Leeder,18,2,15,35
Comal,103,U.S. House,21,DEM,Cast Votes:,127,26,122,275
Comal,103,U.S. House,21,DEM,Under Votes,25,3,13,41
Comal,103,U.S. House,21,DEM,Over Votes,0,0,0,0
Comal,103,Railroad Commissioner,,DEM,Mark Watson,26,1,22,49
Comal,103,Railroad Commissioner,,DEM,Chrysta Casta침eda,41,10,31,82
Comal,103,Railroad Commissioner,,DEM,Kelly Stone,32,4,29,65
Comal,103,Railroad Commissioner,,DEM,"Roberto R. ""Beto"" Alonzo",14,4,23,41
Comal,103,Railroad Commissioner,,DEM,Cast Votes:,113,19,105,237
Comal,103,Railroad Commissioner,,DEM,Under Votes,39,10,30,79
Comal,103,Railroad Commissioner,,DEM,Over Votes,0,0,0,0
Comal,103,"Chief Justice, Supreme Court",,DEM,Amy Clark Meachum,100,18,97,215
Comal,103,"Chief Justice, Supreme Court",,DEM,Jerry Zimmerer,19,1,10,30
Comal,103,"Chief Justice, Supreme Court",,DEM,Cast Votes:,119,19,107,245
Comal,103,"Chief Justice, Supreme Court",,DEM,Under Votes,33,10,28,71
Comal,103,"Chief Justice, Supreme Court",,DEM,Over Votes,0,0,0,0
Comal,103,"Justice, Supreme Court, Place 6 Unexpired Term",,DEM,Larry Praeger,31,6,27,64
Comal,103,"Justice, Supreme Court, Place 6 Unexpired Term",,DEM,Kathy Cheng,84,13,80,177
Comal,103,"Justice, Supreme Court, Place 6 Unexpired Term",,DEM,Cast Votes:,115,19,107,241
Comal,103,"Justice, Supreme Court, Place 6 Unexpired Term",,DEM,Under Votes,37,10,28,75
Comal,103,"Justice, Supreme Court, Place 6 Unexpired Term",,DEM,Over Votes,0,0,0,0
Comal,103,"Justice, Supreme Court, Place 7",,DEM,Staci Williams,72,10,69,151
Comal,103,"Justice, Supreme Court, Place 7",,DEM,Brandy Voss,40,8,36,84
Comal,103,"Justice, Supreme Court, Place 7",,DEM,Cast Votes:,112,18,105,235
Comal,103,"Justice, Supreme Court, Place 7",,DEM,Under Votes,40,11,30,81
Comal,103,"Justice, Supreme Court, Place 7",,DEM,Over Votes,0,0,0,0
Comal,103,"Justice, Supreme Court, Place 8",,DEM,Peter Kelly,33,6,36,75
Comal,103,"Justice, Supreme Court, Place 8",,DEM,Gisela D. Triana,80,13,71,164
Comal,103,"Justice, Supreme Court, Place 8",,DEM,Cast Votes:,113,19,107,239
Comal,103,"Justice, Supreme Court, Place 8",,DEM,Under Votes,39,10,28,77
Comal,103,"Justice, Supreme Court, Place 8",,DEM,Over Votes,0,0,0,0
Comal,103,"Judge, Court of Criminal Appeals, Place 3",,DEM,Elizabeth Davis Frizell,86,13,77,176
Comal,103,"Judge, Court of Criminal Appeals, Place 3",,DEM,William Pieratt Demond,9,3,7,19
Comal,103,"Judge, Court of Criminal Appeals, Place 3",,DEM,Dan Wood,15,3,23,41
Comal,103,"Judge, Court of Criminal Appeals, Place 3",,DEM,Cast Votes:,110,19,107,236
Comal,103,"Judge, Court of Criminal Appeals, Place 3",,DEM,Under Votes,42,10,28,80
Comal,103,"Judge, Court of Criminal Appeals, Place 3",,DEM,Over Votes,0,0,0,0
Comal,103,"Judge, Court of Criminal Appeals, Place 4",,DEM,Tina Clinton,88,17,84,189
Comal,103,"Judge, Court of Criminal Appeals, Place 4",,DEM,Steven Miears,25,2,24,51
Comal,103,"Judge, Court of Criminal Appeals, Place 4",,DEM,Cast Votes:,113,19,108,240
Comal,103,"Judge, Court of Criminal Appeals, Place 4",,DEM,Under Votes,39,10,27,76
Comal,103,"Judge, Court of Criminal Appeals, Place 4",,DEM,Over Votes,0,0,0,0
Comal,103,"Judge, Court of Criminal Appeals, Place 9",,DEM,Brandon Birmingham,100,17,90,207
Comal,103,"Judge, Court of Criminal Appeals, Place 9",,DEM,Cast Votes:,100,17,90,207
Comal,103,"Judge, Court of Criminal Appeals, Place 9",,DEM,Under Votes,52,12,45,109
Comal,103,"Judge, Court of Criminal Appeals, Place 9",,DEM,Over Votes,0,0,0,0
Comal,103,"Member, State Board of Education, District 5",,DEM,Rebecca Bell-Metereau,63,14,68,145
Comal,103,"Member, State Board of Education, District 5",,DEM,Letti Bresnahan,43,4,38,85
Comal,103,"Member, State Board of Education, District 5",,DEM,Cast Votes:,106,18,106,230
Comal,103,"Member, State Board of Education, District 5",,DEM,Under Votes,46,11,29,86
Comal,103,"Member, State Board of Education, District 5",,DEM,Over Votes,0,0,0,0
Comal,103,State Representative,73,DEM,Stephanie Phillips,108,18,98,224
Comal,103,State Representative,73,DEM,Cast Votes:,108,18,98,224
Comal,103,State Representative,73,DEM,Under Votes,44,11,37,92
Comal,103,State Representative,73,DEM,Over Votes,0,0,0,0
Comal,103,"Chief Justice, 3rd Court of Appeals District",,DEM,Darlene Byrne,92,15,78,185
Comal,103,"Chief Justice, 3rd Court of Appeals District",,DEM,Keith S. Hampton,19,4,25,48
Comal,103,"Chief Justice, 3rd Court of Appeals District",,DEM,Cast Votes:,111,19,103,233
Comal,103,"Chief Justice, 3rd Court of Appeals District",,DEM,Under Votes,41,10,32,83
Comal,103,"Chief Justice, 3rd Court of Appeals District",,DEM,Over Votes,0,0,0,0
Comal,103,"County Commissioner, Precinct 1",,DEM,Lindsay Poisel,110,18,96,224
Comal,103,"County Commissioner, Precinct 1",,DEM,Cast Votes:,110,18,96,224
Comal,103,"County Commissioner, Precinct 1",,DEM,Under Votes,42,11,39,92
Comal,103,"County Commissioner, Precinct 1",,DEM,Over Votes,0,0,0,0
Comal,103,County Chairman,,DEM,Gloria Meehan,112,18,97,227
Comal,103,County Chairman,,DEM,Cast Votes:,112,18,97,227
Comal,103,County Chairman,,DEM,Under Votes,40,11,38,89
Comal,103,County Chairman,,DEM,Over Votes,0,0,0,0
Comal,103,Proposition #1,,DEM,Yes,132,22,121,275
Comal,103,Proposition #1,,DEM,No,12,2,11,25
Comal,103,Proposition #1,,DEM,Cast Votes:,144,24,132,300
Comal,103,Proposition #1,,DEM,Under Votes,8,5,3,16
Comal,103,Proposition #1,,DEM,Over Votes,0,0,0,0
Comal,103,Proposition #2,,DEM,Yes,134,25,118,277
Comal,103,Proposition #2,,DEM,No,12,0,13,25
Comal,103,Proposition #2,,DEM,Cast Votes:,146,25,131,302
Comal,103,Proposition #2,,DEM,Under Votes,6,4,4,14
Comal,103,Proposition #2,,DEM,Over Votes,0,0,0,0
Comal,103,Proposition #3,,DEM,Yes,140,25,129,294
Comal,103,Proposition #3,,DEM,No,6,0,2,8
Comal,103,Proposition #3,,DEM,Cast Votes:,146,25,131,302
Comal,103,Proposition #3,,DEM,Under Votes,6,4,4,14
Comal,103,Proposition #3,,DEM,Over Votes,0,0,0,0
Comal,103,Proposition #4,,DEM,Yes,126,24,115,265
Comal,103,Proposition #4,,DEM,No,17,0,14,31
Comal,103,Proposition #4,,DEM,Cast Votes:,143,24,129,296
Comal,103,Proposition #4,,DEM,Under Votes,9,5,6,20
Comal,103,Proposition #4,,DEM,Over Votes,0,0,0,0
Comal,103,Proposition #5,,DEM,Yes,135,25,125,285
Comal,103,Proposition #5,,DEM,No,7,0,6,13
Comal,103,Proposition #5,,DEM,Cast Votes:,142,25,131,298
Comal,103,Proposition #5,,DEM,Under Votes,10,4,4,18
Comal,103,Proposition #5,,DEM,Over Votes,0,0,0,0
Comal,103,Proposition #6,,DEM,Yes,134,24,125,283
Comal,103,Proposition #6,,DEM,No,9,0,5,14
Comal,103,Proposition #6,,DEM,Cast Votes:,143,24,130,297
Comal,103,Proposition #6,,DEM,Under Votes,9,5,5,19
Comal,103,Proposition #6,,DEM,Over Votes,0,0,0,0
Comal,103,Proposition #7,,DEM,Yes,136,22,117,275
Comal,103,Proposition #7,,DEM,No,11,0,14,25
Comal,103,Proposition #7,,DEM,Cast Votes:,147,22,131,300
Comal,103,Proposition #7,,DEM,Under Votes,5,7,4,16
Comal,103,Proposition #7,,DEM,Over Votes,0,0,0,0
Comal,103,Proposition #8,,DEM,Yes,135,26,122,283
Comal,103,Proposition #8,,DEM,No,10,0,9,19
Comal,103,Proposition #8,,DEM,Cast Votes:,145,26,131,302
Comal,103,Proposition #8,,DEM,Under Votes,7,3,4,14
Comal,103,Proposition #8,,DEM,Over Votes,0,0,0,0
Comal,103,Proposition #9,,DEM,Yes,137,26,124,287
Comal,103,Proposition #9,,DEM,No,6,0,6,12
Comal,103,Proposition #9,,DEM,Cast Votes:,143,26,130,299
Comal,103,Proposition #9,,DEM,Under Votes,9,3,5,17
Comal,103,Proposition #9,,DEM,Over Votes,0,0,0,0
Comal,103,Proposition #10,,DEM,Yes,132,26,125,283
Comal,103,Proposition #10,,DEM,No,10,0,7,17
Comal,103,Proposition #10,,DEM,Cast Votes:,142,26,132,300
Comal,103,Proposition #10,,DEM,Under Votes,10,3,3,16
Comal,103,Proposition #10,,DEM,Over Votes,0,0,0,0
Comal,103,Proposition #11,,DEM,Yes,119,23,121,263
Comal,103,Proposition #11,,DEM,No,18,1,11,30
Comal,103,Proposition #11,,DEM,Cast Votes:,137,24,132,293
Comal,103,Proposition #11,,DEM,Under Votes,15,5,3,23
Comal,103,Proposition #11,,DEM,Over Votes,0,0,0,0
Comal,104,President,,DEM,Tulsi Gabbard,0,0,0,0
Comal,104,President,,DEM,Marianne Williamson,0,0,0,0
Comal,104,President,,DEM,John K. Delaney,0,0,1,1
Comal,104,President,,DEM,Elizabeth Warren,10,1,11,22
Comal,104,President,,DEM,Cory Booker,0,0,0,0
Comal,104,President,,DEM,Amy Klobuchar,0,8,5,13
Comal,104,President,,DEM,Joseph R. Biden,51,7,12,70
Comal,104,President,,DEM,Pete Buttigieg,0,1,21,22
Comal,104,President,,DEM,Juli치n Castro,1,0,0,1
Comal,104,President,,DEM,Tom Steyer,0,3,0,3
Comal,104,President,,DEM,Michael Bennet,0,0,0,0
Comal,104,President,,DEM,Michael R. Bloomberg,13,8,11,32
Comal,104,President,,DEM,Robby Wells,0,0,0,0
Comal,104,President,,DEM,"Roque ""Rocky"" De La Fuente",0,0,0,0
Comal,104,President,,DEM,Deval Patrick,0,0,0,0
Comal,104,President,,DEM,Bernie Sanders,9,5,22,36
Comal,104,President,,DEM,Andrew Yang,2,0,0,2
Comal,104,Ballots Cast,,DEM,,86,33,83,202
Comal,104,President,,DEM,Under Votes,0,0,0,0
Comal,104,President,,DEM,Over Votes,0,0,0,0
Comal,104,U.S. Senate,,DEM,Royce West,6,1,5,12
Comal,104,U.S. Senate,,DEM,Chris Bell,4,4,12,20
Comal,104,U.S. Senate,,DEM,Amanda K. Edwards,11,2,10,23
Comal,104,U.S. Senate,,DEM,Sema Hernandez,9,0,4,13
Comal,104,U.S. Senate,,DEM,Jack Daniel Foster Jr,4,0,0,4
Comal,104,U.S. Senate,,DEM,D.R. Hunter,4,0,1,5
Comal,104,U.S. Senate,,DEM,Adrian Ocegueda,3,0,0,3
Comal,104,U.S. Senate,,DEM,"Mary ""MJ"" Hegar",23,15,36,74
Comal,104,U.S. Senate,,DEM,Cristina Tzintzun Ramirez,2,7,3,12
Comal,104,U.S. Senate,,DEM,Michael Cooper,2,0,0,2
Comal,104,U.S. Senate,,DEM,Victor Hugo Harris,1,0,1,2
Comal,104,U.S. Senate,,DEM,"Annie ""Mam치"" Garcia",4,2,4,10
Comal,104,U.S. Senate,,DEM,Cast Votes:,73,31,76,180
Comal,104,U.S. Senate,,DEM,Under Votes,13,2,7,22
Comal,104,U.S. Senate,,DEM,Over Votes,0,0,0,0
Comal,104,U.S. House,21,DEM,Wendy R. Davis,66,27,61,154
Comal,104,U.S. House,21,DEM,Jennie Lou Leeder,8,3,17,28
Comal,104,U.S. House,21,DEM,Cast Votes:,74,30,78,182
Comal,104,U.S. House,21,DEM,Under Votes,12,3,5,20
Comal,104,U.S. House,21,DEM,Over Votes,0,0,0,0
Comal,104,Railroad Commissioner,,DEM,Mark Watson,21,7,10,38
Comal,104,Railroad Commissioner,,DEM,Chrysta Casta침eda,14,16,35,65
Comal,104,Railroad Commissioner,,DEM,Kelly Stone,21,4,18,43
Comal,104,Railroad Commissioner,,DEM,"Roberto R. ""Beto"" Alonzo",17,2,9,28
Comal,104,Railroad Commissioner,,DEM,Cast Votes:,73,29,72,174
Comal,104,Railroad Commissioner,,DEM,Under Votes,13,4,11,28
Comal,104,Railroad Commissioner,,DEM,Over Votes,0,0,0,0
Comal,104,"Chief Justice, Supreme Court",,DEM,Amy Clark Meachum,68,24,64,156
Comal,104,"Chief Justice, Supreme Court",,DEM,Jerry Zimmerer,6,5,8,19
Comal,104,"Chief Justice, Supreme Court",,DEM,Cast Votes:,74,29,72,175
Comal,104,"Chief Justice, Supreme Court",,DEM,Under Votes,12,4,11,27
Comal,104,"Chief Justice, Supreme Court",,DEM,Over Votes,0,0,0,0
Comal,104,"Justice, Supreme Court, Place 6 Unexpired Term",,DEM,Larry Praeger,19,10,12,41
Comal,104,"Justice, Supreme Court, Place 6 Unexpired Term",,DEM,Kathy Cheng,54,19,57,130
Comal,104,"Justice, Supreme Court, Place 6 Unexpired Term",,DEM,Cast Votes:,73,29,69,171
Comal,104,"Justice, Supreme Court, Place 6 Unexpired Term",,DEM,Under Votes,13,4,14,31
Comal,104,"Justice, Supreme Court, Place 6 Unexpired Term",,DEM,Over Votes,0,0,0,0
Comal,104,"Justice, Supreme Court, Place 7",,DEM,Staci Williams,40,13,32,85
Comal,104,"Justice, Supreme Court, Place 7",,DEM,Brandy Voss,31,15,36,82
Comal,104,"Justice, Supreme Court, Place 7",,DEM,Cast Votes:,71,28,68,167
Comal,104,"Justice, Supreme Court, Place 7",,DEM,Under Votes,15,5,15,35
Comal,104,"Justice, Supreme Court, Place 7",,DEM,Over Votes,0,0,0,0
Comal,104,"Justice, Supreme Court, Place 8",,DEM,Peter Kelly,21,9,11,41
Comal,104,"Justice, Supreme Court, Place 8",,DEM,Gisela D. Triana,51,20,56,127
Comal,104,"Justice, Supreme Court, Place 8",,DEM,Cast Votes:,72,29,67,168
Comal,104,"Justice, Supreme Court, Place 8",,DEM,Under Votes,14,4,16,34
Comal,104,"Justice, Supreme Court, Place 8",,DEM,Over Votes,0,0,0,0
Comal,104,"Judge, Court of Criminal Appeals, Place 3",,DEM,Elizabeth Davis Frizell,51,18,49,118
Comal,104,"Judge, Court of Criminal Appeals, Place 3",,DEM,William Pieratt Demond,9,6,9,24
Comal,104,"Judge, Court of Criminal Appeals, Place 3",,DEM,Dan Wood,11,5,8,24
Comal,104,"Judge, Court of Criminal Appeals, Place 3",,DEM,Cast Votes:,71,29,66,166
Comal,104,"Judge, Court of Criminal Appeals, Place 3",,DEM,Under Votes,15,4,17,36
Comal,104,"Judge, Court of Criminal Appeals, Place 3",,DEM,Over Votes,0,0,0,0
Comal,104,"Judge, Court of Criminal Appeals, Place 4",,DEM,Tina Clinton,57,20,53,130
Comal,104,"Judge, Court of Criminal Appeals, Place 4",,DEM,Steven Miears,14,9,13,36
Comal,104,"Judge, Court of Criminal Appeals, Place 4",,DEM,Cast Votes:,71,29,66,166
Comal,104,"Judge, Court of Criminal Appeals, Place 4",,DEM,Under Votes,15,4,17,36
Comal,104,"Judge, Court of Criminal Appeals, Place 4",,DEM,Over Votes,0,0,0,0
Comal,104,"Judge, Court of Criminal Appeals, Place 9",,DEM,Brandon Birmingham,65,24,57,146
Comal,104,"Judge, Court of Criminal Appeals, Place 9",,DEM,Cast Votes:,65,24,57,146
Comal,104,"Judge, Court of Criminal Appeals, Place 9",,DEM,Under Votes,21,9,26,56
Comal,104,"Judge, Court of Criminal Appeals, Place 9",,DEM,Over Votes,0,0,0,0
Comal,104,"Member, State Board of Education, District 5",,DEM,Rebecca Bell-Metereau,52,20,42,114
Comal,104,"Member, State Board of Education, District 5",,DEM,Letti Bresnahan,18,10,26,54
Comal,104,"Member, State Board of Education, District 5",,DEM,Cast Votes:,70,30,68,168
Comal,104,"Member, State Board of Education, District 5",,DEM,Under Votes,16,3,15,34
Comal,104,"Member, State Board of Education, District 5",,DEM,Over Votes,0,0,0,0
Comal,104,State Representative,73,DEM,Stephanie Phillips,64,24,67,155
Comal,104,State Representative,73,DEM,Cast Votes:,64,24,67,155
Comal,104,State Representative,73,DEM,Under Votes,22,9,16,47
Comal,104,State Representative,73,DEM,Over Votes,0,0,0,0
Comal,104,"Chief Justice, 3rd Court of Appeals District",,DEM,Darlene Byrne,57,21,49,127
Comal,104,"Chief Justice, 3rd Court of Appeals District",,DEM,Keith S. Hampton,13,8,19,40
Comal,104,"Chief Justice, 3rd Court of Appeals District",,DEM,Cast Votes:,70,29,68,167
Comal,104,"Chief Justice, 3rd Court of Appeals District",,DEM,Under Votes,16,4,15,35
Comal,104,"Chief Justice, 3rd Court of Appeals District",,DEM,Over Votes,0,0,0,0
Comal,104,"County Commissioner, Precinct 1",,DEM,Lindsay Poisel,67,25,66,158
Comal,104,"County Commissioner, Precinct 1",,DEM,Cast Votes:,67,25,66,158
Comal,104,"County Commissioner, Precinct 1",,DEM,Under Votes,19,8,17,44
Comal,104,"County Commissioner, Precinct 1",,DEM,Over Votes,0,0,0,0
Comal,104,County Chairman,,DEM,Gloria Meehan,67,25,62,154
Comal,104,County Chairman,,DEM,Cast Votes:,67,25,62,154
Comal,104,County Chairman,,DEM,Under Votes,19,8,21,48
Comal,104,County Chairman,,DEM,Over Votes,0,0,0,0
Comal,104,Proposition #1,,DEM,Yes,76,31,70,177
Comal,104,Proposition #1,,DEM,No,8,0,6,14
Comal,104,Proposition #1,,DEM,Cast Votes:,84,31,76,191
Comal,104,Proposition #1,,DEM,Under Votes,2,2,7,11
Comal,104,Proposition #1,,DEM,Over Votes,0,0,0,0
Comal,104,Proposition #2,,DEM,Yes,77,30,71,178
Comal,104,Proposition #2,,DEM,No,7,0,5,12
Comal,104,Proposition #2,,DEM,Cast Votes:,84,30,76,190
Comal,104,Proposition #2,,DEM,Under Votes,2,3,7,12
Comal,104,Proposition #2,,DEM,Over Votes,0,0,0,0
Comal,104,Proposition #3,,DEM,Yes,80,31,70,181
Comal,104,Proposition #3,,DEM,No,4,0,3,7
Comal,104,Proposition #3,,DEM,Cast Votes:,84,31,73,188
Comal,104,Proposition #3,,DEM,Under Votes,2,2,10,14
Comal,104,Proposition #3,,DEM,Over Votes,0,0,0,0
Comal,104,Proposition #4,,DEM,Yes,75,31,68,174
Comal,104,Proposition #4,,DEM,No,6,0,8,14
Comal,104,Proposition #4,,DEM,Cast Votes:,81,31,76,188
Comal,104,Proposition #4,,DEM,Under Votes,5,2,7,14
Comal,104,Proposition #4,,DEM,Over Votes,0,0,0,0
Comal,104,Proposition #5,,DEM,Yes,79,31,70,180
Comal,104,Proposition #5,,DEM,No,5,0,4,9
Comal,104,Proposition #5,,DEM,Cast Votes:,84,31,74,189
Comal,104,Proposition #5,,DEM,Under Votes,2,2,9,13
Comal,104,Proposition #5,,DEM,Over Votes,0,0,0,0
Comal,104,Proposition #6,,DEM,Yes,79,31,67,177
Comal,104,Proposition #6,,DEM,No,4,0,6,10
Comal,104,Proposition #6,,DEM,Cast Votes:,83,31,73,187
Comal,104,Proposition #6,,DEM,Under Votes,3,2,10,15
Comal,104,Proposition #6,,DEM,Over Votes,0,0,0,0
Comal,104,Proposition #7,,DEM,Yes,77,31,69,177
Comal,104,Proposition #7,,DEM,No,7,0,5,12
Comal,104,Proposition #7,,DEM,Cast Votes:,84,31,74,189
Comal,104,Proposition #7,,DEM,Under Votes,2,2,9,13
Comal,104,Proposition #7,,DEM,Over Votes,0,0,0,0
Comal,104,Proposition #8,,DEM,Yes,78,32,73,183
Comal,104,Proposition #8,,DEM,No,6,0,3,9
Comal,104,Proposition #8,,DEM,Cast Votes:,84,32,76,192
Comal,104,Proposition #8,,DEM,Under Votes,2,1,7,10
Comal,104,Proposition #8,,DEM,Over Votes,0,0,0,0
Comal,104,Proposition #9,,DEM,Yes,81,32,74,187
Comal,104,Proposition #9,,DEM,No,3,0,1,4
Comal,104,Proposition #9,,DEM,Cast Votes:,84,32,75,191
Comal,104,Proposition #9,,DEM,Under Votes,2,1,8,11
Comal,104,Proposition #9,,DEM,Over Votes,0,0,0,0
Comal,104,Proposition #10,,DEM,Yes,77,32,72,181
Comal,104,Proposition #10,,DEM,No,7,0,4,11
Comal,104,Proposition #10,,DEM,Cast Votes:,84,32,76,192
Comal,104,Proposition #10,,DEM,Under Votes,2,1,7,10
Comal,104,Proposition #10,,DEM,Over Votes,0,0,0,0
Comal,104,Proposition #11,,DEM,Yes,74,28,67,169
Comal,104,Proposition #11,,DEM,No,8,3,9,20
Comal,104,Proposition #11,,DEM,Cast Votes:,82,31,76,189
Comal,104,Proposition #11,,DEM,Under Votes,4,2,7,13
Comal,104,Proposition #11,,DEM,Over Votes,0,0,0,0
Comal,105,President,,DEM,Tulsi Gabbard,2,0,0,2
Comal,105,President,,DEM,Marianne Williamson,0,0,0,0
Comal,105,President,,DEM,John K. Delaney,0,0,0,0
Comal,105,President,,DEM,Elizabeth Warren,10,5,20,35
Comal,105,President,,DEM,Cory Booker,0,0,0,0
Comal,105,President,,DEM,Amy Klobuchar,0,1,13,14
Comal,105,President,,DEM,Joseph R. Biden,76,10,22,108
Comal,105,President,,DEM,Pete Buttigieg,0,1,19,20
Comal,105,President,,DEM,Juli치n Castro,0,0,0,0
Comal,105,President,,DEM,Tom Steyer,0,1,3,4
Comal,105,President,,DEM,Michael Bennet,0,0,0,0
Comal,105,President,,DEM,Michael R. Bloomberg,9,6,26,41
Comal,105,President,,DEM,Robby Wells,0,0,0,0
Comal,105,President,,DEM,"Roque ""Rocky"" De La Fuente",0,0,1,1
Comal,105,President,,DEM,Deval Patrick,0,0,0,0
Comal,105,President,,DEM,Bernie Sanders,49,2,32,83
Comal,105,President,,DEM,Andrew Yang,0,1,0,1
Comal,105,Ballots Cast,,DEM,,146,27,136,309
Comal,105,President,,DEM,Under Votes,0,2,0,2
Comal,105,President,,DEM,Over Votes,0,0,0,0
Comal,105,U.S. Senate,,DEM,Royce West,8,5,6,19
Comal,105,U.S. Senate,,DEM,Chris Bell,9,2,12,23
Comal,105,U.S. Senate,,DEM,Amanda K. Edwards,11,3,18,32
Comal,105,U.S. Senate,,DEM,Sema Hernandez,9,0,3,12
Comal,105,U.S. Senate,,DEM,Jack Daniel Foster Jr,4,0,3,7
Comal,105,U.S. Senate,,DEM,D.R. Hunter,3,1,1,5
Comal,105,U.S. Senate,,DEM,Adrian Ocegueda,2,0,2,4
Comal,105,U.S. Senate,,DEM,"Mary ""MJ"" Hegar",51,14,57,122
Comal,105,U.S. Senate,,DEM,Cristina Tzintzun Ramirez,10,0,12,22
Comal,105,U.S. Senate,,DEM,Michael Cooper,2,0,0,2
Comal,105,U.S. Senate,,DEM,Victor Hugo Harris,4,2,0,6
Comal,105,U.S. Senate,,DEM,"Annie ""Mam치"" Garcia",7,2,7,16
Comal,105,U.S. Senate,,DEM,Cast Votes:,120,29,121,270
Comal,105,U.S. Senate,,DEM,Under Votes,26,0,15,41
Comal,105,U.S. Senate,,DEM,Over Votes,0,0,0,0
Comal,105,U.S. House,21,DEM,Wendy R. Davis,107,23,106,236
Comal,105,U.S. House,21,DEM,Jennie Lou Leeder,20,6,19,45
Comal,105,U.S. House,21,DEM,Cast Votes:,127,29,125,281
Comal,105,U.S. House,21,DEM,Under Votes,19,0,11,30
Comal,105,U.S. House,21,DEM,Over Votes,0,0,0,0
Comal,105,Railroad Commissioner,,DEM,Mark Watson,22,4,24,50
Comal,105,Railroad Commissioner,,DEM,Chrysta Casta침eda,37,7,34,78
Comal,105,Railroad Commissioner,,DEM,Kelly Stone,25,12,38,75
Comal,105,Railroad Commissioner,,DEM,"Roberto R. ""Beto"" Alonzo",27,4,22,53
Comal,105,Railroad Commissioner,,DEM,Cast Votes:,111,27,118,256
Comal,105,Railroad Commissioner,,DEM,Under Votes,35,2,18,55
Comal,105,Railroad Commissioner,,DEM,Over Votes,0,0,0,0
Comal,105,"Chief Justice, Supreme Court",,DEM,Amy Clark Meachum,97,24,103,224
Comal,105,"Chief Justice, Supreme Court",,DEM,Jerry Zimmerer,19,3,17,39
Comal,105,"Chief Justice, Supreme Court",,DEM,Cast Votes:,116,27,120,263
Comal,105,"Chief Justice, Supreme Court",,DEM,Under Votes,30,2,16,48
Comal,105,"Chief Justice, Supreme Court",,DEM,Over Votes,0,0,0,0
Comal,105,"Justice, Supreme Court, Place 6 Unexpired Term",,DEM,Larry Praeger,25,9,24,58
Comal,105,"Justice, Supreme Court, Place 6 Unexpired Term",,DEM,Kathy Cheng,87,18,97,202
Comal,105,"Justice, Supreme Court, Place 6 Unexpired Term",,DEM,Cast Votes:,112,27,121,260
Comal,105,"Justice, Supreme Court, Place 6 Unexpired Term",,DEM,Under Votes,34,2,15,51
Comal,105,"Justice, Supreme Court, Place 6 Unexpired Term",,DEM,Over Votes,0,0,0,0
Comal,105,"Justice, Supreme Court, Place 7",,DEM,Staci Williams,68,19,63,150
Comal,105,"Justice, Supreme Court, Place 7",,DEM,Brandy Voss,39,8,55,102
Comal,105,"Justice, Supreme Court, Place 7",,DEM,Cast Votes:,107,27,118,252
Comal,105,"Justice, Supreme Court, Place 7",,DEM,Under Votes,39,2,18,59
Comal,105,"Justice, Supreme Court, Place 7",,DEM,Over Votes,0,0,0,0
Comal,105,"Justice, Supreme Court, Place 8",,DEM,Peter Kelly,35,8,28,71
Comal,105,"Justice, Supreme Court, Place 8",,DEM,Gisela D. Triana,76,19,89,184
Comal,105,"Justice, Supreme Court, Place 8",,DEM,Cast Votes:,111,27,117,255
Comal,105,"Justice, Supreme Court, Place 8",,DEM,Under Votes,35,2,19,56
Comal,105,"Justice, Supreme Court, Place 8",,DEM,Over Votes,0,0,0,0
Comal,105,"Judge, Court of Criminal Appeals, Place 3",,DEM,Elizabeth Davis Frizell,85,22,97,204
Comal,105,"Judge, Court of Criminal Appeals, Place 3",,DEM,William Pieratt Demond,8,1,8,17
Comal,105,"Judge, Court of Criminal Appeals, Place 3",,DEM,Dan Wood,18,4,15,37
Comal,105,"Judge, Court of Criminal Appeals, Place 3",,DEM,Cast Votes:,111,27,120,258
Comal,105,"Judge, Court of Criminal Appeals, Place 3",,DEM,Under Votes,35,2,16,53
Comal,105,"Judge, Court of Criminal Appeals, Place 3",,DEM,Over Votes,0,0,0,0
Comal,105,"Judge, Court of Criminal Appeals, Place 4",,DEM,Tina Clinton,89,19,100,208
Comal,105,"Judge, Court of Criminal Appeals, Place 4",,DEM,Steven Miears,20,8,17,45
Comal,105,"Judge, Court of Criminal Appeals, Place 4",,DEM,Cast Votes:,109,27,117,253
Comal,105,"Judge, Court of Criminal Appeals, Place 4",,DEM,Under Votes,37,2,19,58
Comal,105,"Judge, Court of Criminal Appeals, Place 4",,DEM,Over Votes,0,0,0,0
Comal,105,"Judge, Court of Criminal Appeals, Place 9",,DEM,Brandon Birmingham,98,28,107,233
Comal,105,"Judge, Court of Criminal Appeals, Place 9",,DEM,Cast Votes:,98,28,107,233
Comal,105,"Judge, Court of Criminal Appeals, Place 9",,DEM,Under Votes,48,1,29,78
Comal,105,"Judge, Court of Criminal Appeals, Place 9",,DEM,Over Votes,0,0,0,0
Comal,105,"Member, State Board of Education, District 5",,DEM,Rebecca Bell-Metereau,72,15,82,169
Comal,105,"Member, State Board of Education, District 5",,DEM,Letti Bresnahan,37,11,33,81
Comal,105,"Member, State Board of Education, District 5",,DEM,Cast Votes:,109,26,115,250
Comal,105,"Member, State Board of Education, District 5",,DEM,Under Votes,37,3,21,61
Comal,105,"Member, State Board of Education, District 5",,DEM,Over Votes,0,0,0,0
Comal,105,State Representative,73,DEM,Stephanie Phillips,106,28,111,245
Comal,105,State Representative,73,DEM,Cast Votes:,106,28,111,245
Comal,105,State Representative,73,DEM,Under Votes,40,1,25,66
Comal,105,State Representative,73,DEM,Over Votes,0,0,0,0
Comal,105,"Chief Justice, 3rd Court of Appeals District",,DEM,Darlene Byrne,81,24,97,202
Comal,105,"Chief Justice, 3rd Court of Appeals District",,DEM,Keith S. Hampton,27,3,19,49
Comal,105,"Chief Justice, 3rd Court of Appeals District",,DEM,Cast Votes:,108,27,116,251
Comal,105,"Chief Justice, 3rd Court of Appeals District",,DEM,Under Votes,38,2,20,60
Comal,105,"Chief Justice, 3rd Court of Appeals District",,DEM,Over Votes,0,0,0,0
Comal,105,"County Commissioner, Precinct 1",,DEM,Lindsay Poisel,106,28,117,251
Comal,105,"County Commissioner, Precinct 1",,DEM,Cast Votes:,106,28,117,251
Comal,105,"County Commissioner, Precinct 1",,DEM,Under Votes,40,1,19,60
Comal,105,"County Commissioner, Precinct 1",,DEM,Over Votes,0,0,0,0
Comal,105,County Chairman,,DEM,Gloria Meehan,106,28,117,251
Comal,105,County Chairman,,DEM,Cast Votes:,106,28,117,251
Comal,105,County Chairman,,DEM,Under Votes,40,1,19,60
Comal,105,County Chairman,,DEM,Over Votes,0,0,0,0
Comal,105,Proposition #1,,DEM,Yes,125,26,120,271
Comal,105,Proposition #1,,DEM,No,10,0,12,22
Comal,105,Proposition #1,,DEM,Cast Votes:,135,26,132,293
Comal,105,Proposition #1,,DEM,Under Votes,11,3,4,18
Comal,105,Proposition #1,,DEM,Over Votes,0,0,0,0
Comal,105,Proposition #2,,DEM,Yes,121,26,116,263
Comal,105,Proposition #2,,DEM,No,14,0,15,29
Comal,105,Proposition #2,,DEM,Cast Votes:,135,26,131,292
Comal,105,Proposition #2,,DEM,Under Votes,11,3,5,19
Comal,105,Proposition #2,,DEM,Over Votes,0,0,0,0
Comal,105,Proposition #3,,DEM,Yes,126,26,129,281
Comal,105,Proposition #3,,DEM,No,8,0,2,10
Comal,105,Proposition #3,,DEM,Cast Votes:,134,26,131,291
Comal,105,Proposition #3,,DEM,Under Votes,12,3,5,20
Comal,105,Proposition #3,,DEM,Over Votes,0,0,0,0
Comal,105,Proposition #4,,DEM,Yes,122,26,121,269
Comal,105,Proposition #4,,DEM,No,12,0,11,23
Comal,105,Proposition #4,,DEM,Cast Votes:,134,26,132,292
Comal,105,Proposition #4,,DEM,Under Votes,12,3,4,19
Comal,105,Proposition #4,,DEM,Over Votes,0,0,0,0
Comal,105,Proposition #5,,DEM,Yes,132,26,132,290
Comal,105,Proposition #5,,DEM,No,3,0,0,3
Comal,105,Proposition #5,,DEM,Cast Votes:,135,26,132,293
Comal,105,Proposition #5,,DEM,Under Votes,11,3,4,18
Comal,105,Proposition #5,,DEM,Over Votes,0,0,0,0
Comal,105,Proposition #6,,DEM,Yes,129,26,127,282
Comal,105,Proposition #6,,DEM,No,4,0,4,8
Comal,105,Proposition #6,,DEM,Cast Votes:,133,26,131,290
Comal,105,Proposition #6,,DEM,Under Votes,13,3,5,21
Comal,105,Proposition #6,,DEM,Over Votes,0,0,0,0
Comal,105,Proposition #7,,DEM,Yes,121,25,123,269
Comal,105,Proposition #7,,DEM,No,12,0,7,19
Comal,105,Proposition #7,,DEM,Cast Votes:,133,25,130,288
Comal,105,Proposition #7,,DEM,Under Votes,13,4,6,23
Comal,105,Proposition #7,,DEM,Over Votes,0,0,0,0
Comal,105,Proposition #8,,DEM,Yes,130,28,122,280
Comal,105,Proposition #8,,DEM,No,6,0,8,14
Comal,105,Proposition #8,,DEM,Cast Votes:,136,28,130,294
Comal,105,Proposition #8,,DEM,Under Votes,10,1,5,16
Comal,105,Proposition #8,,DEM,Over Votes,0,0,0,0
Comal,105,Proposition #9,,DEM,Yes,124,28,126,278
Comal,105,Proposition #9,,DEM,No,8,0,3,11
Comal,105,Proposition #9,,DEM,Cast Votes:,132,28,129,289
Comal,105,Proposition #9,,DEM,Under Votes,14,1,6,21
Comal,105,Proposition #9,,DEM,Over Votes,0,0,0,0
Comal,105,Proposition #10,,DEM,Yes,120,28,116,264
Comal,105,Proposition #10,,DEM,No,14,0,13,27
Comal,105,Proposition #10,,DEM,Cast Votes:,134,28,129,291
Comal,105,Proposition #10,,DEM,Under Votes,12,1,6,19
Comal,105,Proposition #10,,DEM,Over Votes,0,0,0,0
Comal,105,Proposition #11,,DEM,Yes,118,28,117,263
Comal,105,Proposition #11,,DEM,No,15,0,12,27
Comal,105,Proposition #11,,DEM,Cast Votes:,133,28,129,290
Comal,105,Proposition #11,,DEM,Under Votes,13,1,6,20
Comal,105,Proposition #11,,DEM,Over Votes,0,0,0,0
Comal,106,President,,DEM,Tulsi Gabbard,0,0,1,1
Comal,106,President,,DEM,Marianne Williamson,0,0,0,0
Comal,106,President,,DEM,John K. Delaney,0,0,1,1
Comal,106,President,,DEM,Elizabeth Warren,17,0,23,40
Comal,106,President,,DEM,Cory Booker,0,0,0,0
Comal,106,President,,DEM,Amy Klobuchar,1,3,12,16
Comal,106,President,,DEM,Joseph R. Biden,87,13,51,151
Comal,106,President,,DEM,Pete Buttigieg,1,9,35,45
Comal,106,President,,DEM,Juli치n Castro,1,0,0,1
Comal,106,President,,DEM,Tom Steyer,0,0,1,1
Comal,106,President,,DEM,Michael Bennet,0,0,0,0
Comal,106,President,,DEM,Michael R. Bloomberg,16,12,30,58
Comal,106,President,,DEM,Robby Wells,0,0,1,1
Comal,106,President,,DEM,"Roque ""Rocky"" De La Fuente",0,0,0,0
Comal,106,President,,DEM,Deval Patrick,0,0,0,0
Comal,106,President,,DEM,Bernie Sanders,33,1,36,70
Comal,106,President,,DEM,Andrew Yang,0,0,0,0
Comal,106,Ballots Cast,,DEM,,156,38,191,385
Comal,106,President,,DEM,Under Votes,0,0,1,1
Comal,106,President,,DEM,Over Votes,0,0,0,0
Comal,106,U.S. Senate,,DEM,Royce West,13,1,10,24
Comal,106,U.S. Senate,,DEM,Chris Bell,8,6,16,30
Comal,106,U.S. Senate,,DEM,Amanda K. Edwards,19,6,27,52
Comal,106,U.S. Senate,,DEM,Sema Hernandez,15,2,14,31
Comal,106,U.S. Senate,,DEM,Jack Daniel Foster Jr,2,0,5,7
Comal,106,U.S. Senate,,DEM,D.R. Hunter,3,0,3,6
Comal,106,U.S. Senate,,DEM,Adrian Ocegueda,2,0,4,6
Comal,106,U.S. Senate,,DEM,"Mary ""MJ"" Hegar",37,11,68,116
Comal,106,U.S. Senate,,DEM,Cristina Tzintzun Ramirez,9,6,17,32
Comal,106,U.S. Senate,,DEM,Michael Cooper,3,2,3,8
Comal,106,U.S. Senate,,DEM,Victor Hugo Harris,0,0,3,3
Comal,106,U.S. Senate,,DEM,"Annie ""Mam치"" Garcia",12,1,7,20
Comal,106,U.S. Senate,,DEM,Cast Votes:,123,35,177,335
Comal,106,U.S. Senate,,DEM,Under Votes,33,3,15,51
Comal,106,U.S. Senate,,DEM,Over Votes,0,0,0,0
Comal,106,U.S. House,21,DEM,Wendy R. Davis,102,31,154,287
Comal,106,U.S. House,21,DEM,Jennie Lou Leeder,22,5,25,52
Comal,106,U.S. House,21,DEM,Cast Votes:,124,36,179,339
Comal,106,U.S. House,21,DEM,Under Votes,32,2,13,47
Comal,106,U.S. House,21,DEM,Over Votes,0,0,0,0
Comal,106,Railroad Commissioner,,DEM,Mark Watson,15,5,32,52
Comal,106,Railroad Commissioner,,DEM,Chrysta Casta침eda,46,20,72,138
Comal,106,Railroad Commissioner,,DEM,Kelly Stone,26,3,41,70
Comal,106,Railroad Commissioner,,DEM,"Roberto R. ""Beto"" Alonzo",28,6,23,57
Comal,106,Railroad Commissioner,,DEM,Cast Votes:,115,34,168,317
Comal,106,Railroad Commissioner,,DEM,Under Votes,41,4,24,69
Comal,106,Railroad Commissioner,,DEM,Over Votes,0,0,0,0
Comal,106,"Chief Justice, Supreme Court",,DEM,Amy Clark Meachum,107,31,153,291
Comal,106,"Chief Justice, Supreme Court",,DEM,Jerry Zimmerer,8,3,18,29
Comal,106,"Chief Justice, Supreme Court",,DEM,Cast Votes:,115,34,171,320
Comal,106,"Chief Justice, Supreme Court",,DEM,Under Votes,41,4,21,66
Comal,106,"Chief Justice, Supreme Court",,DEM,Over Votes,0,0,0,0
Comal,106,"Justice, Supreme Court, Place 6 Unexpired Term",,DEM,Larry Praeger,21,14,41,76
Comal,106,"Justice, Supreme Court, Place 6 Unexpired Term",,DEM,Kathy Cheng,89,19,125,233
Comal,106,"Justice, Supreme Court, Place 6 Unexpired Term",,DEM,Cast Votes:,110,33,166,309
Comal,106,"Justice, Supreme Court, Place 6 Unexpired Term",,DEM,Under Votes,46,5,26,77
Comal,106,"Justice, Supreme Court, Place 6 Unexpired Term",,DEM,Over Votes,0,0,0,0
Comal,106,"Justice, Supreme Court, Place 7",,DEM,Staci Williams,70,14,102,186
Comal,106,"Justice, Supreme Court, Place 7",,DEM,Brandy Voss,37,18,58,113
Comal,106,"Justice, Supreme Court, Place 7",,DEM,Cast Votes:,107,32,160,299
Comal,106,"Justice, Supreme Court, Place 7",,DEM,Under Votes,49,6,32,87
Comal,106,"Justice, Supreme Court, Place 7",,DEM,Over Votes,0,0,0,0
Comal,106,"Justice, Supreme Court, Place 8",,DEM,Peter Kelly,28,10,45,83
Comal,106,"Justice, Supreme Court, Place 8",,DEM,Gisela D. Triana,81,23,115,219
Comal,106,"Justice, Supreme Court, Place 8",,DEM,Cast Votes:,109,33,160,302
Comal,106,"Justice, Supreme Court, Place 8",,DEM,Under Votes,47,5,32,84
Comal,106,"Justice, Supreme Court, Place 8",,DEM,Over Votes,0,0,0,0
Comal,106,"Judge, Court of Criminal Appeals, Place 3",,DEM,Elizabeth Davis Frizell,80,26,132,238
Comal,106,"Judge, Court of Criminal Appeals, Place 3",,DEM,William Pieratt Demond,8,1,10,19
Comal,106,"Judge, Court of Criminal Appeals, Place 3",,DEM,Dan Wood,20,6,22,48
Comal,106,"Judge, Court of Criminal Appeals, Place 3",,DEM,Cast Votes:,108,33,164,305
Comal,106,"Judge, Court of Criminal Appeals, Place 3",,DEM,Under Votes,48,5,28,81
Comal,106,"Judge, Court of Criminal Appeals, Place 3",,DEM,Over Votes,0,0,0,0
Comal,106,"Judge, Court of Criminal Appeals, Place 4",,DEM,Tina Clinton,97,27,131,255
Comal,106,"Judge, Court of Criminal Appeals, Place 4",,DEM,Steven Miears,10,5,27,42
Comal,106,"Judge, Court of Criminal Appeals, Place 4",,DEM,Cast Votes:,107,32,158,297
Comal,106,"Judge, Court of Criminal Appeals, Place 4",,DEM,Under Votes,49,6,34,89
Comal,106,"Judge, Court of Criminal Appeals, Place 4",,DEM,Over Votes,0,0,0,0
Comal,106,"Judge, Court of Criminal Appeals, Place 9",,DEM,Brandon Birmingham,92,31,148,271
Comal,106,"Judge, Court of Criminal Appeals, Place 9",,DEM,Cast Votes:,92,31,148,271
Comal,106,"Judge, Court of Criminal Appeals, Place 9",,DEM,Under Votes,64,7,44,115
Comal,106,"Judge, Court of Criminal Appeals, Place 9",,DEM,Over Votes,0,0,0,0
Comal,106,"Member, State Board of Education, District 5",,DEM,Rebecca Bell-Metereau,68,21,100,189
Comal,106,"Member, State Board of Education, District 5",,DEM,Letti Bresnahan,41,10,56,107
Comal,106,"Member, State Board of Education, District 5",,DEM,Cast Votes:,109,31,156,296
Comal,106,"Member, State Board of Education, District 5",,DEM,Under Votes,47,7,36,90
Comal,106,"Member, State Board of Education, District 5",,DEM,Over Votes,0,0,0,0
Comal,106,State Representative,73,DEM,Stephanie Phillips,101,33,155,289
Comal,106,State Representative,73,DEM,Cast Votes:,101,33,155,289
Comal,106,State Representative,73,DEM,Under Votes,55,5,37,97
Comal,106,State Representative,73,DEM,Over Votes,0,0,0,0
Comal,106,"Chief Justice, 3rd Court of Appeals District",,DEM,Darlene Byrne,90,25,123,238
Comal,106,"Chief Justice, 3rd Court of Appeals District",,DEM,Keith S. Hampton,14,7,30,51
Comal,106,"Chief Justice, 3rd Court of Appeals District",,DEM,Cast Votes:,104,32,153,289
Comal,106,"Chief Justice, 3rd Court of Appeals District",,DEM,Under Votes,52,6,39,97
Comal,106,"Chief Justice, 3rd Court of Appeals District",,DEM,Over Votes,0,0,0,0
Comal,106,"County Commissioner, Precinct 1",,DEM,Lindsay Poisel,98,31,154,283
Comal,106,"County Commissioner, Precinct 1",,DEM,Cast Votes:,98,31,154,283
Comal,106,"County Commissioner, Precinct 1",,DEM,Under Votes,58,7,38,103
Comal,106,"County Commissioner, Precinct 1",,DEM,Over Votes,0,0,0,0
Comal,106,County Chairman,,DEM,Gloria Meehan,97,33,154,284
Comal,106,County Chairman,,DEM,Cast Votes:,97,33,154,284
Comal,106,County Chairman,,DEM,Under Votes,59,5,38,102
Comal,106,County Chairman,,DEM,Over Votes,0,0,0,0
Comal,106,Proposition #1,,DEM,Yes,137,32,169,338
Comal,106,Proposition #1,,DEM,No,15,5,20,40
Comal,106,Proposition #1,,DEM,Cast Votes:,152,37,189,378
Comal,106,Proposition #1,,DEM,Under Votes,4,1,3,8
Comal,106,Proposition #1,,DEM,Over Votes,0,0,0,0
Comal,106,Proposition #2,,DEM,Yes,134,33,173,340
Comal,106,Proposition #2,,DEM,No,19,3,17,39
Comal,106,Proposition #2,,DEM,Cast Votes:,153,36,190,379
Comal,106,Proposition #2,,DEM,Under Votes,3,2,2,7
Comal,106,Proposition #2,,DEM,Over Votes,0,0,0,0
Comal,106,Proposition #3,,DEM,Yes,144,38,187,369
Comal,106,Proposition #3,,DEM,No,8,0,4,12
Comal,106,Proposition #3,,DEM,Cast Votes:,152,38,191,381
Comal,106,Proposition #3,,DEM,Under Votes,4,0,1,5
Comal,106,Proposition #3,,DEM,Over Votes,0,0,0,0
Comal,106,Proposition #4,,DEM,Yes,134,31,170,335
Comal,106,Proposition #4,,DEM,No,15,3,17,35
Comal,106,Proposition #4,,DEM,Cast Votes:,149,34,187,370
Comal,106,Proposition #4,,DEM,Under Votes,7,4,5,16
Comal,106,Proposition #4,,DEM,Over Votes,0,0,0,0
Comal,106,Proposition #5,,DEM,Yes,144,38,186,368
Comal,106,Proposition #5,,DEM,No,6,0,3,9
Comal,106,Proposition #5,,DEM,Cast Votes:,150,38,189,377
Comal,106,Proposition #5,,DEM,Under Votes,6,0,3,9
Comal,106,Proposition #5,,DEM,Over Votes,0,0,0,0
Comal,106,Proposition #6,,DEM,Yes,139,38,188,365
Comal,106,Proposition #6,,DEM,No,10,0,2,12
Comal,106,Proposition #6,,DEM,Cast Votes:,149,38,190,377
Comal,106,Proposition #6,,DEM,Under Votes,7,0,2,9
Comal,106,Proposition #6,,DEM,Over Votes,0,0,0,0
Comal,106,Proposition #7,,DEM,Yes,136,31,172,339
Comal,106,Proposition #7,,DEM,No,13,4,15,32
Comal,106,Proposition #7,,DEM,Cast Votes:,149,35,187,371
Comal,106,Proposition #7,,DEM,Under Votes,7,3,5,15
Comal,106,Proposition #7,,DEM,Over Votes,0,0,0,0
Comal,106,Proposition #8,,DEM,Yes,139,38,179,356
Comal,106,Proposition #8,,DEM,No,9,0,12,21
Comal,106,Proposition #8,,DEM,Cast Votes:,148,38,191,377
Comal,106,Proposition #8,,DEM,Under Votes,8,0,1,9
Comal,106,Proposition #8,,DEM,Over Votes,0,0,0,0
Comal,106,Proposition #9,,DEM,Yes,144,38,183,365
Comal,106,Proposition #9,,DEM,No,6,0,5,11
Comal,106,Proposition #9,,DEM,Cast Votes:,150,38,188,376
Comal,106,Proposition #9,,DEM,Under Votes,6,0,4,10
Comal,106,Proposition #9,,DEM,Over Votes,0,0,0,0
Comal,106,Proposition #10,,DEM,Yes,136,38,178,352
Comal,106,Proposition #10,,DEM,No,13,0,11,24
Comal,106,Proposition #10,,DEM,Cast Votes:,149,38,189,376
Comal,106,Proposition #10,,DEM,Under Votes,7,0,3,10
Comal,106,Proposition #10,,DEM,Over Votes,0,0,0,0
Comal,106,Proposition #11,,DEM,Yes,133,35,172,340
Comal,106,Proposition #11,,DEM,No,11,3,14,28
Comal,106,Proposition #11,,DEM,Cast Votes:,144,38,186,368
Comal,106,Proposition #11,,DEM,Under Votes,12,0,6,18
Comal,106,Proposition #11,,DEM,Over Votes,0,0,0,0
Comal,107,President,,DEM,Tulsi Gabbard,0,0,0,0
Comal,107,President,,DEM,Marianne Williamson,0,0,0,0
Comal,107,President,,DEM,John K. Delaney,0,0,0,0
Comal,107,President,,DEM,Elizabeth Warren,19,5,18,42
Comal,107,President,,DEM,Cory Booker,0,0,0,0
Comal,107,President,,DEM,Amy Klobuchar,0,1,10,11
Comal,107,President,,DEM,Joseph R. Biden,147,5,22,174
Comal,107,President,,DEM,Pete Buttigieg,0,1,16,17
Comal,107,President,,DEM,Juli치n Castro,0,0,0,0
Comal,107,President,,DEM,Tom Steyer,0,0,1,1
Comal,107,President,,DEM,Michael Bennet,0,0,0,0
Comal,107,President,,DEM,Michael R. Bloomberg,24,4,13,41
Comal,107,President,,DEM,Robby Wells,0,0,0,0
Comal,107,President,,DEM,"Roque ""Rocky"" De La Fuente",0,0,0,0
Comal,107,President,,DEM,Deval Patrick,0,0,0,0
Comal,107,President,,DEM,Bernie Sanders,27,2,9,38
Comal,107,President,,DEM,Andrew Yang,0,0,0,0
Comal,107,Ballots Cast,,DEM,,217,18,89,324
Comal,107,President,,DEM,Under Votes,1,0,0,1
Comal,107,President,,DEM,Over Votes,0,0,0,0
Comal,107,U.S. Senate,,DEM,Royce West,23,1,11,35
Comal,107,U.S. Senate,,DEM,Chris Bell,16,1,9,26
Comal,107,U.S. Senate,,DEM,Amanda K. Edwards,33,4,14,51
Comal,107,U.S. Senate,,DEM,Sema Hernandez,18,1,1,20
Comal,107,U.S. Senate,,DEM,Jack Daniel Foster Jr,2,0,0,2
Comal,107,U.S. Senate,,DEM,D.R. Hunter,6,0,3,9
Comal,107,U.S. Senate,,DEM,Adrian Ocegueda,5,0,0,5
Comal,107,U.S. Senate,,DEM,"Mary ""MJ"" Hegar",63,9,34,106
Comal,107,U.S. Senate,,DEM,Cristina Tzintzun Ramirez,8,0,6,14
Comal,107,U.S. Senate,,DEM,Michael Cooper,2,0,0,2
Comal,107,U.S. Senate,,DEM,Victor Hugo Harris,5,0,1,6
Comal,107,U.S. Senate,,DEM,"Annie ""Mam치"" Garcia",8,0,2,10
Comal,107,U.S. Senate,,DEM,Cast Votes:,189,16,81,286
Comal,107,U.S. Senate,,DEM,Under Votes,29,2,8,39
Comal,107,U.S. Senate,,DEM,Over Votes,0,0,0,0
Comal,107,U.S. House,21,DEM,Wendy R. Davis,165,13,68,246
Comal,107,U.S. House,21,DEM,Jennie Lou Leeder,26,4,13,43
Comal,107,U.S. House,21,DEM,Cast Votes:,191,17,81,289
Comal,107,U.S. House,21,DEM,Under Votes,27,1,7,35
Comal,107,U.S. House,21,DEM,Over Votes,0,0,1,1
Comal,107,Railroad Commissioner,,DEM,Mark Watson,35,0,8,43
Comal,107,Railroad Commissioner,,DEM,Chrysta Casta침eda,61,11,29,101
Comal,107,Railroad Commissioner,,DEM,Kelly Stone,44,2,26,72
Comal,107,Railroad Commissioner,,DEM,"Roberto R. ""Beto"" Alonzo",38,2,10,50
Comal,107,Railroad Commissioner,,DEM,Cast Votes:,178,15,73,266
Comal,107,Railroad Commissioner,,DEM,Under Votes,40,3,16,59
Comal,107,Railroad Commissioner,,DEM,Over Votes,0,0,0,0
Comal,107,"Chief Justice, Supreme Court",,DEM,Amy Clark Meachum,149,15,58,222
Comal,107,"Chief Justice, Supreme Court",,DEM,Jerry Zimmerer,31,1,14,46
Comal,107,"Chief Justice, Supreme Court",,DEM,Cast Votes:,180,16,72,268
Comal,107,"Chief Justice, Supreme Court",,DEM,Under Votes,38,2,17,57
Comal,107,"Chief Justice, Supreme Court",,DEM,Over Votes,0,0,0,0
Comal,107,"Justice, Supreme Court, Place 6 Unexpired Term",,DEM,Larry Praeger,48,3,10,61
Comal,107,"Justice, Supreme Court, Place 6 Unexpired Term",,DEM,Kathy Cheng,131,13,60,204
Comal,107,"Justice, Supreme Court, Place 6 Unexpired Term",,DEM,Cast Votes:,179,16,70,265
Comal,107,"Justice, Supreme Court, Place 6 Unexpired Term",,DEM,Under Votes,39,2,19,60
Comal,107,"Justice, Supreme Court, Place 6 Unexpired Term",,DEM,Over Votes,0,0,0,0
Comal,107,"Justice, Supreme Court, Place 7",,DEM,Staci Williams,113,8,41,162
Comal,107,"Justice, Supreme Court, Place 7",,DEM,Brandy Voss,68,8,29,105
Comal,107,"Justice, Supreme Court, Place 7",,DEM,Cast Votes:,181,16,70,267
Comal,107,"Justice, Supreme Court, Place 7",,DEM,Under Votes,37,2,19,58
Comal,107,"Justice, Supreme Court, Place 7",,DEM,Over Votes,0,0,0,0
Comal,107,"Justice, Supreme Court, Place 8",,DEM,Peter Kelly,50,2,11,63
Comal,107,"Justice, Supreme Court, Place 8",,DEM,Gisela D. Triana,130,14,58,202
Comal,107,"Justice, Supreme Court, Place 8",,DEM,Cast Votes:,180,16,69,265
Comal,107,"Justice, Supreme Court, Place 8",,DEM,Under Votes,38,2,20,60
Comal,107,"Justice, Supreme Court, Place 8",,DEM,Over Votes,0,0,0,0
Comal,107,"Judge, Court of Criminal Appeals, Place 3",,DEM,Elizabeth Davis Frizell,137,13,51,201
Comal,107,"Judge, Court of Criminal Appeals, Place 3",,DEM,William Pieratt Demond,15,1,4,20
Comal,107,"Judge, Court of Criminal Appeals, Place 3",,DEM,Dan Wood,30,2,15,47
Comal,107,"Judge, Court of Criminal Appeals, Place 3",,DEM,Cast Votes:,182,16,70,268
Comal,107,"Judge, Court of Criminal Appeals, Place 3",,DEM,Under Votes,36,2,19,57
Comal,107,"Judge, Court of Criminal Appeals, Place 3",,DEM,Over Votes,0,0,0,0
Comal,107,"Judge, Court of Criminal Appeals, Place 4",,DEM,Tina Clinton,147,13,61,221
Comal,107,"Judge, Court of Criminal Appeals, Place 4",,DEM,Steven Miears,30,3,9,42
Comal,107,"Judge, Court of Criminal Appeals, Place 4",,DEM,Cast Votes:,177,16,70,263
Comal,107,"Judge, Court of Criminal Appeals, Place 4",,DEM,Under Votes,41,2,19,62
Comal,107,"Judge, Court of Criminal Appeals, Place 4",,DEM,Over Votes,0,0,0,0
Comal,107,"Judge, Court of Criminal Appeals, Place 9",,DEM,Brandon Birmingham,162,10,63,235
Comal,107,"Judge, Court of Criminal Appeals, Place 9",,DEM,Cast Votes:,162,10,63,235
Comal,107,"Judge, Court of Criminal Appeals, Place 9",,DEM,Under Votes,56,8,26,90
Comal,107,"Judge, Court of Criminal Appeals, Place 9",,DEM,Over Votes,0,0,0,0
Comal,107,"Member, State Board of Education, District 5",,DEM,Rebecca Bell-Metereau,111,13,52,176
Comal,107,"Member, State Board of Education, District 5",,DEM,Letti Bresnahan,61,3,20,84
Comal,107,"Member, State Board of Education, District 5",,DEM,Cast Votes:,172,16,72,260
Comal,107,"Member, State Board of Education, District 5",,DEM,Under Votes,46,2,17,65
Comal,107,"Member, State Board of Education, District 5",,DEM,Over Votes,0,0,0,0
Comal,107,State Representative,73,DEM,Stephanie Phillips,168,12,70,250
Comal,107,State Representative,73,DEM,Cast Votes:,168,12,70,250
Comal,107,State Representative,73,DEM,Under Votes,50,6,19,75
Comal,107,State Representative,73,DEM,Over Votes,0,0,0,0
Comal,107,"Chief Justice, 3rd Court of Appeals District",,DEM,Darlene Byrne,129,12,58,199
Comal,107,"Chief Justice, 3rd Court of Appeals District",,DEM,Keith S. Hampton,40,4,11,55
Comal,107,"Chief Justice, 3rd Court of Appeals District",,DEM,Cast Votes:,169,16,69,254
Comal,107,"Chief Justice, 3rd Court of Appeals District",,DEM,Under Votes,49,2,19,70
Comal,107,"Chief Justice, 3rd Court of Appeals District",,DEM,Over Votes,0,0,1,1
Comal,107,"County Commissioner, Precinct 1",,DEM,Lindsay Poisel,171,13,67,251
Comal,107,"County Commissioner, Precinct 1",,DEM,Cast Votes:,171,13,67,251
Comal,107,"County Commissioner, Precinct 1",,DEM,Under Votes,47,5,22,74
Comal,107,"County Commissioner, Precinct 1",,DEM,Over Votes,0,0,0,0
Comal,107,County Chairman,,DEM,Gloria Meehan,170,12,69,251
Comal,107,County Chairman,,DEM,Cast Votes:,170,12,69,251
Comal,107,County Chairman,,DEM,Under Votes,48,6,20,74
Comal,107,County Chairman,,DEM,Over Votes,0,0,0,0
Comal,107,Proposition #1,,DEM,Yes,187,16,81,284
Comal,107,Proposition #1,,DEM,No,28,0,5,33
Comal,107,Proposition #1,,DEM,Cast Votes:,215,16,86,317
Comal,107,Proposition #1,,DEM,Under Votes,3,2,3,8
Comal,107,Proposition #1,,DEM,Over Votes,0,0,0,0
Comal,107,Proposition #2,,DEM,Yes,186,14,84,284
Comal,107,Proposition #2,,DEM,No,28,2,4,34
Comal,107,Proposition #2,,DEM,Cast Votes:,214,16,88,318
Comal,107,Proposition #2,,DEM,Under Votes,4,2,1,7
Comal,107,Proposition #2,,DEM,Over Votes,0,0,0,0
Comal,107,Proposition #3,,DEM,Yes,207,16,87,310
Comal,107,Proposition #3,,DEM,No,7,0,0,7
Comal,107,Proposition #3,,DEM,Cast Votes:,214,16,87,317
Comal,107,Proposition #3,,DEM,Under Votes,4,2,2,8
Comal,107,Proposition #3,,DEM,Over Votes,0,0,0,0
Comal,107,Proposition #4,,DEM,Yes,193,15,83,291
Comal,107,Proposition #4,,DEM,No,19,1,4,24
Comal,107,Proposition #4,,DEM,Cast Votes:,212,16,87,315
Comal,107,Proposition #4,,DEM,Under Votes,6,2,2,10
Comal,107,Proposition #4,,DEM,Over Votes,0,0,0,0
Comal,107,Proposition #5,,DEM,Yes,208,16,86,310
Comal,107,Proposition #5,,DEM,No,4,0,1,5
Comal,107,Proposition #5,,DEM,Cast Votes:,212,16,87,315
Comal,107,Proposition #5,,DEM,Under Votes,6,2,2,10
Comal,107,Proposition #5,,DEM,Over Votes,0,0,0,0
Comal,107,Proposition #6,,DEM,Yes,206,16,87,309
Comal,107,Proposition #6,,DEM,No,7,0,1,8
Comal,107,Proposition #6,,DEM,Cast Votes:,213,16,88,317
Comal,107,Proposition #6,,DEM,Under Votes,5,2,1,8
Comal,107,Proposition #6,,DEM,Over Votes,0,0,0,0
Comal,107,Proposition #7,,DEM,Yes,195,15,84,294
Comal,107,Proposition #7,,DEM,No,16,0,3,19
Comal,107,Proposition #7,,DEM,Cast Votes:,211,15,87,313
Comal,107,Proposition #7,,DEM,Under Votes,7,3,2,12
Comal,107,Proposition #7,,DEM,Over Votes,0,0,0,0
Comal,107,Proposition #8,,DEM,Yes,201,16,86,303
Comal,107,Proposition #8,,DEM,No,11,0,2,13
Comal,107,Proposition #8,,DEM,Cast Votes:,212,16,88,316
Comal,107,Proposition #8,,DEM,Under Votes,6,2,1,9
Comal,107,Proposition #8,,DEM,Over Votes,0,0,0,0
Comal,107,Proposition #9,,DEM,Yes,206,14,83,303
Comal,107,Proposition #9,,DEM,No,7,2,3,12
Comal,107,Proposition #9,,DEM,Cast Votes:,213,16,86,315
Comal,107,Proposition #9,,DEM,Under Votes,5,2,3,10
Comal,107,Proposition #9,,DEM,Over Votes,0,0,0,0
Comal,107,Proposition #10,,DEM,Yes,201,14,86,301
Comal,107,Proposition #10,,DEM,No,10,2,3,15
Comal,107,Proposition #10,,DEM,Cast Votes:,211,16,89,316
Comal,107,Proposition #10,,DEM,Under Votes,7,2,0,9
Comal,107,Proposition #10,,DEM,Over Votes,0,0,0,0
Comal,107,Proposition #11,,DEM,Yes,185,12,84,281
Comal,107,Proposition #11,,DEM,No,25,4,3,32
Comal,107,Proposition #11,,DEM,Cast Votes:,210,16,87,313
Comal,107,Proposition #11,,DEM,Under Votes,8,2,2,12
Comal,107,Proposition #11,,DEM,Over Votes,0,0,0,0
Comal,108,President,,DEM,Tulsi Gabbard,0,0,0,0
Comal,108,President,,DEM,Marianne Williamson,0,0,0,0
Comal,108,President,,DEM,John K. Delaney,0,0,0,0
Comal,108,President,,DEM,Elizabeth Warren,14,1,10,25
Comal,108,President,,DEM,Cory Booker,0,0,0,0
Comal,108,President,,DEM,Amy Klobuchar,0,0,8,8
Comal,108,President,,DEM,Joseph R. Biden,34,6,12,52
Comal,108,President,,DEM,Pete Buttigieg,2,3,7,12
Comal,108,President,,DEM,Juli치n Castro,0,0,0,0
Comal,108,President,,DEM,Tom Steyer,1,0,2,3
Comal,108,President,,DEM,Michael Bennet,0,0,0,0
Comal,108,President,,DEM,Michael R. Bloomberg,14,6,14,34
Comal,108,President,,DEM,Robby Wells,0,0,0,0
Comal,108,President,,DEM,"Roque ""Rocky"" De La Fuente",0,0,0,0
Comal,108,President,,DEM,Deval Patrick,0,0,0,0
Comal,108,President,,DEM,Bernie Sanders,18,1,17,36
Comal,108,President,,DEM,Andrew Yang,0,0,0,0
Comal,108,Ballots Cast,,DEM,,83,17,70,170
Comal,108,President,,DEM,Under Votes,0,0,1,1
Comal,108,President,,DEM,Over Votes,0,0,0,0
Comal,108,U.S. Senate,,DEM,Royce West,2,6,9,17
Comal,108,U.S. Senate,,DEM,Chris Bell,8,0,9,17
Comal,108,U.S. Senate,,DEM,Amanda K. Edwards,9,0,6,15
Comal,108,U.S. Senate,,DEM,Sema Hernandez,5,3,0,8
Comal,108,U.S. Senate,,DEM,Jack Daniel Foster Jr,3,0,0,3
Comal,108,U.S. Senate,,DEM,D.R. Hunter,1,0,1,2
Comal,108,U.S. Senate,,DEM,Adrian Ocegueda,4,0,1,5
Comal,108,U.S. Senate,,DEM,"Mary ""MJ"" Hegar",32,7,28,67
Comal,108,U.S. Senate,,DEM,Cristina Tzintzun Ramirez,4,0,9,13
Comal,108,U.S. Senate,,DEM,Michael Cooper,0,0,2,2
Comal,108,U.S. Senate,,DEM,Victor Hugo Harris,0,0,0,0
Comal,108,U.S. Senate,,DEM,"Annie ""Mam치"" Garcia",5,0,1,6
Comal,108,U.S. Senate,,DEM,Cast Votes:,73,16,66,155
Comal,108,U.S. Senate,,DEM,Under Votes,10,1,5,16
Comal,108,U.S. Senate,,DEM,Over Votes,0,0,0,0
Comal,108,U.S. House,21,DEM,Wendy R. Davis,65,16,48,129
Comal,108,U.S. House,21,DEM,Jennie Lou Leeder,12,0,18,30
Comal,108,U.S. House,21,DEM,Cast Votes:,77,16,66,159
Comal,108,U.S. House,21,DEM,Under Votes,6,1,5,12
Comal,108,U.S. House,21,DEM,Over Votes,0,0,0,0
Comal,108,Railroad Commissioner,,DEM,Mark Watson,15,4,12,31
Comal,108,Railroad Commissioner,,DEM,Chrysta Casta침eda,24,2,30,56
Comal,108,Railroad Commissioner,,DEM,Kelly Stone,16,3,15,34
Comal,108,Railroad Commissioner,,DEM,"Roberto R. ""Beto"" Alonzo",20,6,7,33
Comal,108,Railroad Commissioner,,DEM,Cast Votes:,75,15,64,154
Comal,108,Railroad Commissioner,,DEM,Under Votes,8,2,7,17
Comal,108,Railroad Commissioner,,DEM,Over Votes,0,0,0,0
Comal,108,"Chief Justice, Supreme Court",,DEM,Amy Clark Meachum,68,12,50,130
Comal,108,"Chief Justice, Supreme Court",,DEM,Jerry Zimmerer,9,3,12,24
Comal,108,"Chief Justice, Supreme Court",,DEM,Cast Votes:,77,15,62,154
Comal,108,"Chief Justice, Supreme Court",,DEM,Under Votes,6,2,9,17
Comal,108,"Chief Justice, Supreme Court",,DEM,Over Votes,0,0,0,0
Comal,108,"Justice, Supreme Court, Place 6 Unexpired Term",,DEM,Larry Praeger,16,4,18,38
Comal,108,"Justice, Supreme Court, Place 6 Unexpired Term",,DEM,Kathy Cheng,59,11,42,112
Comal,108,"Justice, Supreme Court, Place 6 Unexpired Term",,DEM,Cast Votes:,75,15,60,150
Comal,108,"Justice, Supreme Court, Place 6 Unexpired Term",,DEM,Under Votes,8,2,11,21
Comal,108,"Justice, Supreme Court, Place 6 Unexpired Term",,DEM,Over Votes,0,0,0,0
Comal,108,"Justice, Supreme Court, Place 7",,DEM,Staci Williams,53,10,29,92
Comal,108,"Justice, Supreme Court, Place 7",,DEM,Brandy Voss,22,5,33,60
Comal,108,"Justice, Supreme Court, Place 7",,DEM,Cast Votes:,75,15,62,152
Comal,108,"Justice, Supreme Court, Place 7",,DEM,Under Votes,8,2,9,19
Comal,108,"Justice, Supreme Court, Place 7",,DEM,Over Votes,0,0,0,0
Comal,108,"Justice, Supreme Court, Place 8",,DEM,Peter Kelly,21,5,16,42
Comal,108,"Justice, Supreme Court, Place 8",,DEM,Gisela D. Triana,53,9,45,107
Comal,108,"Justice, Supreme Court, Place 8",,DEM,Cast Votes:,74,14,61,149
Comal,108,"Justice, Supreme Court, Place 8",,DEM,Under Votes,9,3,10,22
Comal,108,"Justice, Supreme Court, Place 8",,DEM,Over Votes,0,0,0,0
Comal,108,"Judge, Court of Criminal Appeals, Place 3",,DEM,Elizabeth Davis Frizell,61,10,43,114
Comal,108,"Judge, Court of Criminal Appeals, Place 3",,DEM,William Pieratt Demond,6,0,4,10
Comal,108,"Judge, Court of Criminal Appeals, Place 3",,DEM,Dan Wood,9,5,14,28
Comal,108,"Judge, Court of Criminal Appeals, Place 3",,DEM,Cast Votes:,76,15,61,152
Comal,108,"Judge, Court of Criminal Appeals, Place 3",,DEM,Under Votes,7,2,10,19
Comal,108,"Judge, Court of Criminal Appeals, Place 3",,DEM,Over Votes,0,0,0,0
Comal,108,"Judge, Court of Criminal Appeals, Place 4",,DEM,Tina Clinton,58,9,49,116
Comal,108,"Judge, Court of Criminal Appeals, Place 4",,DEM,Steven Miears,15,6,10,31
Comal,108,"Judge, Court of Criminal Appeals, Place 4",,DEM,Cast Votes:,73,15,59,147
Comal,108,"Judge, Court of Criminal Appeals, Place 4",,DEM,Under Votes,10,2,12,24
Comal,108,"Judge, Court of Criminal Appeals, Place 4",,DEM,Over Votes,0,0,0,0
Comal,108,"Judge, Court of Criminal Appeals, Place 9",,DEM,Brandon Birmingham,67,14,54,135
Comal,108,"Judge, Court of Criminal Appeals, Place 9",,DEM,Cast Votes:,67,14,54,135
Comal,108,"Judge, Court of Criminal Appeals, Place 9",,DEM,Under Votes,16,3,17,36
Comal,108,"Judge, Court of Criminal Appeals, Place 9",,DEM,Over Votes,0,0,0,0
Comal,108,"Member, State Board of Education, District 5",,DEM,Rebecca Bell-Metereau,48,9,42,99
Comal,108,"Member, State Board of Education, District 5",,DEM,Letti Bresnahan,24,7,18,49
Comal,108,"Member, State Board of Education, District 5",,DEM,Cast Votes:,72,16,60,148
Comal,108,"Member, State Board of Education, District 5",,DEM,Under Votes,11,1,11,23
Comal,108,"Member, State Board of Education, District 5",,DEM,Over Votes,0,0,0,0
Comal,108,State Representative,73,DEM,Stephanie Phillips,68,14,57,139
Comal,108,State Representative,73,DEM,Cast Votes:,68,14,57,139
Comal,108,State Representative,73,DEM,Under Votes,15,3,14,32
Comal,108,State Representative,73,DEM,Over Votes,0,0,0,0
Comal,108,"Chief Justice, 3rd Court of Appeals District",,DEM,Darlene Byrne,58,13,39,110
Comal,108,"Chief Justice, 3rd Court of Appeals District",,DEM,Keith S. Hampton,14,2,18,34
Comal,108,"Chief Justice, 3rd Court of Appeals District",,DEM,Cast Votes:,72,15,57,144
Comal,108,"Chief Justice, 3rd Court of Appeals District",,DEM,Under Votes,11,2,14,27
Comal,108,"Chief Justice, 3rd Court of Appeals District",,DEM,Over Votes,0,0,0,0
Comal,108,"County Commissioner, Precinct 1",,DEM,Lindsay Poisel,68,13,56,137
Comal,108,"County Commissioner, Precinct 1",,DEM,Cast Votes:,68,13,56,137
Comal,108,"County Commissioner, Precinct 1",,DEM,Under Votes,15,4,15,34
Comal,108,"County Commissioner, Precinct 1",,DEM,Over Votes,0,0,0,0
Comal,108,County Chairman,,DEM,Gloria Meehan,70,13,59,142
Comal,108,County Chairman,,DEM,Cast Votes:,70,13,59,142
Comal,108,County Chairman,,DEM,Under Votes,13,4,12,29
Comal,108,County Chairman,,DEM,Over Votes,0,0,0,0
Comal,108,Proposition #1,,DEM,Yes,76,16,62,154
Comal,108,Proposition #1,,DEM,No,4,0,8,12
Comal,108,Proposition #1,,DEM,Cast Votes:,80,16,70,166
Comal,108,Proposition #1,,DEM,Under Votes,3,1,1,5
Comal,108,Proposition #1,,DEM,Over Votes,0,0,0,0
Comal,108,Proposition #2,,DEM,Yes,73,16,57,146
Comal,108,Proposition #2,,DEM,No,7,0,10,17
Comal,108,Proposition #2,,DEM,Cast Votes:,80,16,67,163
Comal,108,Proposition #2,,DEM,Under Votes,3,1,4,8
Comal,108,Proposition #2,,DEM,Over Votes,0,0,0,0
Comal,108,Proposition #3,,DEM,Yes,78,16,63,157
Comal,108,Proposition #3,,DEM,No,2,0,4,6
Comal,108,Proposition #3,,DEM,Cast Votes:,80,16,67,163
Comal,108,Proposition #3,,DEM,Under Votes,3,1,4,8
Comal,108,Proposition #3,,DEM,Over Votes,0,0,0,0
Comal,108,Proposition #4,,DEM,Yes,77,16,59,152
Comal,108,Proposition #4,,DEM,No,3,0,9,12
Comal,108,Proposition #4,,DEM,Cast Votes:,80,16,68,164
Comal,108,Proposition #4,,DEM,Under Votes,3,1,3,7
Comal,108,Proposition #4,,DEM,Over Votes,0,0,0,0
Comal,108,Proposition #5,,DEM,Yes,77,16,63,156
Comal,108,Proposition #5,,DEM,No,3,0,4,7
Comal,108,Proposition #5,,DEM,Cast Votes:,80,16,67,163
Comal,108,Proposition #5,,DEM,Under Votes,3,1,4,8
Comal,108,Proposition #5,,DEM,Over Votes,0,0,0,0
Comal,108,Proposition #6,,DEM,Yes,77,16,64,157
Comal,108,Proposition #6,,DEM,No,2,0,3,5
Comal,108,Proposition #6,,DEM,Cast Votes:,79,16,67,162
Comal,108,Proposition #6,,DEM,Under Votes,4,1,4,9
Comal,108,Proposition #6,,DEM,Over Votes,0,0,0,0
Comal,108,Proposition #7,,DEM,Yes,71,16,64,151
Comal,108,Proposition #7,,DEM,No,4,0,6,10
Comal,108,Proposition #7,,DEM,Cast Votes:,75,16,70,161
Comal,108,Proposition #7,,DEM,Under Votes,8,1,1,10
Comal,108,Proposition #7,,DEM,Over Votes,0,0,0,0
Comal,108,Proposition #8,,DEM,Yes,78,16,65,159
Comal,108,Proposition #8,,DEM,No,2,0,4,6
Comal,108,Proposition #8,,DEM,Cast Votes:,80,16,69,165
Comal,108,Proposition #8,,DEM,Under Votes,3,1,2,6
Comal,108,Proposition #8,,DEM,Over Votes,0,0,0,0
Comal,108,Proposition #9,,DEM,Yes,80,16,64,160
Comal,108,Proposition #9,,DEM,No,1,0,5,6
Comal,108,Proposition #9,,DEM,Cast Votes:,81,16,69,166
Comal,108,Proposition #9,,DEM,Under Votes,2,1,2,5
Comal,108,Proposition #9,,DEM,Over Votes,0,0,0,0
Comal,108,Proposition #10,,DEM,Yes,77,16,63,156
Comal,108,Proposition #10,,DEM,No,3,0,6,9
Comal,108,Proposition #10,,DEM,Cast Votes:,80,16,69,165
Comal,108,Proposition #10,,DEM,Under Votes,3,1,2,6
Comal,108,Proposition #10,,DEM,Over Votes,0,0,0,0
Comal,108,Proposition #11,,DEM,Yes,68,16,60,144
Comal,108,Proposition #11,,DEM,No,9,0,7,16
Comal,108,Proposition #11,,DEM,Cast Votes:,77,16,67,160
Comal,108,Proposition #11,,DEM,Under Votes,6,1,4,11
Comal,108,Proposition #11,,DEM,Over Votes,0,0,0,0
Comal,201,President,,REP,Zoltan G. Istvan,0,0,0,0
Comal,201,President,,REP,Bill Weld,1,1,4,6
Comal,201,President,,REP,"Roque ""Rocky"" De La Fuente Guerra",1,0,2,3
Comal,201,President,,REP,Matthew John Matern,0,0,1,1
Comal,201,President,,REP,Donald J. Trump,407,18,270,695
Comal,201,President,,REP,Joe Walsh,4,0,2,6
Comal,201,President,,REP,Bob Ely,1,0,0,1
Comal,201,President,,REP,Uncommitted,13,1,15,29
Comal,201,Ballots Cast,,REP,,427,20,294,741
Comal,201,President,,REP,Under Votes,2,0,0,2
Comal,201,President,,REP,Over Votes,0,0,0,0
Comal,201,U.S. Senate,,REP,John Anthony Castro,32,1,22,55
Comal,201,U.S. Senate,,REP,Virgil Bierschwale,7,0,4,11
Comal,201,U.S. Senate,,REP,John Cornyn,291,15,216,522
Comal,201,U.S. Senate,,REP,Mark Yancey,24,1,18,43
Comal,201,U.S. Senate,,REP,Dwayne Stovall,42,2,22,66
Comal,201,U.S. Senate,,REP,Cast Votes:,396,19,282,697
Comal,201,U.S. Senate,,REP,Under Votes,33,1,12,46
Comal,201,U.S. Senate,,REP,Over Votes,0,0,0,0
Comal,201,U.S. House,35,REP,Jenny Garcia Sharon,167,7,127,301
Comal,201,U.S. House,35,REP,Guillermo William Hayward,98,8,60,166
Comal,201,U.S. House,35,REP,Nick Moutos,92,4,71,167
Comal,201,U.S. House,35,REP,Cast Votes:,357,19,258,634
Comal,201,U.S. House,35,REP,Under Votes,72,1,36,109
Comal,201,U.S. House,35,REP,Over Votes,0,0,0,0
Comal,201,Railroad Commissioner,,REP,"James ""Jim"" Wright",241,12,168,421
Comal,201,Railroad Commissioner,,REP,Ryan Sitton,125,7,101,233
Comal,201,Railroad Commissioner,,REP,Cast Votes:,366,19,269,654
Comal,201,Railroad Commissioner,,REP,Under Votes,63,1,25,89
Comal,201,Railroad Commissioner,,REP,Over Votes,0,0,0,0
Comal,201,"Chief Justice, Supreme Court",,REP,Nathan Hecht,368,18,266,652
Comal,201,"Chief Justice, Supreme Court",,REP,Cast Votes:,368,18,266,652
Comal,201,"Chief Justice, Supreme Court",,REP,Under Votes,61,2,28,91
Comal,201,"Chief Justice, Supreme Court",,REP,Over Votes,0,0,0,0
Comal,201,"Justice, Supreme Court, Place 6 Unexpired Term",,REP,Jane Bland,369,19,267,655
Comal,201,"Justice, Supreme Court, Place 6 Unexpired Term",,REP,Cast Votes:,369,19,267,655
Comal,201,"Justice, Supreme Court, Place 6 Unexpired Term",,REP,Under Votes,60,1,27,88
Comal,201,"Justice, Supreme Court, Place 6 Unexpired Term",,REP,Over Votes,0,0,0,0
Comal,201,"Justice, Supreme Court, Place 7",,REP,Jeff Boyd,370,19,265,654
Comal,201,"Justice, Supreme Court, Place 7",,REP,Cast Votes:,370,19,265,654
Comal,201,"Justice, Supreme Court, Place 7",,REP,Under Votes,59,1,29,89
Comal,201,"Justice, Supreme Court, Place 7",,REP,Over Votes,0,0,0,0
Comal,201,"Justice, Supreme Court, Place 8",,REP,Brett Busby,366,19,260,645
Comal,201,"Justice, Supreme Court, Place 8",,REP,Cast Votes:,366,19,260,645
Comal,201,"Justice, Supreme Court, Place 8",,REP,Under Votes,63,1,34,98
Comal,201,"Justice, Supreme Court, Place 8",,REP,Over Votes,0,0,0,0
Comal,201,"Judge, Court of Criminal Appeals, Place 3",,REP,Gina Parker,172,9,143,324
Comal,201,"Judge, Court of Criminal Appeals, Place 3",,REP,Bert Richardson,189,10,116,315
Comal,201,"Judge, Court of Criminal Appeals, Place 3",,REP,Cast Votes:,361,19,259,639
Comal,201,"Judge, Court of Criminal Appeals, Place 3",,REP,Under Votes,68,1,35,104
Comal,201,"Judge, Court of Criminal Appeals, Place 3",,REP,Over Votes,0,0,0,0
Comal,201,"Judge, Court of Criminal Appeals, Place 4",,REP,Kevin Patrick Yeary,361,19,260,640
Comal,201,"Judge, Court of Criminal Appeals, Place 4",,REP,Cast Votes:,361,19,260,640
Comal,201,"Judge, Court of Criminal Appeals, Place 4",,REP,Under Votes,68,1,34,103
Comal,201,"Judge, Court of Criminal Appeals, Place 4",,REP,Over Votes,0,0,0,0
Comal,201,"Judge, Court of Criminal Appeals, Place 9",,REP,David Newell,362,19,257,638
Comal,201,"Judge, Court of Criminal Appeals, Place 9",,REP,Cast Votes:,362,19,257,638
Comal,201,"Judge, Court of Criminal Appeals, Place 9",,REP,Under Votes,67,1,37,105
Comal,201,"Judge, Court of Criminal Appeals, Place 9",,REP,Over Votes,0,0,0,0
Comal,201,"Member, State Board of Education, District 5",,REP,Lani Popp,122,4,107,233
Comal,201,"Member, State Board of Education, District 5",,REP,Inga Cotton,80,2,49,131
Comal,201,"Member, State Board of Education, District 5",,REP,Robert Morrow,158,13,101,272
Comal,201,"Member, State Board of Education, District 5",,REP,Cast Votes:,360,19,257,636
Comal,201,"Member, State Board of Education, District 5",,REP,Under Votes,69,1,37,107
Comal,201,"Member, State Board of Education, District 5",,REP,Over Votes,0,0,0,0
Comal,201,State Representative,73,REP,Kyle Biedermann,377,19,265,661
Comal,201,State Representative,73,REP,Cast Votes:,377,19,265,661
Comal,201,State Representative,73,REP,Under Votes,52,1,29,82
Comal,201,State Representative,73,REP,Over Votes,0,0,0,0
Comal,201,"Chief Justice, 3rd Court of Appeals District",,REP,Jeff Rose,362,19,259,640
Comal,201,"Chief Justice, 3rd Court of Appeals District",,REP,Cast Votes:,362,19,259,640
Comal,201,"Chief Justice, 3rd Court of Appeals District",,REP,Under Votes,67,1,35,103
Comal,201,"Chief Justice, 3rd Court of Appeals District",,REP,Over Votes,0,0,0,0
Comal,201,"District Judge, 22nd Judicial District",,REP,R. Bruce Boyer,368,19,266,653
Comal,201,"District Judge, 22nd Judicial District",,REP,Cast Votes:,368,19,266,653
Comal,201,"District Judge, 22nd Judicial District",,REP,Under Votes,61,1,28,90
Comal,201,"District Judge, 22nd Judicial District",,REP,Over Votes,0,0,0,0
Comal,201,"District Judge, 433rd Judicial District",,REP,Dib Waldrip,261,12,197,470
Comal,201,"District Judge, 433rd Judicial District",,REP,Charlie Sullivan,124,7,76,207
Comal,201,"District Judge, 433rd Judicial District",,REP,Cast Votes:,385,19,273,677
Comal,201,"District Judge, 433rd Judicial District",,REP,Under Votes,44,1,21,66
Comal,201,"District Judge, 433rd Judicial District",,REP,Over Votes,0,0,0,0
Comal,201,"Judge, County Court at Law No. 2",,REP,"Charles A. Stephens, II",367,19,261,647
Comal,201,"Judge, County Court at Law No. 2",,REP,Cast Votes:,367,19,261,647
Comal,201,"Judge, County Court at Law No. 2",,REP,Under Votes,62,1,33,96
Comal,201,"Judge, County Court at Law No. 2",,REP,Over Votes,0,0,0,0
Comal,201,"Judge, County Court at Law No. 3",,REP,Deborah Linnartz Wigington,362,19,258,639
Comal,201,"Judge, County Court at Law No. 3",,REP,Cast Votes:,362,19,258,639
Comal,201,"Judge, County Court at Law No. 3",,REP,Under Votes,67,1,36,104
Comal,201,"Judge, County Court at Law No. 3",,REP,Over Votes,0,0,0,0
Comal,201,Sheriff,,REP,Mark Reynolds,378,19,268,665
Comal,201,Sheriff,,REP,Cast Votes:,378,19,268,665
Comal,201,Sheriff,,REP,Under Votes,51,1,26,78
Comal,201,Sheriff,,REP,Over Votes,0,0,0,0
Comal,201,County Tax Assessor-Collector,,REP,Kristen H. Hoyt,231,13,170,414
Comal,201,County Tax Assessor-Collector,,REP,Patrick Aten,150,6,105,261
Comal,201,County Tax Assessor-Collector,,REP,Cast Votes:,381,19,275,675
Comal,201,County Tax Assessor-Collector,,REP,Under Votes,48,1,19,68
Comal,201,County Tax Assessor-Collector,,REP,Over Votes,0,0,0,0
Comal,201,"Constable, Precinct No. 2",,REP,Mark Cheatum,367,18,261,646
Comal,201,"Constable, Precinct No. 2",,REP,Cast Votes:,367,18,261,646
Comal,201,"Constable, Precinct No. 2",,REP,Under Votes,62,2,33,97
Comal,201,"Constable, Precinct No. 2",,REP,Over Votes,0,0,0,0
Comal,201,County Chairman,,REP,Sue Piner,360,19,259,638
Comal,201,County Chairman,,REP,Cast Votes:,360,19,259,638
Comal,201,County Chairman,,REP,Under Votes,69,1,35,105
Comal,201,County Chairman,,REP,Over Votes,0,0,0,0
Comal,201,Proposition 1,,REP,Yes,380,19,273,672
Comal,201,Proposition 1,,REP,No,42,1,18,61
Comal,201,Proposition 1,,REP,Cast Votes:,422,20,291,733
Comal,201,Proposition 1,,REP,Under Votes,7,0,3,10
Comal,201,Proposition 1,,REP,Over Votes,0,0,0,0
Comal,201,Proposition 2,,REP,Yes,368,16,255,639
Comal,201,Proposition 2,,REP,No,53,4,31,88
Comal,201,Proposition 2,,REP,Cast Votes:,421,20,286,727
Comal,201,Proposition 2,,REP,Under Votes,8,0,8,16
Comal,201,Proposition 2,,REP,Over Votes,0,0,0,0
Comal,201,Proposition 3,,REP,Yes,393,19,275,687
Comal,201,Proposition 3,,REP,No,19,1,11,31
Comal,201,Proposition 3,,REP,Cast Votes:,412,20,286,718
Comal,201,Proposition 3,,REP,Under Votes,17,0,8,25
Comal,201,Proposition 3,,REP,Over Votes,0,0,0,0
Comal,201,Proposition 4,,REP,Yes,396,19,270,685
Comal,201,Proposition 4,,REP,No,28,1,21,50
Comal,201,Proposition 4,,REP,Cast Votes:,424,20,291,735
Comal,201,Proposition 4,,REP,Under Votes,5,0,3,8
Comal,201,Proposition 4,,REP,Over Votes,0,0,0,0
Comal,201,Proposition 5,,REP,Yes,377,18,258,653
Comal,201,Proposition 5,,REP,No,37,2,26,65
Comal,201,Proposition 5,,REP,Cast Votes:,414,20,284,718
Comal,201,Proposition 5,,REP,Under Votes,15,0,10,25
Comal,201,Proposition 5,,REP,Over Votes,0,0,0,0
Comal,201,Proposition 6,,REP,Yes,397,19,274,690
Comal,201,Proposition 6,,REP,No,20,1,11,32
Comal,201,Proposition 6,,REP,Cast Votes:,417,20,285,722
Comal,201,Proposition 6,,REP,Under Votes,12,0,9,21
Comal,201,Proposition 6,,REP,Over Votes,0,0,0,0
Comal,201,Proposition 7,,REP,Yes,401,20,279,700
Comal,201,Proposition 7,,REP,No,15,0,9,24
Comal,201,Proposition 7,,REP,Cast Votes:,416,20,288,724
Comal,201,Proposition 7,,REP,Under Votes,13,0,6,19
Comal,201,Proposition 7,,REP,Over Votes,0,0,0,0
Comal,201,Proposition 8,,REP,Yes,418,20,284,722
Comal,201,Proposition 8,,REP,No,3,0,5,8
Comal,201,Proposition 8,,REP,Cast Votes:,421,20,289,730
Comal,201,Proposition 8,,REP,Under Votes,8,0,5,13
Comal,201,Proposition 8,,REP,Over Votes,0,0,0,0
Comal,201,Proposition 9,,REP,Yes,394,20,261,675
Comal,201,Proposition 9,,REP,No,26,0,25,51
Comal,201,Proposition 9,,REP,Cast Votes:,420,20,286,726
Comal,201,Proposition 9,,REP,Under Votes,9,0,8,17
Comal,201,Proposition 9,,REP,Over Votes,0,0,0,0
Comal,201,Proposition 10,,REP,Yes,385,20,267,672
Comal,201,Proposition 10,,REP,No,27,0,18,45
Comal,201,Proposition 10,,REP,Cast Votes:,412,20,285,717
Comal,201,Proposition 10,,REP,Under Votes,17,0,9,26
Comal,201,Proposition 10,,REP,Over Votes,0,0,0,0
Comal,202,President,,REP,Zoltan G. Istvan,0,0,0,0
Comal,202,President,,REP,Bill Weld,0,0,0,0
Comal,202,President,,REP,"Roque ""Rocky"" De La Fuente Guerra",1,0,0,1
Comal,202,President,,REP,Matthew John Matern,0,0,0,0
Comal,202,President,,REP,Donald J. Trump,98,9,79,186
Comal,202,President,,REP,Joe Walsh,1,0,0,1
Comal,202,President,,REP,Bob Ely,0,0,0,0
Comal,202,President,,REP,Uncommitted,0,0,2,2
Comal,202,Ballots Cast,,REP,,100,9,81,190
Comal,202,President,,REP,Under Votes,0,0,0,0
Comal,202,President,,REP,Over Votes,0,0,0,0
Comal,202,U.S. Senate,,REP,John Anthony Castro,7,0,2,9
Comal,202,U.S. Senate,,REP,Virgil Bierschwale,2,0,1,3
Comal,202,U.S. Senate,,REP,John Cornyn,73,8,67,148
Comal,202,U.S. Senate,,REP,Mark Yancey,3,0,1,4
Comal,202,U.S. Senate,,REP,Dwayne Stovall,11,1,7,19
Comal,202,U.S. Senate,,REP,Cast Votes:,96,9,78,183
Comal,202,U.S. Senate,,REP,Under Votes,4,0,3,7
Comal,202,U.S. Senate,,REP,Over Votes,0,0,0,0
Comal,202,U.S. House,35,REP,Jenny Garcia Sharon,43,2,28,73
Comal,202,U.S. House,35,REP,Guillermo William Hayward,23,1,21,45
Comal,202,U.S. House,35,REP,Nick Moutos,19,6,18,43
Comal,202,U.S. House,35,REP,Cast Votes:,85,9,67,161
Comal,202,U.S. House,35,REP,Under Votes,15,0,14,29
Comal,202,U.S. House,35,REP,Over Votes,0,0,0,0
Comal,202,Railroad Commissioner,,REP,"James ""Jim"" Wright",42,5,33,80
Comal,202,Railroad Commissioner,,REP,Ryan Sitton,46,4,41,91
Comal,202,Railroad Commissioner,,REP,Cast Votes:,88,9,74,171
Comal,202,Railroad Commissioner,,REP,Under Votes,12,0,7,19
Comal,202,Railroad Commissioner,,REP,Over Votes,0,0,0,0
Comal,202,"Chief Justice, Supreme Court",,REP,Nathan Hecht,84,9,70,163
Comal,202,"Chief Justice, Supreme Court",,REP,Cast Votes:,84,9,70,163
Comal,202,"Chief Justice, Supreme Court",,REP,Under Votes,16,0,11,27
Comal,202,"Chief Justice, Supreme Court",,REP,Over Votes,0,0,0,0
Comal,202,"Justice, Supreme Court, Place 6 Unexpired Term",,REP,Jane Bland,83,9,70,162
Comal,202,"Justice, Supreme Court, Place 6 Unexpired Term",,REP,Cast Votes:,83,9,70,162
Comal,202,"Justice, Supreme Court, Place 6 Unexpired Term",,REP,Under Votes,17,0,11,28
Comal,202,"Justice, Supreme Court, Place 6 Unexpired Term",,REP,Over Votes,0,0,0,0
Comal,202,"Justice, Supreme Court, Place 7",,REP,Jeff Boyd,82,9,67,158
Comal,202,"Justice, Supreme Court, Place 7",,REP,Cast Votes:,82,9,67,158
Comal,202,"Justice, Supreme Court, Place 7",,REP,Under Votes,18,0,14,32
Comal,202,"Justice, Supreme Court, Place 7",,REP,Over Votes,0,0,0,0
Comal,202,"Justice, Supreme Court, Place 8",,REP,Brett Busby,84,9,69,162
Comal,202,"Justice, Supreme Court, Place 8",,REP,Cast Votes:,84,9,69,162
Comal,202,"Justice, Supreme Court, Place 8",,REP,Under Votes,16,0,12,28
Comal,202,"Justice, Supreme Court, Place 8",,REP,Over Votes,0,0,0,0
Comal,202,"Judge, Court of Criminal Appeals, Place 3",,REP,Gina Parker,46,5,37,88
Comal,202,"Judge, Court of Criminal Appeals, Place 3",,REP,Bert Richardson,39,4,31,74
Comal,202,"Judge, Court of Criminal Appeals, Place 3",,REP,Cast Votes:,85,9,68,162
Comal,202,"Judge, Court of Criminal Appeals, Place 3",,REP,Under Votes,15,0,13,28
Comal,202,"Judge, Court of Criminal Appeals, Place 3",,REP,Over Votes,0,0,0,0
Comal,202,"Judge, Court of Criminal Appeals, Place 4",,REP,Kevin Patrick Yeary,81,8,68,157
Comal,202,"Judge, Court of Criminal Appeals, Place 4",,REP,Cast Votes:,81,8,68,157
Comal,202,"Judge, Court of Criminal Appeals, Place 4",,REP,Under Votes,19,1,13,33
Comal,202,"Judge, Court of Criminal Appeals, Place 4",,REP,Over Votes,0,0,0,0
Comal,202,"Judge, Court of Criminal Appeals, Place 9",,REP,David Newell,80,8,68,156
Comal,202,"Judge, Court of Criminal Appeals, Place 9",,REP,Cast Votes:,80,8,68,156
Comal,202,"Judge, Court of Criminal Appeals, Place 9",,REP,Under Votes,20,1,13,34
Comal,202,"Judge, Court of Criminal Appeals, Place 9",,REP,Over Votes,0,0,0,0
Comal,202,"Member, State Board of Education, District 5",,REP,Lani Popp,31,3,37,71
Comal,202,"Member, State Board of Education, District 5",,REP,Inga Cotton,24,3,14,41
Comal,202,"Member, State Board of Education, District 5",,REP,Robert Morrow,30,3,20,53
Comal,202,"Member, State Board of Education, District 5",,REP,Cast Votes:,85,9,71,165
Comal,202,"Member, State Board of Education, District 5",,REP,Under Votes,15,0,10,25
Comal,202,"Member, State Board of Education, District 5",,REP,Over Votes,0,0,0,0
Comal,202,State Representative,73,REP,Kyle Biedermann,84,9,70,163
Comal,202,State Representative,73,REP,Cast Votes:,84,9,70,163
Comal,202,State Representative,73,REP,Under Votes,16,0,11,27
Comal,202,State Representative,73,REP,Over Votes,0,0,0,0
Comal,202,"Chief Justice, 3rd Court of Appeals District",,REP,Jeff Rose,80,9,69,158
Comal,202,"Chief Justice, 3rd Court of Appeals District",,REP,Cast Votes:,80,9,69,158
Comal,202,"Chief Justice, 3rd Court of Appeals District",,REP,Under Votes,20,0,12,32
Comal,202,"Chief Justice, 3rd Court of Appeals District",,REP,Over Votes,0,0,0,0
Comal,202,"District Judge, 22nd Judicial District",,REP,R. Bruce Boyer,78,9,67,154
Comal,202,"District Judge, 22nd Judicial District",,REP,Cast Votes:,78,9,67,154
Comal,202,"District Judge, 22nd Judicial District",,REP,Under Votes,22,0,14,36
Comal,202,"District Judge, 22nd Judicial District",,REP,Over Votes,0,0,0,0
Comal,202,"District Judge, 433rd Judicial District",,REP,Dib Waldrip,53,8,34,95
Comal,202,"District Judge, 433rd Judicial District",,REP,Charlie Sullivan,32,1,34,67
Comal,202,"District Judge, 433rd Judicial District",,REP,Cast Votes:,85,9,68,162
Comal,202,"District Judge, 433rd Judicial District",,REP,Under Votes,15,0,13,28
Comal,202,"District Judge, 433rd Judicial District",,REP,Over Votes,0,0,0,0
Comal,202,"Judge, County Court at Law No. 2",,REP,"Charles A. Stephens, II",79,9,68,156
Comal,202,"Judge, County Court at Law No. 2",,REP,Cast Votes:,79,9,68,156
Comal,202,"Judge, County Court at Law No. 2",,REP,Under Votes,21,0,13,34
Comal,202,"Judge, County Court at Law No. 2",,REP,Over Votes,0,0,0,0
Comal,202,"Judge, County Court at Law No. 3",,REP,Deborah Linnartz Wigington,78,9,67,154
Comal,202,"Judge, County Court at Law No. 3",,REP,Cast Votes:,78,9,67,154
Comal,202,"Judge, County Court at Law No. 3",,REP,Under Votes,22,0,14,36
Comal,202,"Judge, County Court at Law No. 3",,REP,Over Votes,0,0,0,0
Comal,202,Sheriff,,REP,Mark Reynolds,82,9,68,159
Comal,202,Sheriff,,REP,Cast Votes:,82,9,68,159
Comal,202,Sheriff,,REP,Under Votes,18,0,13,31
Comal,202,Sheriff,,REP,Over Votes,0,0,0,0
Comal,202,County Tax Assessor-Collector,,REP,Kristen H. Hoyt,61,5,45,111
Comal,202,County Tax Assessor-Collector,,REP,Patrick Aten,24,4,25,53
Comal,202,County Tax Assessor-Collector,,REP,Cast Votes:,85,9,70,164
Comal,202,County Tax Assessor-Collector,,REP,Under Votes,15,0,11,26
Comal,202,County Tax Assessor-Collector,,REP,Over Votes,0,0,0,0
Comal,202,"Constable, Precinct No. 2",,REP,Mark Cheatum,80,9,67,156
Comal,202,"Constable, Precinct No. 2",,REP,Cast Votes:,80,9,67,156
Comal,202,"Constable, Precinct No. 2",,REP,Under Votes,20,0,14,34
Comal,202,"Constable, Precinct No. 2",,REP,Over Votes,0,0,0,0
Comal,202,County Chairman,,REP,Sue Piner,79,9,67,155
Comal,202,County Chairman,,REP,Cast Votes:,79,9,67,155
Comal,202,County Chairman,,REP,Under Votes,21,0,14,35
Comal,202,County Chairman,,REP,Over Votes,0,0,0,0
Comal,202,Proposition 1,,REP,Yes,89,8,73,170
Comal,202,Proposition 1,,REP,No,11,1,6,18
Comal,202,Proposition 1,,REP,Cast Votes:,100,9,79,188
Comal,202,Proposition 1,,REP,Under Votes,0,0,2,2
Comal,202,Proposition 1,,REP,Over Votes,0,0,0,0
Comal,202,Proposition 2,,REP,Yes,88,6,70,164
Comal,202,Proposition 2,,REP,No,11,3,10,24
Comal,202,Proposition 2,,REP,Cast Votes:,99,9,80,188
Comal,202,Proposition 2,,REP,Under Votes,1,0,1,2
Comal,202,Proposition 2,,REP,Over Votes,0,0,0,0
Comal,202,Proposition 3,,REP,Yes,93,9,73,175
Comal,202,Proposition 3,,REP,No,5,0,2,7
Comal,202,Proposition 3,,REP,Cast Votes:,98,9,75,182
Comal,202,Proposition 3,,REP,Under Votes,2,0,6,8
Comal,202,Proposition 3,,REP,Over Votes,0,0,0,0
Comal,202,Proposition 4,,REP,Yes,93,9,73,175
Comal,202,Proposition 4,,REP,No,5,0,2,7
Comal,202,Proposition 4,,REP,Cast Votes:,98,9,75,182
Comal,202,Proposition 4,,REP,Under Votes,2,0,6,8
Comal,202,Proposition 4,,REP,Over Votes,0,0,0,0
Comal,202,Proposition 5,,REP,Yes,86,7,69,162
Comal,202,Proposition 5,,REP,No,10,2,8,20
Comal,202,Proposition 5,,REP,Cast Votes:,96,9,77,182
Comal,202,Proposition 5,,REP,Under Votes,4,0,4,8
Comal,202,Proposition 5,,REP,Over Votes,0,0,0,0
Comal,202,Proposition 6,,REP,Yes,96,7,74,177
Comal,202,Proposition 6,,REP,No,1,2,2,5
Comal,202,Proposition 6,,REP,Cast Votes:,97,9,76,182
Comal,202,Proposition 6,,REP,Under Votes,3,0,5,8
Comal,202,Proposition 6,,REP,Over Votes,0,0,0,0
Comal,202,Proposition 7,,REP,Yes,98,9,74,181
Comal,202,Proposition 7,,REP,No,1,0,5,6
Comal,202,Proposition 7,,REP,Cast Votes:,99,9,79,187
Comal,202,Proposition 7,,REP,Under Votes,1,0,2,3
Comal,202,Proposition 7,,REP,Over Votes,0,0,0,0
Comal,202,Proposition 8,,REP,Yes,96,9,75,180
Comal,202,Proposition 8,,REP,No,2,0,1,3
Comal,202,Proposition 8,,REP,Cast Votes:,98,9,76,183
Comal,202,Proposition 8,,REP,Under Votes,2,0,5,7
Comal,202,Proposition 8,,REP,Over Votes,0,0,0,0
Comal,202,Proposition 9,,REP,Yes,95,9,74,178
Comal,202,Proposition 9,,REP,No,4,0,4,8
Comal,202,Proposition 9,,REP,Cast Votes:,99,9,78,186
Comal,202,Proposition 9,,REP,Under Votes,1,0,3,4
Comal,202,Proposition 9,,REP,Over Votes,0,0,0,0
Comal,202,Proposition 10,,REP,Yes,88,9,74,171
Comal,202,Proposition 10,,REP,No,8,0,5,13
Comal,202,Proposition 10,,REP,Cast Votes:,96,9,79,184
Comal,202,Proposition 10,,REP,Under Votes,4,0,2,6
Comal,202,Proposition 10,,REP,Over Votes,0,0,0,0
Comal,203,President,,REP,Zoltan G. Istvan,0,0,0,0
Comal,203,President,,REP,Bill Weld,4,0,6,10
Comal,203,President,,REP,"Roque ""Rocky"" De La Fuente Guerra",0,0,0,0
Comal,203,President,,REP,Matthew John Matern,0,0,1,1
Comal,203,President,,REP,Donald J. Trump,375,28,522,925
Comal,203,President,,REP,Joe Walsh,2,0,2,4
Comal,203,President,,REP,Bob Ely,0,0,3,3
Comal,203,President,,REP,Uncommitted,14,3,18,35
Comal,203,Ballots Cast,,REP,,395,31,552,978
Comal,203,President,,REP,Under Votes,2,2,2,6
Comal,203,President,,REP,Over Votes,0,0,0,0
Comal,203,U.S. Senate,,REP,John Anthony Castro,21,0,15,36
Comal,203,U.S. Senate,,REP,Virgil Bierschwale,3,0,2,5
Comal,203,U.S. Senate,,REP,John Cornyn,318,31,471,820
Comal,203,U.S. Senate,,REP,Mark Yancey,15,0,8,23
Comal,203,U.S. Senate,,REP,Dwayne Stovall,15,0,39,54
Comal,203,U.S. Senate,,REP,Cast Votes:,372,31,535,938
Comal,203,U.S. Senate,,REP,Under Votes,25,2,19,46
Comal,203,U.S. Senate,,REP,Over Votes,0,0,0,0
Comal,203,U.S. House,21,REP,Chip Roy,367,31,516,914
Comal,203,U.S. House,21,REP,Cast Votes:,367,31,516,914
Comal,203,U.S. House,21,REP,Under Votes,30,2,38,70
Comal,203,U.S. House,21,REP,Over Votes,0,0,0,0
Comal,203,Railroad Commissioner,,REP,"James ""Jim"" Wright",211,17,263,491
Comal,203,Railroad Commissioner,,REP,Ryan Sitton,127,14,239,380
Comal,203,Railroad Commissioner,,REP,Cast Votes:,338,31,502,871
Comal,203,Railroad Commissioner,,REP,Under Votes,59,2,52,113
Comal,203,Railroad Commissioner,,REP,Over Votes,0,0,0,0
Comal,203,"Chief Justice, Supreme Court",,REP,Nathan Hecht,342,27,495,864
Comal,203,"Chief Justice, Supreme Court",,REP,Cast Votes:,342,27,495,864
Comal,203,"Chief Justice, Supreme Court",,REP,Under Votes,55,6,59,120
Comal,203,"Chief Justice, Supreme Court",,REP,Over Votes,0,0,0,0
Comal,203,"Justice, Supreme Court, Place 6 Unexpired Term",,REP,Jane Bland,331,27,488,846
Comal,203,"Justice, Supreme Court, Place 6 Unexpired Term",,REP,Cast Votes:,331,27,488,846
Comal,203,"Justice, Supreme Court, Place 6 Unexpired Term",,REP,Under Votes,66,6,66,138
Comal,203,"Justice, Supreme Court, Place 6 Unexpired Term",,REP,Over Votes,0,0,0,0
Comal,203,"Justice, Supreme Court, Place 7",,REP,Jeff Boyd,336,27,492,855
Comal,203,"Justice, Supreme Court, Place 7",,REP,Cast Votes:,336,27,492,855
Comal,203,"Justice, Supreme Court, Place 7",,REP,Under Votes,61,6,62,129
Comal,203,"Justice, Supreme Court, Place 7",,REP,Over Votes,0,0,0,0
Comal,203,"Justice, Supreme Court, Place 8",,REP,Brett Busby,336,25,490,851
Comal,203,"Justice, Supreme Court, Place 8",,REP,Cast Votes:,336,25,490,851
Comal,203,"Justice, Supreme Court, Place 8",,REP,Under Votes,61,8,64,133
Comal,203,"Justice, Supreme Court, Place 8",,REP,Over Votes,0,0,0,0
Comal,203,"Judge, Court of Criminal Appeals, Place 3",,REP,Gina Parker,164,15,213,392
Comal,203,"Judge, Court of Criminal Appeals, Place 3",,REP,Bert Richardson,164,14,266,444
Comal,203,"Judge, Court of Criminal Appeals, Place 3",,REP,Cast Votes:,328,29,479,836
Comal,203,"Judge, Court of Criminal Appeals, Place 3",,REP,Under Votes,69,4,75,148
Comal,203,"Judge, Court of Criminal Appeals, Place 3",,REP,Over Votes,0,0,0,0
Comal,203,"Judge, Court of Criminal Appeals, Place 4",,REP,Kevin Patrick Yeary,331,26,488,845
Comal,203,"Judge, Court of Criminal Appeals, Place 4",,REP,Cast Votes:,331,26,488,845
Comal,203,"Judge, Court of Criminal Appeals, Place 4",,REP,Under Votes,66,7,66,139
Comal,203,"Judge, Court of Criminal Appeals, Place 4",,REP,Over Votes,0,0,0,0
Comal,203,"Judge, Court of Criminal Appeals, Place 9",,REP,David Newell,332,26,489,847
Comal,203,"Judge, Court of Criminal Appeals, Place 9",,REP,Cast Votes:,332,26,489,847
Comal,203,"Judge, Court of Criminal Appeals, Place 9",,REP,Under Votes,65,7,65,137
Comal,203,"Judge, Court of Criminal Appeals, Place 9",,REP,Over Votes,0,0,0,0
Comal,203,"Member, State Board of Education, District 5",,REP,Lani Popp,112,9,196,317
Comal,203,"Member, State Board of Education, District 5",,REP,Inga Cotton,99,4,97,200
Comal,203,"Member, State Board of Education, District 5",,REP,Robert Morrow,112,14,183,309
Comal,203,"Member, State Board of Education, District 5",,REP,Cast Votes:,323,27,476,826
Comal,203,"Member, State Board of Education, District 5",,REP,Under Votes,74,6,78,158
Comal,203,"Member, State Board of Education, District 5",,REP,Over Votes,0,0,0,0
Comal,203,State Representative,73,REP,Kyle Biedermann,352,28,483,863
Comal,203,State Representative,73,REP,Cast Votes:,352,28,483,863
Comal,203,State Representative,73,REP,Under Votes,45,5,71,121
Comal,203,State Representative,73,REP,Over Votes,0,0,0,0
Comal,203,"Chief Justice, 3rd Court of Appeals District",,REP,Jeff Rose,332,25,490,847
Comal,203,"Chief Justice, 3rd Court of Appeals District",,REP,Cast Votes:,332,25,490,847
Comal,203,"Chief Justice, 3rd Court of Appeals District",,REP,Under Votes,65,8,64,137
Comal,203,"Chief Justice, 3rd Court of Appeals District",,REP,Over Votes,0,0,0,0
Comal,203,"District Judge, 22nd Judicial District",,REP,R. Bruce Boyer,356,25,493,874
Comal,203,"District Judge, 22nd Judicial District",,REP,Cast Votes:,356,25,493,874
Comal,203,"District Judge, 22nd Judicial District",,REP,Under Votes,41,8,61,110
Comal,203,"District Judge, 22nd Judicial District",,REP,Over Votes,0,0,0,0
Comal,203,"District Judge, 433rd Judicial District",,REP,Dib Waldrip,277,23,426,726
Comal,203,"District Judge, 433rd Judicial District",,REP,Charlie Sullivan,91,7,96,194
Comal,203,"District Judge, 433rd Judicial District",,REP,Cast Votes:,368,30,522,920
Comal,203,"District Judge, 433rd Judicial District",,REP,Under Votes,29,3,32,64
Comal,203,"District Judge, 433rd Judicial District",,REP,Over Votes,0,0,0,0
Comal,203,"Judge, County Court at Law No. 2",,REP,"Charles A. Stephens, II",345,27,498,870
Comal,203,"Judge, County Court at Law No. 2",,REP,Cast Votes:,345,27,498,870
Comal,203,"Judge, County Court at Law No. 2",,REP,Under Votes,52,6,56,114
Comal,203,"Judge, County Court at Law No. 2",,REP,Over Votes,0,0,0,0
Comal,203,"Judge, County Court at Law No. 3",,REP,Deborah Linnartz Wigington,340,27,483,850
Comal,203,"Judge, County Court at Law No. 3",,REP,Cast Votes:,340,27,483,850
Comal,203,"Judge, County Court at Law No. 3",,REP,Under Votes,57,6,71,134
Comal,203,"Judge, County Court at Law No. 3",,REP,Over Votes,0,0,0,0
Comal,203,Sheriff,,REP,Mark Reynolds,351,29,502,882
Comal,203,Sheriff,,REP,Cast Votes:,351,29,502,882
Comal,203,Sheriff,,REP,Under Votes,46,4,52,102
Comal,203,Sheriff,,REP,Over Votes,0,0,0,0
Comal,203,County Tax Assessor-Collector,,REP,Kristen H. Hoyt,185,21,231,437
Comal,203,County Tax Assessor-Collector,,REP,Patrick Aten,175,11,285,471
Comal,203,County Tax Assessor-Collector,,REP,Cast Votes:,360,32,516,908
Comal,203,County Tax Assessor-Collector,,REP,Under Votes,37,1,38,76
Comal,203,County Tax Assessor-Collector,,REP,Over Votes,0,0,0,0
Comal,203,"Constable, Precinct No. 2",,REP,Mark Cheatum,339,25,485,849
Comal,203,"Constable, Precinct No. 2",,REP,Cast Votes:,339,25,485,849
Comal,203,"Constable, Precinct No. 2",,REP,Under Votes,58,8,69,135
Comal,203,"Constable, Precinct No. 2",,REP,Over Votes,0,0,0,0
Comal,203,County Chairman,,REP,Sue Piner,338,26,481,845
Comal,203,County Chairman,,REP,Cast Votes:,338,26,481,845
Comal,203,County Chairman,,REP,Under Votes,59,7,73,139
Comal,203,County Chairman,,REP,Over Votes,0,0,0,0
Comal,203,Proposition 1,,REP,Yes,360,32,512,904
Comal,203,Proposition 1,,REP,No,27,1,29,57
Comal,203,Proposition 1,,REP,Cast Votes:,387,33,541,961
Comal,203,Proposition 1,,REP,Under Votes,10,0,13,23
Comal,203,Proposition 1,,REP,Over Votes,0,0,0,0
Comal,203,Proposition 2,,REP,Yes,352,30,482,864
Comal,203,Proposition 2,,REP,No,40,3,63,106
Comal,203,Proposition 2,,REP,Cast Votes:,392,33,545,970
Comal,203,Proposition 2,,REP,Under Votes,5,0,9,14
Comal,203,Proposition 2,,REP,Over Votes,0,0,0,0
Comal,203,Proposition 3,,REP,Yes,374,31,508,913
Comal,203,Proposition 3,,REP,No,15,2,31,48
Comal,203,Proposition 3,,REP,Cast Votes:,389,33,539,961
Comal,203,Proposition 3,,REP,Under Votes,8,0,15,23
Comal,203,Proposition 3,,REP,Over Votes,0,0,0,0
Comal,203,Proposition 4,,REP,Yes,371,31,512,914
Comal,203,Proposition 4,,REP,No,20,2,29,51
Comal,203,Proposition 4,,REP,Cast Votes:,391,33,541,965
Comal,203,Proposition 4,,REP,Under Votes,6,0,13,19
Comal,203,Proposition 4,,REP,Over Votes,0,0,0,0
Comal,203,Proposition 5,,REP,Yes,355,29,472,856
Comal,203,Proposition 5,,REP,No,32,4,69,105
Comal,203,Proposition 5,,REP,Cast Votes:,387,33,541,961
Comal,203,Proposition 5,,REP,Under Votes,10,0,13,23
Comal,203,Proposition 5,,REP,Over Votes,0,0,0,0
Comal,203,Proposition 6,,REP,Yes,370,32,512,914
Comal,203,Proposition 6,,REP,No,19,1,21,41
Comal,203,Proposition 6,,REP,Cast Votes:,389,33,533,955
Comal,203,Proposition 6,,REP,Under Votes,8,0,21,29
Comal,203,Proposition 6,,REP,Over Votes,0,0,0,0
Comal,203,Proposition 7,,REP,Yes,381,32,508,921
Comal,203,Proposition 7,,REP,No,9,0,28,37
Comal,203,Proposition 7,,REP,Cast Votes:,390,32,536,958
Comal,203,Proposition 7,,REP,Under Votes,7,1,18,26
Comal,203,Proposition 7,,REP,Over Votes,0,0,0,0
Comal,203,Proposition 8,,REP,Yes,384,33,540,957
Comal,203,Proposition 8,,REP,No,6,0,8,14
Comal,203,Proposition 8,,REP,Cast Votes:,390,33,548,971
Comal,203,Proposition 8,,REP,Under Votes,7,0,6,13
Comal,203,Proposition 8,,REP,Over Votes,0,0,0,0
Comal,203,Proposition 9,,REP,Yes,377,32,518,927
Comal,203,Proposition 9,,REP,No,11,1,24,36
Comal,203,Proposition 9,,REP,Cast Votes:,388,33,542,963
Comal,203,Proposition 9,,REP,Under Votes,9,0,12,21
Comal,203,Proposition 9,,REP,Over Votes,0,0,0,0
Comal,203,Proposition 10,,REP,Yes,370,30,497,897
Comal,203,Proposition 10,,REP,No,17,3,37,57
Comal,203,Proposition 10,,REP,Cast Votes:,387,33,534,954
Comal,203,Proposition 10,,REP,Under Votes,10,0,20,30
Comal,203,Proposition 10,,REP,Over Votes,0,0,0,0
Comal,204,President,,REP,Zoltan G. Istvan,0,0,1,1
Comal,204,President,,REP,Bill Weld,1,1,1,3
Comal,204,President,,REP,"Roque ""Rocky"" De La Fuente Guerra",0,0,0,0
Comal,204,President,,REP,Matthew John Matern,0,0,0,0
Comal,204,President,,REP,Donald J. Trump,285,22,452,759
Comal,204,President,,REP,Joe Walsh,2,0,2,4
Comal,204,President,,REP,Bob Ely,0,0,0,0
Comal,204,President,,REP,Uncommitted,6,1,13,20
Comal,204,Ballots Cast,,REP,,294,24,469,787
Comal,204,President,,REP,Under Votes,1,1,2,4
Comal,204,President,,REP,Over Votes,0,0,0,0
Comal,204,U.S. Senate,,REP,John Anthony Castro,20,0,14,34
Comal,204,U.S. Senate,,REP,Virgil Bierschwale,4,2,11,17
Comal,204,U.S. Senate,,REP,John Cornyn,210,22,361,593
Comal,204,U.S. Senate,,REP,Mark Yancey,15,1,13,29
Comal,204,U.S. Senate,,REP,Dwayne Stovall,30,0,50,80
Comal,204,U.S. Senate,,REP,Cast Votes:,279,25,449,753
Comal,204,U.S. Senate,,REP,Under Votes,16,0,22,38
Comal,204,U.S. Senate,,REP,Over Votes,0,0,0,0
Comal,204,U.S. House,21,REP,Chip Roy,283,24,437,744
Comal,204,U.S. House,21,REP,Cast Votes:,283,24,437,744
Comal,204,U.S. House,21,REP,Under Votes,12,1,34,47
Comal,204,U.S. House,21,REP,Over Votes,0,0,0,0
Comal,204,Railroad Commissioner,,REP,"James ""Jim"" Wright",150,11,204,365
Comal,204,Railroad Commissioner,,REP,Ryan Sitton,120,12,219,351
Comal,204,Railroad Commissioner,,REP,Cast Votes:,270,23,423,716
Comal,204,Railroad Commissioner,,REP,Under Votes,25,2,48,75
Comal,204,Railroad Commissioner,,REP,Over Votes,0,0,0,0
Comal,204,"Chief Justice, Supreme Court",,REP,Nathan Hecht,266,22,414,702
Comal,204,"Chief Justice, Supreme Court",,REP,Cast Votes:,266,22,414,702
Comal,204,"Chief Justice, Supreme Court",,REP,Under Votes,29,3,57,89
Comal,204,"Chief Justice, Supreme Court",,REP,Over Votes,0,0,0,0
Comal,204,"Justice, Supreme Court, Place 6 Unexpired Term",,REP,Jane Bland,262,22,402,686
Comal,204,"Justice, Supreme Court, Place 6 Unexpired Term",,REP,Cast Votes:,262,22,402,686
Comal,204,"Justice, Supreme Court, Place 6 Unexpired Term",,REP,Under Votes,33,3,69,105
Comal,204,"Justice, Supreme Court, Place 6 Unexpired Term",,REP,Over Votes,0,0,0,0
Comal,204,"Justice, Supreme Court, Place 7",,REP,Jeff Boyd,259,22,414,695
Comal,204,"Justice, Supreme Court, Place 7",,REP,Cast Votes:,259,22,414,695
Comal,204,"Justice, Supreme Court, Place 7",,REP,Under Votes,36,3,57,96
Comal,204,"Justice, Supreme Court, Place 7",,REP,Over Votes,0,0,0,0
Comal,204,"Justice, Supreme Court, Place 8",,REP,Brett Busby,259,22,409,690
Comal,204,"Justice, Supreme Court, Place 8",,REP,Cast Votes:,259,22,409,690
Comal,204,"Justice, Supreme Court, Place 8",,REP,Under Votes,36,3,62,101
Comal,204,"Justice, Supreme Court, Place 8",,REP,Over Votes,0,0,0,0
Comal,204,"Judge, Court of Criminal Appeals, Place 3",,REP,Gina Parker,136,8,197,341
Comal,204,"Judge, Court of Criminal Appeals, Place 3",,REP,Bert Richardson,125,14,225,364
Comal,204,"Judge, Court of Criminal Appeals, Place 3",,REP,Cast Votes:,261,22,422,705
Comal,204,"Judge, Court of Criminal Appeals, Place 3",,REP,Under Votes,34,3,49,86
Comal,204,"Judge, Court of Criminal Appeals, Place 3",,REP,Over Votes,0,0,0,0
Comal,204,"Judge, Court of Criminal Appeals, Place 4",,REP,Kevin Patrick Yeary,257,22,410,689
Comal,204,"Judge, Court of Criminal Appeals, Place 4",,REP,Cast Votes:,257,22,410,689
Comal,204,"Judge, Court of Criminal Appeals, Place 4",,REP,Under Votes,38,3,61,102
Comal,204,"Judge, Court of Criminal Appeals, Place 4",,REP,Over Votes,0,0,0,0
Comal,204,"Judge, Court of Criminal Appeals, Place 9",,REP,David Newell,252,22,405,679
Comal,204,"Judge, Court of Criminal Appeals, Place 9",,REP,Cast Votes:,252,22,405,679
Comal,204,"Judge, Court of Criminal Appeals, Place 9",,REP,Under Votes,43,3,66,112
Comal,204,"Judge, Court of Criminal Appeals, Place 9",,REP,Over Votes,0,0,0,0
Comal,204,"Member, State Board of Education, District 5",,REP,Lani Popp,114,12,201,327
Comal,204,"Member, State Board of Education, District 5",,REP,Inga Cotton,38,5,71,114
Comal,204,"Member, State Board of Education, District 5",,REP,Robert Morrow,100,7,140,247
Comal,204,"Member, State Board of Education, District 5",,REP,Cast Votes:,252,24,412,688
Comal,204,"Member, State Board of Education, District 5",,REP,Under Votes,43,1,59,103
Comal,204,"Member, State Board of Education, District 5",,REP,Over Votes,0,0,0,0
Comal,204,State Representative,73,REP,Kyle Biedermann,268,23,403,694
Comal,204,State Representative,73,REP,Cast Votes:,268,23,403,694
Comal,204,State Representative,73,REP,Under Votes,27,2,68,97
Comal,204,State Representative,73,REP,Over Votes,0,0,0,0
Comal,204,"Chief Justice, 3rd Court of Appeals District",,REP,Jeff Rose,251,21,399,671
Comal,204,"Chief Justice, 3rd Court of Appeals District",,REP,Cast Votes:,251,21,399,671
Comal,204,"Chief Justice, 3rd Court of Appeals District",,REP,Under Votes,44,4,72,120
Comal,204,"Chief Justice, 3rd Court of Appeals District",,REP,Over Votes,0,0,0,0
Comal,204,"District Judge, 22nd Judicial District",,REP,R. Bruce Boyer,254,21,399,674
Comal,204,"District Judge, 22nd Judicial District",,REP,Cast Votes:,254,21,399,674
Comal,204,"District Judge, 22nd Judicial District",,REP,Under Votes,41,4,72,117
Comal,204,"District Judge, 22nd Judicial District",,REP,Over Votes,0,0,0,0
Comal,204,"District Judge, 433rd Judicial District",,REP,Dib Waldrip,187,16,310,513
Comal,204,"District Judge, 433rd Judicial District",,REP,Charlie Sullivan,84,7,120,211
Comal,204,"District Judge, 433rd Judicial District",,REP,Cast Votes:,271,23,430,724
Comal,204,"District Judge, 433rd Judicial District",,REP,Under Votes,24,2,40,66
Comal,204,"District Judge, 433rd Judicial District",,REP,Over Votes,0,0,1,1
Comal,204,"Judge, County Court at Law No. 2",,REP,"Charles A. Stephens, II",251,21,404,676
Comal,204,"Judge, County Court at Law No. 2",,REP,Cast Votes:,251,21,404,676
Comal,204,"Judge, County Court at Law No. 2",,REP,Under Votes,44,4,67,115
Comal,204,"Judge, County Court at Law No. 2",,REP,Over Votes,0,0,0,0
Comal,204,"Judge, County Court at Law No. 3",,REP,Deborah Linnartz Wigington,249,21,394,664
Comal,204,"Judge, County Court at Law No. 3",,REP,Cast Votes:,249,21,394,664
Comal,204,"Judge, County Court at Law No. 3",,REP,Under Votes,46,4,77,127
Comal,204,"Judge, County Court at Law No. 3",,REP,Over Votes,0,0,0,0
Comal,204,Sheriff,,REP,Mark Reynolds,257,22,406,685
Comal,204,Sheriff,,REP,Cast Votes:,257,22,406,685
Comal,204,Sheriff,,REP,Under Votes,38,3,65,106
Comal,204,Sheriff,,REP,Over Votes,0,0,0,0
Comal,204,County Tax Assessor-Collector,,REP,Kristen H. Hoyt,181,5,246,432
Comal,204,County Tax Assessor-Collector,,REP,Patrick Aten,83,18,187,288
Comal,204,County Tax Assessor-Collector,,REP,Cast Votes:,264,23,433,720
Comal,204,County Tax Assessor-Collector,,REP,Under Votes,31,2,37,70
Comal,204,County Tax Assessor-Collector,,REP,Over Votes,0,0,1,1
Comal,204,"Constable, Precinct No. 2",,REP,Mark Cheatum,258,21,408,687
Comal,204,"Constable, Precinct No. 2",,REP,Cast Votes:,258,21,408,687
Comal,204,"Constable, Precinct No. 2",,REP,Under Votes,37,4,63,104
Comal,204,"Constable, Precinct No. 2",,REP,Over Votes,0,0,0,0
Comal,204,County Chairman,,REP,Sue Piner,248,22,397,667
Comal,204,County Chairman,,REP,Cast Votes:,248,22,397,667
Comal,204,County Chairman,,REP,Under Votes,47,3,74,124
Comal,204,County Chairman,,REP,Over Votes,0,0,0,0
Comal,204,Proposition 1,,REP,Yes,272,20,432,724
Comal,204,Proposition 1,,REP,No,21,5,32,58
Comal,204,Proposition 1,,REP,Cast Votes:,293,25,464,782
Comal,204,Proposition 1,,REP,Under Votes,2,0,7,9
Comal,204,Proposition 1,,REP,Over Votes,0,0,0,0
Comal,204,Proposition 2,,REP,Yes,256,21,426,703
Comal,204,Proposition 2,,REP,No,33,4,36,73
Comal,204,Proposition 2,,REP,Cast Votes:,289,25,462,776
Comal,204,Proposition 2,,REP,Under Votes,6,0,9,15
Comal,204,Proposition 2,,REP,Over Votes,0,0,0,0
Comal,204,Proposition 3,,REP,Yes,276,25,443,744
Comal,204,Proposition 3,,REP,No,14,0,18,32
Comal,204,Proposition 3,,REP,Cast Votes:,290,25,461,776
Comal,204,Proposition 3,,REP,Under Votes,5,0,10,15
Comal,204,Proposition 3,,REP,Over Votes,0,0,0,0
Comal,204,Proposition 4,,REP,Yes,273,24,446,743
Comal,204,Proposition 4,,REP,No,13,1,18,32
Comal,204,Proposition 4,,REP,Cast Votes:,286,25,464,775
Comal,204,Proposition 4,,REP,Under Votes,9,0,7,16
Comal,204,Proposition 4,,REP,Over Votes,0,0,0,0
Comal,204,Proposition 5,,REP,Yes,276,20,431,727
Comal,204,Proposition 5,,REP,No,13,4,34,51
Comal,204,Proposition 5,,REP,Cast Votes:,289,24,465,778
Comal,204,Proposition 5,,REP,Under Votes,6,1,6,13
Comal,204,Proposition 5,,REP,Over Votes,0,0,0,0
Comal,204,Proposition 6,,REP,Yes,277,23,444,744
Comal,204,Proposition 6,,REP,No,10,2,17,29
Comal,204,Proposition 6,,REP,Cast Votes:,287,25,461,773
Comal,204,Proposition 6,,REP,Under Votes,8,0,10,18
Comal,204,Proposition 6,,REP,Over Votes,0,0,0,0
Comal,204,Proposition 7,,REP,Yes,279,24,441,744
Comal,204,Proposition 7,,REP,No,7,1,15,23
Comal,204,Proposition 7,,REP,Cast Votes:,286,25,456,767
Comal,204,Proposition 7,,REP,Under Votes,9,0,15,24
Comal,204,Proposition 7,,REP,Over Votes,0,0,0,0
Comal,204,Proposition 8,,REP,Yes,289,25,458,772
Comal,204,Proposition 8,,REP,No,2,0,5,7
Comal,204,Proposition 8,,REP,Cast Votes:,291,25,463,779
Comal,204,Proposition 8,,REP,Under Votes,4,0,8,12
Comal,204,Proposition 8,,REP,Over Votes,0,0,0,0
Comal,204,Proposition 9,,REP,Yes,279,23,447,749
Comal,204,Proposition 9,,REP,No,10,1,15,26
Comal,204,Proposition 9,,REP,Cast Votes:,289,24,462,775
Comal,204,Proposition 9,,REP,Under Votes,6,1,9,16
Comal,204,Proposition 9,,REP,Over Votes,0,0,0,0
Comal,204,Proposition 10,,REP,Yes,271,22,434,727
Comal,204,Proposition 10,,REP,No,15,3,24,42
Comal,204,Proposition 10,,REP,Cast Votes:,286,25,458,769
Comal,204,Proposition 10,,REP,Under Votes,9,0,13,22
Comal,204,Proposition 10,,REP,Over Votes,0,0,0,0
Comal,205,President,,REP,Zoltan G. Istvan,0,0,0,0
Comal,205,President,,REP,Bill Weld,5,0,10,15
Comal,205,President,,REP,"Roque ""Rocky"" De La Fuente Guerra",3,0,1,4
Comal,205,President,,REP,Matthew John Matern,1,0,1,2
Comal,205,President,,REP,Donald J. Trump,390,23,708,1121
Comal,205,President,,REP,Joe Walsh,2,0,3,5
Comal,205,President,,REP,Bob Ely,0,1,0,1
Comal,205,President,,REP,Uncommitted,20,2,24,46
Comal,205,Ballots Cast,,REP,,421,26,747,1194
Comal,205,President,,REP,Under Votes,1,0,1,2
Comal,205,President,,REP,Over Votes,0,0,0,0
Comal,205,U.S. Senate,,REP,John Anthony Castro,21,1,23,45
Comal,205,U.S. Senate,,REP,Virgil Bierschwale,2,0,4,6
Comal,205,U.S. Senate,,REP,John Cornyn,340,23,641,1004
Comal,205,U.S. Senate,,REP,Mark Yancey,18,1,20,39
Comal,205,U.S. Senate,,REP,Dwayne Stovall,30,0,44,74
Comal,205,U.S. Senate,,REP,Cast Votes:,411,25,732,1168
Comal,205,U.S. Senate,,REP,Under Votes,11,1,16,28
Comal,205,U.S. Senate,,REP,Over Votes,0,0,0,0
Comal,205,U.S. House,21,REP,Chip Roy,394,23,717,1134
Comal,205,U.S. House,21,REP,Cast Votes:,394,23,717,1134
Comal,205,U.S. House,21,REP,Under Votes,28,3,31,62
Comal,205,U.S. House,21,REP,Over Votes,0,0,0,0
Comal,205,Railroad Commissioner,,REP,"James ""Jim"" Wright",212,17,350,579
Comal,205,Railroad Commissioner,,REP,Ryan Sitton,167,8,328,503
Comal,205,Railroad Commissioner,,REP,Cast Votes:,379,25,678,1082
Comal,205,Railroad Commissioner,,REP,Under Votes,43,1,70,114
Comal,205,Railroad Commissioner,,REP,Over Votes,0,0,0,0
Comal,205,"Chief Justice, Supreme Court",,REP,Nathan Hecht,377,21,672,1070
Comal,205,"Chief Justice, Supreme Court",,REP,Cast Votes:,377,21,672,1070
Comal,205,"Chief Justice, Supreme Court",,REP,Under Votes,45,5,76,126
Comal,205,"Chief Justice, Supreme Court",,REP,Over Votes,0,0,0,0
Comal,205,"Justice, Supreme Court, Place 6 Unexpired Term",,REP,Jane Bland,369,21,668,1058
Comal,205,"Justice, Supreme Court, Place 6 Unexpired Term",,REP,Cast Votes:,369,21,668,1058
Comal,205,"Justice, Supreme Court, Place 6 Unexpired Term",,REP,Under Votes,53,5,80,138
Comal,205,"Justice, Supreme Court, Place 6 Unexpired Term",,REP,Over Votes,0,0,0,0
Comal,205,"Justice, Supreme Court, Place 7",,REP,Jeff Boyd,365,21,673,1059
Comal,205,"Justice, Supreme Court, Place 7",,REP,Cast Votes:,365,21,673,1059
Comal,205,"Justice, Supreme Court, Place 7",,REP,Under Votes,57,5,75,137
Comal,205,"Justice, Supreme Court, Place 7",,REP,Over Votes,0,0,0,0
Comal,205,"Justice, Supreme Court, Place 8",,REP,Brett Busby,369,21,669,1059
Comal,205,"Justice, Supreme Court, Place 8",,REP,Cast Votes:,369,21,669,1059
Comal,205,"Justice, Supreme Court, Place 8",,REP,Under Votes,53,5,79,137
Comal,205,"Justice, Supreme Court, Place 8",,REP,Over Votes,0,0,0,0
Comal,205,"Judge, Court of Criminal Appeals, Place 3",,REP,Gina Parker,196,16,349,561
Comal,205,"Judge, Court of Criminal Appeals, Place 3",,REP,Bert Richardson,168,8,318,494
Comal,205,"Judge, Court of Criminal Appeals, Place 3",,REP,Cast Votes:,364,24,667,1055
Comal,205,"Judge, Court of Criminal Appeals, Place 3",,REP,Under Votes,58,2,81,141
Comal,205,"Judge, Court of Criminal Appeals, Place 3",,REP,Over Votes,0,0,0,0
Comal,205,"Judge, Court of Criminal Appeals, Place 4",,REP,Kevin Patrick Yeary,366,21,667,1054
Comal,205,"Judge, Court of Criminal Appeals, Place 4",,REP,Cast Votes:,366,21,667,1054
Comal,205,"Judge, Court of Criminal Appeals, Place 4",,REP,Under Votes,56,5,81,142
Comal,205,"Judge, Court of Criminal Appeals, Place 4",,REP,Over Votes,0,0,0,0
Comal,205,"Judge, Court of Criminal Appeals, Place 9",,REP,David Newell,365,21,660,1046
Comal,205,"Judge, Court of Criminal Appeals, Place 9",,REP,Cast Votes:,365,21,660,1046
Comal,205,"Judge, Court of Criminal Appeals, Place 9",,REP,Under Votes,57,5,88,150
Comal,205,"Judge, Court of Criminal Appeals, Place 9",,REP,Over Votes,0,0,0,0
Comal,205,"Member, State Board of Education, District 5",,REP,Lani Popp,151,11,297,459
Comal,205,"Member, State Board of Education, District 5",,REP,Inga Cotton,106,9,156,271
Comal,205,"Member, State Board of Education, District 5",,REP,Robert Morrow,112,4,221,337
Comal,205,"Member, State Board of Education, District 5",,REP,Cast Votes:,369,24,674,1067
Comal,205,"Member, State Board of Education, District 5",,REP,Under Votes,53,2,74,129
Comal,205,"Member, State Board of Education, District 5",,REP,Over Votes,0,0,0,0
Comal,205,State Representative,73,REP,Kyle Biedermann,383,23,683,1089
Comal,205,State Representative,73,REP,Cast Votes:,383,23,683,1089
Comal,205,State Representative,73,REP,Under Votes,39,3,65,107
Comal,205,State Representative,73,REP,Over Votes,0,0,0,0
Comal,205,"Chief Justice, 3rd Court of Appeals District",,REP,Jeff Rose,367,21,665,1053
Comal,205,"Chief Justice, 3rd Court of Appeals District",,REP,Cast Votes:,367,21,665,1053
Comal,205,"Chief Justice, 3rd Court of Appeals District",,REP,Under Votes,55,5,83,143
Comal,205,"Chief Justice, 3rd Court of Appeals District",,REP,Over Votes,0,0,0,0
Comal,205,"District Judge, 22nd Judicial District",,REP,R. Bruce Boyer,372,21,672,1065
Comal,205,"District Judge, 22nd Judicial District",,REP,Cast Votes:,372,21,672,1065
Comal,205,"District Judge, 22nd Judicial District",,REP,Under Votes,50,5,76,131
Comal,205,"District Judge, 22nd Judicial District",,REP,Over Votes,0,0,0,0
Comal,205,"District Judge, 433rd Judicial District",,REP,Dib Waldrip,287,18,526,831
Comal,205,"District Judge, 433rd Judicial District",,REP,Charlie Sullivan,103,5,180,288
Comal,205,"District Judge, 433rd Judicial District",,REP,Cast Votes:,390,23,706,1119
Comal,205,"District Judge, 433rd Judicial District",,REP,Under Votes,32,3,42,77
Comal,205,"District Judge, 433rd Judicial District",,REP,Over Votes,0,0,0,0
Comal,205,"Judge, County Court at Law No. 2",,REP,"Charles A. Stephens, II",369,21,674,1064
Comal,205,"Judge, County Court at Law No. 2",,REP,Cast Votes:,369,21,674,1064
Comal,205,"Judge, County Court at Law No. 2",,REP,Under Votes,53,5,74,132
Comal,205,"Judge, County Court at Law No. 2",,REP,Over Votes,0,0,0,0
Comal,205,"Judge, County Court at Law No. 3",,REP,Deborah Linnartz Wigington,362,21,659,1042
Comal,205,"Judge, County Court at Law No. 3",,REP,Cast Votes:,362,21,659,1042
Comal,205,"Judge, County Court at Law No. 3",,REP,Under Votes,60,5,89,154
Comal,205,"Judge, County Court at Law No. 3",,REP,Over Votes,0,0,0,0
Comal,205,Sheriff,,REP,Mark Reynolds,377,20,681,1078
Comal,205,Sheriff,,REP,Cast Votes:,377,20,681,1078
Comal,205,Sheriff,,REP,Under Votes,45,6,67,118
Comal,205,Sheriff,,REP,Over Votes,0,0,0,0
Comal,205,County Tax Assessor-Collector,,REP,Kristen H. Hoyt,275,13,450,738
Comal,205,County Tax Assessor-Collector,,REP,Patrick Aten,116,9,259,384
Comal,205,County Tax Assessor-Collector,,REP,Cast Votes:,391,22,709,1122
Comal,205,County Tax Assessor-Collector,,REP,Under Votes,31,4,39,74
Comal,205,County Tax Assessor-Collector,,REP,Over Votes,0,0,0,0
Comal,205,"Constable, Precinct No. 2",,REP,Mark Cheatum,370,19,666,1055
Comal,205,"Constable, Precinct No. 2",,REP,Cast Votes:,370,19,666,1055
Comal,205,"Constable, Precinct No. 2",,REP,Under Votes,52,7,82,141
Comal,205,"Constable, Precinct No. 2",,REP,Over Votes,0,0,0,0
Comal,205,County Chairman,,REP,Sue Piner,363,21,657,1041
Comal,205,County Chairman,,REP,Cast Votes:,363,21,657,1041
Comal,205,County Chairman,,REP,Under Votes,59,5,91,155
Comal,205,County Chairman,,REP,Over Votes,0,0,0,0
Comal,205,Proposition 1,,REP,Yes,390,25,686,1101
Comal,205,Proposition 1,,REP,No,26,1,48,75
Comal,205,Proposition 1,,REP,Cast Votes:,416,26,734,1176
Comal,205,Proposition 1,,REP,Under Votes,6,0,14,20
Comal,205,Proposition 1,,REP,Over Votes,0,0,0,0
Comal,205,Proposition 2,,REP,Yes,371,21,652,1044
Comal,205,Proposition 2,,REP,No,47,4,84,135
Comal,205,Proposition 2,,REP,Cast Votes:,418,25,736,1179
Comal,205,Proposition 2,,REP,Under Votes,4,1,12,17
Comal,205,Proposition 2,,REP,Over Votes,0,0,0,0
Comal,205,Proposition 3,,REP,Yes,391,24,714,1129
Comal,205,Proposition 3,,REP,No,16,0,25,41
Comal,205,Proposition 3,,REP,Cast Votes:,407,24,739,1170
Comal,205,Proposition 3,,REP,Under Votes,15,2,9,26
Comal,205,Proposition 3,,REP,Over Votes,0,0,0,0
Comal,205,Proposition 4,,REP,Yes,391,22,700,1113
Comal,205,Proposition 4,,REP,No,24,3,41,68
Comal,205,Proposition 4,,REP,Cast Votes:,415,25,741,1181
Comal,205,Proposition 4,,REP,Under Votes,7,1,7,15
Comal,205,Proposition 4,,REP,Over Votes,0,0,0,0
Comal,205,Proposition 5,,REP,Yes,372,17,662,1051
Comal,205,Proposition 5,,REP,No,40,8,72,120
Comal,205,Proposition 5,,REP,Cast Votes:,412,25,734,1171
Comal,205,Proposition 5,,REP,Under Votes,10,1,14,25
Comal,205,Proposition 5,,REP,Over Votes,0,0,0,0
Comal,205,Proposition 6,,REP,Yes,397,23,718,1138
Comal,205,Proposition 6,,REP,No,18,0,19,37
Comal,205,Proposition 6,,REP,Cast Votes:,415,23,737,1175
Comal,205,Proposition 6,,REP,Under Votes,7,3,11,21
Comal,205,Proposition 6,,REP,Over Votes,0,0,0,0
Comal,205,Proposition 7,,REP,Yes,399,24,690,1113
Comal,205,Proposition 7,,REP,No,16,0,47,63
Comal,205,Proposition 7,,REP,Cast Votes:,415,24,737,1176
Comal,205,Proposition 7,,REP,Under Votes,7,2,11,20
Comal,205,Proposition 7,,REP,Over Votes,0,0,0,0
Comal,205,Proposition 8,,REP,Yes,415,21,730,1166
Comal,205,Proposition 8,,REP,No,2,3,7,12
Comal,205,Proposition 8,,REP,Cast Votes:,417,24,737,1178
Comal,205,Proposition 8,,REP,Under Votes,5,2,11,18
Comal,205,Proposition 8,,REP,Over Votes,0,0,0,0
Comal,205,Proposition 9,,REP,Yes,401,23,714,1138
Comal,205,Proposition 9,,REP,No,14,1,23,38
Comal,205,Proposition 9,,REP,Cast Votes:,415,24,737,1176
Comal,205,Proposition 9,,REP,Under Votes,7,2,11,20
Comal,205,Proposition 9,,REP,Over Votes,0,0,0,0
Comal,205,Proposition 10,,REP,Yes,376,23,673,1072
Comal,205,Proposition 10,,REP,No,37,2,56,95
Comal,205,Proposition 10,,REP,Cast Votes:,413,25,729,1167
Comal,205,Proposition 10,,REP,Under Votes,9,1,19,29
Comal,205,Proposition 10,,REP,Over Votes,0,0,0,0
Comal,206,President,,REP,Zoltan G. Istvan,1,0,0,1
Comal,206,President,,REP,Bill Weld,3,0,2,5
Comal,206,President,,REP,"Roque ""Rocky"" De La Fuente Guerra",0,0,1,1
Comal,206,President,,REP,Matthew John Matern,0,0,0,0
Comal,206,President,,REP,Donald J. Trump,470,13,609,1092
Comal,206,President,,REP,Joe Walsh,3,0,1,4
Comal,206,President,,REP,Bob Ely,0,0,1,1
Comal,206,President,,REP,Uncommitted,9,4,11,24
Comal,206,Ballots Cast,,REP,,486,17,625,1128
Comal,206,President,,REP,Under Votes,2,0,2,4
Comal,206,President,,REP,Over Votes,0,0,0,0
Comal,206,U.S. Senate,,REP,John Anthony Castro,25,0,16,41
Comal,206,U.S. Senate,,REP,Virgil Bierschwale,5,0,2,7
Comal,206,U.S. Senate,,REP,John Cornyn,354,15,508,877
Comal,206,U.S. Senate,,REP,Mark Yancey,28,1,21,50
Comal,206,U.S. Senate,,REP,Dwayne Stovall,55,0,61,116
Comal,206,U.S. Senate,,REP,Cast Votes:,467,16,608,1091
Comal,206,U.S. Senate,,REP,Under Votes,21,1,19,41
Comal,206,U.S. Senate,,REP,Over Votes,0,0,0,0
Comal,206,U.S. House,21,REP,Chip Roy,455,14,606,1075
Comal,206,U.S. House,21,REP,Cast Votes:,455,14,606,1075
Comal,206,U.S. House,21,REP,Under Votes,33,3,21,57
Comal,206,U.S. House,21,REP,Over Votes,0,0,0,0
Comal,206,Railroad Commissioner,,REP,"James ""Jim"" Wright",271,11,288,570
Comal,206,Railroad Commissioner,,REP,Ryan Sitton,161,4,291,456
Comal,206,Railroad Commissioner,,REP,Cast Votes:,432,15,579,1026
Comal,206,Railroad Commissioner,,REP,Under Votes,56,2,48,106
Comal,206,Railroad Commissioner,,REP,Over Votes,0,0,0,0
Comal,206,"Chief Justice, Supreme Court",,REP,Nathan Hecht,434,14,571,1019
Comal,206,"Chief Justice, Supreme Court",,REP,Cast Votes:,434,14,571,1019
Comal,206,"Chief Justice, Supreme Court",,REP,Under Votes,54,3,56,113
Comal,206,"Chief Justice, Supreme Court",,REP,Over Votes,0,0,0,0
Comal,206,"Justice, Supreme Court, Place 6 Unexpired Term",,REP,Jane Bland,425,13,565,1003
Comal,206,"Justice, Supreme Court, Place 6 Unexpired Term",,REP,Cast Votes:,425,13,565,1003
Comal,206,"Justice, Supreme Court, Place 6 Unexpired Term",,REP,Under Votes,63,4,62,129
Comal,206,"Justice, Supreme Court, Place 6 Unexpired Term",,REP,Over Votes,0,0,0,0
Comal,206,"Justice, Supreme Court, Place 7",,REP,Jeff Boyd,427,13,567,1007
Comal,206,"Justice, Supreme Court, Place 7",,REP,Cast Votes:,427,13,567,1007
Comal,206,"Justice, Supreme Court, Place 7",,REP,Under Votes,61,4,60,125
Comal,206,"Justice, Supreme Court, Place 7",,REP,Over Votes,0,0,0,0
Comal,206,"Justice, Supreme Court, Place 8",,REP,Brett Busby,427,13,567,1007
Comal,206,"Justice, Supreme Court, Place 8",,REP,Cast Votes:,427,13,567,1007
Comal,206,"Justice, Supreme Court, Place 8",,REP,Under Votes,61,4,60,125
Comal,206,"Justice, Supreme Court, Place 8",,REP,Over Votes,0,0,0,0
Comal,206,"Judge, Court of Criminal Appeals, Place 3",,REP,Gina Parker,230,5,262,497
Comal,206,"Judge, Court of Criminal Appeals, Place 3",,REP,Bert Richardson,192,10,303,505
Comal,206,"Judge, Court of Criminal Appeals, Place 3",,REP,Cast Votes:,422,15,565,1002
Comal,206,"Judge, Court of Criminal Appeals, Place 3",,REP,Under Votes,66,2,62,130
Comal,206,"Judge, Court of Criminal Appeals, Place 3",,REP,Over Votes,0,0,0,0
Comal,206,"Judge, Court of Criminal Appeals, Place 4",,REP,Kevin Patrick Yeary,422,13,566,1001
Comal,206,"Judge, Court of Criminal Appeals, Place 4",,REP,Cast Votes:,422,13,566,1001
Comal,206,"Judge, Court of Criminal Appeals, Place 4",,REP,Under Votes,66,4,61,131
Comal,206,"Judge, Court of Criminal Appeals, Place 4",,REP,Over Votes,0,0,0,0
Comal,206,"Judge, Court of Criminal Appeals, Place 9",,REP,David Newell,420,13,558,991
Comal,206,"Judge, Court of Criminal Appeals, Place 9",,REP,Cast Votes:,420,13,558,991
Comal,206,"Judge, Court of Criminal Appeals, Place 9",,REP,Under Votes,68,4,69,141
Comal,206,"Judge, Court of Criminal Appeals, Place 9",,REP,Over Votes,0,0,0,0
Comal,206,"Member, State Board of Education, District 5",,REP,Lani Popp,160,5,242,407
Comal,206,"Member, State Board of Education, District 5",,REP,Inga Cotton,103,1,105,209
Comal,206,"Member, State Board of Education, District 5",,REP,Robert Morrow,154,9,212,375
Comal,206,"Member, State Board of Education, District 5",,REP,Cast Votes:,417,15,559,991
Comal,206,"Member, State Board of Education, District 5",,REP,Under Votes,71,2,68,141
Comal,206,"Member, State Board of Education, District 5",,REP,Over Votes,0,0,0,0
Comal,206,State Representative,73,REP,Kyle Biedermann,437,14,572,1023
Comal,206,State Representative,73,REP,Cast Votes:,437,14,572,1023
Comal,206,State Representative,73,REP,Under Votes,51,3,55,109
Comal,206,State Representative,73,REP,Over Votes,0,0,0,0
Comal,206,"Chief Justice, 3rd Court of Appeals District",,REP,Jeff Rose,418,13,555,986
Comal,206,"Chief Justice, 3rd Court of Appeals District",,REP,Cast Votes:,418,13,555,986
Comal,206,"Chief Justice, 3rd Court of Appeals District",,REP,Under Votes,70,4,72,146
Comal,206,"Chief Justice, 3rd Court of Appeals District",,REP,Over Votes,0,0,0,0
Comal,206,"District Judge, 22nd Judicial District",,REP,R. Bruce Boyer,418,13,558,989
Comal,206,"District Judge, 22nd Judicial District",,REP,Cast Votes:,418,13,558,989
Comal,206,"District Judge, 22nd Judicial District",,REP,Under Votes,70,4,69,143
Comal,206,"District Judge, 22nd Judicial District",,REP,Over Votes,0,0,0,0
Comal,206,"District Judge, 433rd Judicial District",,REP,Dib Waldrip,276,10,415,701
Comal,206,"District Judge, 433rd Judicial District",,REP,Charlie Sullivan,162,6,162,330
Comal,206,"District Judge, 433rd Judicial District",,REP,Cast Votes:,438,16,577,1031
Comal,206,"District Judge, 433rd Judicial District",,REP,Under Votes,50,1,50,101
Comal,206,"District Judge, 433rd Judicial District",,REP,Over Votes,0,0,0,0
Comal,206,"Judge, County Court at Law No. 2",,REP,"Charles A. Stephens, II",416,13,558,987
Comal,206,"Judge, County Court at Law No. 2",,REP,Cast Votes:,416,13,558,987
Comal,206,"Judge, County Court at Law No. 2",,REP,Under Votes,72,4,69,145
Comal,206,"Judge, County Court at Law No. 2",,REP,Over Votes,0,0,0,0
Comal,206,"Judge, County Court at Law No. 3",,REP,Deborah Linnartz Wigington,413,13,560,986
Comal,206,"Judge, County Court at Law No. 3",,REP,Cast Votes:,413,13,560,986
Comal,206,"Judge, County Court at Law No. 3",,REP,Under Votes,75,4,67,146
Comal,206,"Judge, County Court at Law No. 3",,REP,Over Votes,0,0,0,0
Comal,206,Sheriff,,REP,Mark Reynolds,425,13,572,1010
Comal,206,Sheriff,,REP,Cast Votes:,425,13,572,1010
Comal,206,Sheriff,,REP,Under Votes,63,4,55,122
Comal,206,Sheriff,,REP,Over Votes,0,0,0,0
Comal,206,County Tax Assessor-Collector,,REP,Kristen H. Hoyt,316,12,355,683
Comal,206,County Tax Assessor-Collector,,REP,Patrick Aten,122,3,228,353
Comal,206,County Tax Assessor-Collector,,REP,Cast Votes:,438,15,583,1036
Comal,206,County Tax Assessor-Collector,,REP,Under Votes,50,2,44,96
Comal,206,County Tax Assessor-Collector,,REP,Over Votes,0,0,0,0
Comal,206,"Constable, Precinct No. 2",,REP,Mark Cheatum,417,13,570,1000
Comal,206,"Constable, Precinct No. 2",,REP,Cast Votes:,417,13,570,1000
Comal,206,"Constable, Precinct No. 2",,REP,Under Votes,71,4,57,132
Comal,206,"Constable, Precinct No. 2",,REP,Over Votes,0,0,0,0
Comal,206,County Chairman,,REP,Sue Piner,413,13,553,979
Comal,206,County Chairman,,REP,Cast Votes:,413,13,553,979
Comal,206,County Chairman,,REP,Under Votes,75,4,74,153
Comal,206,County Chairman,,REP,Over Votes,0,0,0,0
Comal,206,Proposition 1,,REP,Yes,451,15,582,1048
Comal,206,Proposition 1,,REP,No,30,2,36,68
Comal,206,Proposition 1,,REP,Cast Votes:,481,17,618,1116
Comal,206,Proposition 1,,REP,Under Votes,7,0,9,16
Comal,206,Proposition 1,,REP,Over Votes,0,0,0,0
Comal,206,Proposition 2,,REP,Yes,440,12,571,1023
Comal,206,Proposition 2,,REP,No,40,5,49,94
Comal,206,Proposition 2,,REP,Cast Votes:,480,17,620,1117
Comal,206,Proposition 2,,REP,Under Votes,8,0,7,15
Comal,206,Proposition 2,,REP,Over Votes,0,0,0,0
Comal,206,Proposition 3,,REP,Yes,466,16,591,1073
Comal,206,Proposition 3,,REP,No,16,0,22,38
Comal,206,Proposition 3,,REP,Cast Votes:,482,16,613,1111
Comal,206,Proposition 3,,REP,Under Votes,6,1,14,21
Comal,206,Proposition 3,,REP,Over Votes,0,0,0,0
Comal,206,Proposition 4,,REP,Yes,466,16,601,1083
Comal,206,Proposition 4,,REP,No,16,1,18,35
Comal,206,Proposition 4,,REP,Cast Votes:,482,17,619,1118
Comal,206,Proposition 4,,REP,Under Votes,6,0,8,14
Comal,206,Proposition 4,,REP,Over Votes,0,0,0,0
Comal,206,Proposition 5,,REP,Yes,442,16,572,1030
Comal,206,Proposition 5,,REP,No,37,1,45,83
Comal,206,Proposition 5,,REP,Cast Votes:,479,17,617,1113
Comal,206,Proposition 5,,REP,Under Votes,9,0,10,19
Comal,206,Proposition 5,,REP,Over Votes,0,0,0,0
Comal,206,Proposition 6,,REP,Yes,454,17,596,1067
Comal,206,Proposition 6,,REP,No,22,0,13,35
Comal,206,Proposition 6,,REP,Cast Votes:,476,17,609,1102
Comal,206,Proposition 6,,REP,Under Votes,12,0,18,30
Comal,206,Proposition 6,,REP,Over Votes,0,0,0,0
Comal,206,Proposition 7,,REP,Yes,468,17,588,1073
Comal,206,Proposition 7,,REP,No,10,0,24,34
Comal,206,Proposition 7,,REP,Cast Votes:,478,17,612,1107
Comal,206,Proposition 7,,REP,Under Votes,10,0,15,25
Comal,206,Proposition 7,,REP,Over Votes,0,0,0,0
Comal,206,Proposition 8,,REP,Yes,479,15,611,1105
Comal,206,Proposition 8,,REP,No,1,2,3,6
Comal,206,Proposition 8,,REP,Cast Votes:,480,17,614,1111
Comal,206,Proposition 8,,REP,Under Votes,8,0,13,21
Comal,206,Proposition 8,,REP,Over Votes,0,0,0,0
Comal,206,Proposition 9,,REP,Yes,457,17,598,1072
Comal,206,Proposition 9,,REP,No,20,0,17,37
Comal,206,Proposition 9,,REP,Cast Votes:,477,17,615,1109
Comal,206,Proposition 9,,REP,Under Votes,11,0,12,23
Comal,206,Proposition 9,,REP,Over Votes,0,0,0,0
Comal,206,Proposition 10,,REP,Yes,443,14,579,1036
Comal,206,Proposition 10,,REP,No,26,3,39,68
Comal,206,Proposition 10,,REP,Cast Votes:,469,17,618,1104
Comal,206,Proposition 10,,REP,Under Votes,19,0,9,28
Comal,206,Proposition 10,,REP,Over Votes,0,0,0,0
Comal,207,President,,REP,Zoltan G. Istvan,0,0,1,1
Comal,207,President,,REP,Bill Weld,1,0,2,3
Comal,207,President,,REP,"Roque ""Rocky"" De La Fuente Guerra",0,0,0,0
Comal,207,President,,REP,Matthew John Matern,0,0,0,0
Comal,207,President,,REP,Donald J. Trump,211,22,264,497
Comal,207,President,,REP,Joe Walsh,0,0,1,1
Comal,207,President,,REP,Bob Ely,0,0,0,0
Comal,207,President,,REP,Uncommitted,8,1,10,19
Comal,207,Ballots Cast,,REP,,220,23,278,521
Comal,207,President,,REP,Under Votes,0,0,0,0
Comal,207,President,,REP,Over Votes,0,0,0,0
Comal,207,U.S. Senate,,REP,John Anthony Castro,7,1,10,18
Comal,207,U.S. Senate,,REP,Virgil Bierschwale,2,0,1,3
Comal,207,U.S. Senate,,REP,John Cornyn,175,21,231,427
Comal,207,U.S. Senate,,REP,Mark Yancey,8,0,8,16
Comal,207,U.S. Senate,,REP,Dwayne Stovall,11,1,17,29
Comal,207,U.S. Senate,,REP,Cast Votes:,203,23,267,493
Comal,207,U.S. Senate,,REP,Under Votes,17,0,11,28
Comal,207,U.S. Senate,,REP,Over Votes,0,0,0,0
Comal,207,U.S. House,21,REP,Chip Roy,207,22,264,493
Comal,207,U.S. House,21,REP,Cast Votes:,207,22,264,493
Comal,207,U.S. House,21,REP,Under Votes,13,1,14,28
Comal,207,U.S. House,21,REP,Over Votes,0,0,0,0
Comal,207,Railroad Commissioner,,REP,"James ""Jim"" Wright",118,8,132,258
Comal,207,Railroad Commissioner,,REP,Ryan Sitton,68,9,121,198
Comal,207,Railroad Commissioner,,REP,Cast Votes:,186,17,253,456
Comal,207,Railroad Commissioner,,REP,Under Votes,34,6,25,65
Comal,207,Railroad Commissioner,,REP,Over Votes,0,0,0,0
Comal,207,"Chief Justice, Supreme Court",,REP,Nathan Hecht,197,21,258,476
Comal,207,"Chief Justice, Supreme Court",,REP,Cast Votes:,197,21,258,476
Comal,207,"Chief Justice, Supreme Court",,REP,Under Votes,23,2,20,45
Comal,207,"Chief Justice, Supreme Court",,REP,Over Votes,0,0,0,0
Comal,207,"Justice, Supreme Court, Place 6 Unexpired Term",,REP,Jane Bland,197,22,253,472
Comal,207,"Justice, Supreme Court, Place 6 Unexpired Term",,REP,Cast Votes:,197,22,253,472
Comal,207,"Justice, Supreme Court, Place 6 Unexpired Term",,REP,Under Votes,23,1,25,49
Comal,207,"Justice, Supreme Court, Place 6 Unexpired Term",,REP,Over Votes,0,0,0,0
Comal,207,"Justice, Supreme Court, Place 7",,REP,Jeff Boyd,195,22,254,471
Comal,207,"Justice, Supreme Court, Place 7",,REP,Cast Votes:,195,22,254,471
Comal,207,"Justice, Supreme Court, Place 7",,REP,Under Votes,25,1,24,50
Comal,207,"Justice, Supreme Court, Place 7",,REP,Over Votes,0,0,0,0
Comal,207,"Justice, Supreme Court, Place 8",,REP,Brett Busby,195,21,252,468
Comal,207,"Justice, Supreme Court, Place 8",,REP,Cast Votes:,195,21,252,468
Comal,207,"Justice, Supreme Court, Place 8",,REP,Under Votes,25,2,26,53
Comal,207,"Justice, Supreme Court, Place 8",,REP,Over Votes,0,0,0,0
Comal,207,"Judge, Court of Criminal Appeals, Place 3",,REP,Gina Parker,96,8,109,213
Comal,207,"Judge, Court of Criminal Appeals, Place 3",,REP,Bert Richardson,81,12,132,225
Comal,207,"Judge, Court of Criminal Appeals, Place 3",,REP,Cast Votes:,177,20,241,438
Comal,207,"Judge, Court of Criminal Appeals, Place 3",,REP,Under Votes,43,3,37,83
Comal,207,"Judge, Court of Criminal Appeals, Place 3",,REP,Over Votes,0,0,0,0
Comal,207,"Judge, Court of Criminal Appeals, Place 4",,REP,Kevin Patrick Yeary,189,22,249,460
Comal,207,"Judge, Court of Criminal Appeals, Place 4",,REP,Cast Votes:,189,22,249,460
Comal,207,"Judge, Court of Criminal Appeals, Place 4",,REP,Under Votes,31,1,29,61
Comal,207,"Judge, Court of Criminal Appeals, Place 4",,REP,Over Votes,0,0,0,0
Comal,207,"Judge, Court of Criminal Appeals, Place 9",,REP,David Newell,188,22,248,458
Comal,207,"Judge, Court of Criminal Appeals, Place 9",,REP,Cast Votes:,188,22,248,458
Comal,207,"Judge, Court of Criminal Appeals, Place 9",,REP,Under Votes,32,1,30,63
Comal,207,"Judge, Court of Criminal Appeals, Place 9",,REP,Over Votes,0,0,0,0
Comal,207,"Member, State Board of Education, District 5",,REP,Lani Popp,51,5,114,170
Comal,207,"Member, State Board of Education, District 5",,REP,Inga Cotton,54,5,49,108
Comal,207,"Member, State Board of Education, District 5",,REP,Robert Morrow,72,7,83,162
Comal,207,"Member, State Board of Education, District 5",,REP,Cast Votes:,177,17,246,440
Comal,207,"Member, State Board of Education, District 5",,REP,Under Votes,43,6,32,81
Comal,207,"Member, State Board of Education, District 5",,REP,Over Votes,0,0,0,0
Comal,207,State Representative,73,REP,Kyle Biedermann,200,18,257,475
Comal,207,State Representative,73,REP,Cast Votes:,200,18,257,475
Comal,207,State Representative,73,REP,Under Votes,20,5,21,46
Comal,207,State Representative,73,REP,Over Votes,0,0,0,0
Comal,207,"Chief Justice, 3rd Court of Appeals District",,REP,Jeff Rose,191,20,246,457
Comal,207,"Chief Justice, 3rd Court of Appeals District",,REP,Cast Votes:,191,20,246,457
Comal,207,"Chief Justice, 3rd Court of Appeals District",,REP,Under Votes,29,3,32,64
Comal,207,"Chief Justice, 3rd Court of Appeals District",,REP,Over Votes,0,0,0,0
Comal,207,"District Judge, 22nd Judicial District",,REP,R. Bruce Boyer,194,20,250,464
Comal,207,"District Judge, 22nd Judicial District",,REP,Cast Votes:,194,20,250,464
Comal,207,"District Judge, 22nd Judicial District",,REP,Under Votes,26,3,28,57
Comal,207,"District Judge, 22nd Judicial District",,REP,Over Votes,0,0,0,0
Comal,207,"District Judge, 433rd Judicial District",,REP,Dib Waldrip,165,15,210,390
Comal,207,"District Judge, 433rd Judicial District",,REP,Charlie Sullivan,42,5,49,96
Comal,207,"District Judge, 433rd Judicial District",,REP,Cast Votes:,207,20,259,486
Comal,207,"District Judge, 433rd Judicial District",,REP,Under Votes,13,3,19,35
Comal,207,"District Judge, 433rd Judicial District",,REP,Over Votes,0,0,0,0
Comal,207,"Judge, County Court at Law No. 2",,REP,"Charles A. Stephens, II",193,20,249,462
Comal,207,"Judge, County Court at Law No. 2",,REP,Cast Votes:,193,20,249,462
Comal,207,"Judge, County Court at Law No. 2",,REP,Under Votes,27,3,29,59
Comal,207,"Judge, County Court at Law No. 2",,REP,Over Votes,0,0,0,0
Comal,207,"Judge, County Court at Law No. 3",,REP,Deborah Linnartz Wigington,192,20,248,460
Comal,207,"Judge, County Court at Law No. 3",,REP,Cast Votes:,192,20,248,460
Comal,207,"Judge, County Court at Law No. 3",,REP,Under Votes,28,3,30,61
Comal,207,"Judge, County Court at Law No. 3",,REP,Over Votes,0,0,0,0
Comal,207,Sheriff,,REP,Mark Reynolds,199,20,258,477
Comal,207,Sheriff,,REP,Cast Votes:,199,20,258,477
Comal,207,Sheriff,,REP,Under Votes,21,3,20,44
Comal,207,Sheriff,,REP,Over Votes,0,0,0,0
Comal,207,County Tax Assessor-Collector,,REP,Kristen H. Hoyt,114,12,114,240
Comal,207,County Tax Assessor-Collector,,REP,Patrick Aten,83,8,144,235
Comal,207,County Tax Assessor-Collector,,REP,Cast Votes:,197,20,258,475
Comal,207,County Tax Assessor-Collector,,REP,Under Votes,23,3,20,46
Comal,207,County Tax Assessor-Collector,,REP,Over Votes,0,0,0,0
Comal,207,"Constable, Precinct No. 2",,REP,Mark Cheatum,190,20,247,457
Comal,207,"Constable, Precinct No. 2",,REP,Cast Votes:,190,20,247,457
Comal,207,"Constable, Precinct No. 2",,REP,Under Votes,30,3,31,64
Comal,207,"Constable, Precinct No. 2",,REP,Over Votes,0,0,0,0
Comal,207,County Chairman,,REP,Sue Piner,189,23,246,458
Comal,207,County Chairman,,REP,Cast Votes:,189,23,246,458
Comal,207,County Chairman,,REP,Under Votes,31,0,32,63
Comal,207,County Chairman,,REP,Over Votes,0,0,0,0
Comal,207,Proposition 1,,REP,Yes,210,22,268,500
Comal,207,Proposition 1,,REP,No,9,1,9,19
Comal,207,Proposition 1,,REP,Cast Votes:,219,23,277,519
Comal,207,Proposition 1,,REP,Under Votes,1,0,1,2
Comal,207,Proposition 1,,REP,Over Votes,0,0,0,0
Comal,207,Proposition 2,,REP,Yes,206,19,253,478
Comal,207,Proposition 2,,REP,No,14,4,24,42
Comal,207,Proposition 2,,REP,Cast Votes:,220,23,277,520
Comal,207,Proposition 2,,REP,Under Votes,0,0,1,1
Comal,207,Proposition 2,,REP,Over Votes,0,0,0,0
Comal,207,Proposition 3,,REP,Yes,211,23,261,495
Comal,207,Proposition 3,,REP,No,6,0,14,20
Comal,207,Proposition 3,,REP,Cast Votes:,217,23,275,515
Comal,207,Proposition 3,,REP,Under Votes,3,0,3,6
Comal,207,Proposition 3,,REP,Over Votes,0,0,0,0
Comal,207,Proposition 4,,REP,Yes,210,21,260,491
Comal,207,Proposition 4,,REP,No,8,2,15,25
Comal,207,Proposition 4,,REP,Cast Votes:,218,23,275,516
Comal,207,Proposition 4,,REP,Under Votes,2,0,3,5
Comal,207,Proposition 4,,REP,Over Votes,0,0,0,0
Comal,207,Proposition 5,,REP,Yes,205,21,245,471
Comal,207,Proposition 5,,REP,No,14,1,29,44
Comal,207,Proposition 5,,REP,Cast Votes:,219,22,274,515
Comal,207,Proposition 5,,REP,Under Votes,1,1,4,6
Comal,207,Proposition 5,,REP,Over Votes,0,0,0,0
Comal,207,Proposition 6,,REP,Yes,212,23,268,503
Comal,207,Proposition 6,,REP,No,3,0,9,12
Comal,207,Proposition 6,,REP,Cast Votes:,215,23,277,515
Comal,207,Proposition 6,,REP,Under Votes,5,0,1,6
Comal,207,Proposition 6,,REP,Over Votes,0,0,0,0
Comal,207,Proposition 7,,REP,Yes,213,19,259,491
Comal,207,Proposition 7,,REP,No,3,4,12,19
Comal,207,Proposition 7,,REP,Cast Votes:,216,23,271,510
Comal,207,Proposition 7,,REP,Under Votes,4,0,7,11
Comal,207,Proposition 7,,REP,Over Votes,0,0,0,0
Comal,207,Proposition 8,,REP,Yes,218,23,275,516
Comal,207,Proposition 8,,REP,No,0,0,3,3
Comal,207,Proposition 8,,REP,Cast Votes:,218,23,278,519
Comal,207,Proposition 8,,REP,Under Votes,2,0,0,2
Comal,207,Proposition 8,,REP,Over Votes,0,0,0,0
Comal,207,Proposition 9,,REP,Yes,207,22,263,492
Comal,207,Proposition 9,,REP,No,8,1,10,19
Comal,207,Proposition 9,,REP,Cast Votes:,215,23,273,511
Comal,207,Proposition 9,,REP,Under Votes,5,0,5,10
Comal,207,Proposition 9,,REP,Over Votes,0,0,0,0
Comal,207,Proposition 10,,REP,Yes,202,21,252,475
Comal,207,Proposition 10,,REP,No,11,1,19,31
Comal,207,Proposition 10,,REP,Cast Votes:,213,22,271,506
Comal,207,Proposition 10,,REP,Under Votes,7,1,7,15
Comal,207,Proposition 10,,REP,Over Votes,0,0,0,0
Comal,208,President,,REP,Zoltan G. Istvan,0,0,0,0
Comal,208,President,,REP,Bill Weld,1,0,2,3
Comal,208,President,,REP,"Roque ""Rocky"" De La Fuente Guerra",0,0,0,0
Comal,208,President,,REP,Matthew John Matern,0,0,0,0
Comal,208,President,,REP,Donald J. Trump,179,15,188,382
Comal,208,President,,REP,Joe Walsh,1,0,0,1
Comal,208,President,,REP,Bob Ely,0,0,0,0
Comal,208,President,,REP,Uncommitted,6,1,10,17
Comal,208,Ballots Cast,,REP,,187,16,200,403
Comal,208,President,,REP,Under Votes,0,0,0,0
Comal,208,President,,REP,Over Votes,0,0,0,0
Comal,208,U.S. Senate,,REP,John Anthony Castro,6,0,3,9
Comal,208,U.S. Senate,,REP,Virgil Bierschwale,0,0,4,4
Comal,208,U.S. Senate,,REP,John Cornyn,148,14,173,335
Comal,208,U.S. Senate,,REP,Mark Yancey,5,0,1,6
Comal,208,U.S. Senate,,REP,Dwayne Stovall,17,1,10,28
Comal,208,U.S. Senate,,REP,Cast Votes:,176,15,191,382
Comal,208,U.S. Senate,,REP,Under Votes,11,1,9,21
Comal,208,U.S. Senate,,REP,Over Votes,0,0,0,0
Comal,208,U.S. House,21,REP,Chip Roy,174,14,193,381
Comal,208,U.S. House,21,REP,Cast Votes:,174,14,193,381
Comal,208,U.S. House,21,REP,Under Votes,13,2,7,22
Comal,208,U.S. House,21,REP,Over Votes,0,0,0,0
Comal,208,Railroad Commissioner,,REP,"James ""Jim"" Wright",79,6,98,183
Comal,208,Railroad Commissioner,,REP,Ryan Sitton,83,7,82,172
Comal,208,Railroad Commissioner,,REP,Cast Votes:,162,13,180,355
Comal,208,Railroad Commissioner,,REP,Under Votes,25,3,20,48
Comal,208,Railroad Commissioner,,REP,Over Votes,0,0,0,0
Comal,208,"Chief Justice, Supreme Court",,REP,Nathan Hecht,163,13,178,354
Comal,208,"Chief Justice, Supreme Court",,REP,Cast Votes:,163,13,178,354
Comal,208,"Chief Justice, Supreme Court",,REP,Under Votes,24,3,22,49
Comal,208,"Chief Justice, Supreme Court",,REP,Over Votes,0,0,0,0
Comal,208,"Justice, Supreme Court, Place 6 Unexpired Term",,REP,Jane Bland,162,13,180,355
Comal,208,"Justice, Supreme Court, Place 6 Unexpired Term",,REP,Cast Votes:,162,13,180,355
Comal,208,"Justice, Supreme Court, Place 6 Unexpired Term",,REP,Under Votes,25,3,20,48
Comal,208,"Justice, Supreme Court, Place 6 Unexpired Term",,REP,Over Votes,0,0,0,0
Comal,208,"Justice, Supreme Court, Place 7",,REP,Jeff Boyd,163,13,179,355
Comal,208,"Justice, Supreme Court, Place 7",,REP,Cast Votes:,163,13,179,355
Comal,208,"Justice, Supreme Court, Place 7",,REP,Under Votes,24,3,21,48
Comal,208,"Justice, Supreme Court, Place 7",,REP,Over Votes,0,0,0,0
Comal,208,"Justice, Supreme Court, Place 8",,REP,Brett Busby,163,13,177,353
Comal,208,"Justice, Supreme Court, Place 8",,REP,Cast Votes:,163,13,177,353
Comal,208,"Justice, Supreme Court, Place 8",,REP,Under Votes,24,3,23,50
Comal,208,"Justice, Supreme Court, Place 8",,REP,Over Votes,0,0,0,0
Comal,208,"Judge, Court of Criminal Appeals, Place 3",,REP,Gina Parker,77,3,85,165
Comal,208,"Judge, Court of Criminal Appeals, Place 3",,REP,Bert Richardson,82,9,90,181
Comal,208,"Judge, Court of Criminal Appeals, Place 3",,REP,Cast Votes:,159,12,175,346
Comal,208,"Judge, Court of Criminal Appeals, Place 3",,REP,Under Votes,28,4,25,57
Comal,208,"Judge, Court of Criminal Appeals, Place 3",,REP,Over Votes,0,0,0,0
Comal,208,"Judge, Court of Criminal Appeals, Place 4",,REP,Kevin Patrick Yeary,160,13,172,345
Comal,208,"Judge, Court of Criminal Appeals, Place 4",,REP,Cast Votes:,160,13,172,345
Comal,208,"Judge, Court of Criminal Appeals, Place 4",,REP,Under Votes,27,3,28,58
Comal,208,"Judge, Court of Criminal Appeals, Place 4",,REP,Over Votes,0,0,0,0
Comal,208,"Judge, Court of Criminal Appeals, Place 9",,REP,David Newell,157,13,172,342
Comal,208,"Judge, Court of Criminal Appeals, Place 9",,REP,Cast Votes:,157,13,172,342
Comal,208,"Judge, Court of Criminal Appeals, Place 9",,REP,Under Votes,30,3,28,61
Comal,208,"Judge, Court of Criminal Appeals, Place 9",,REP,Over Votes,0,0,0,0
Comal,208,"Member, State Board of Education, District 5",,REP,Lani Popp,80,3,75,158
Comal,208,"Member, State Board of Education, District 5",,REP,Inga Cotton,30,3,37,70
Comal,208,"Member, State Board of Education, District 5",,REP,Robert Morrow,48,5,62,115
Comal,208,"Member, State Board of Education, District 5",,REP,Cast Votes:,158,11,174,343
Comal,208,"Member, State Board of Education, District 5",,REP,Under Votes,29,5,26,60
Comal,208,"Member, State Board of Education, District 5",,REP,Over Votes,0,0,0,0
Comal,208,State Representative,73,REP,Kyle Biedermann,160,12,181,353
Comal,208,State Representative,73,REP,Cast Votes:,160,12,181,353
Comal,208,State Representative,73,REP,Under Votes,27,4,19,50
Comal,208,State Representative,73,REP,Over Votes,0,0,0,0
Comal,208,"Chief Justice, 3rd Court of Appeals District",,REP,Jeff Rose,160,13,176,349
Comal,208,"Chief Justice, 3rd Court of Appeals District",,REP,Cast Votes:,160,13,176,349
Comal,208,"Chief Justice, 3rd Court of Appeals District",,REP,Under Votes,27,3,24,54
Comal,208,"Chief Justice, 3rd Court of Appeals District",,REP,Over Votes,0,0,0,0
Comal,208,"District Judge, 22nd Judicial District",,REP,R. Bruce Boyer,161,13,177,351
Comal,208,"District Judge, 22nd Judicial District",,REP,Cast Votes:,161,13,177,351
Comal,208,"District Judge, 22nd Judicial District",,REP,Under Votes,26,3,23,52
Comal,208,"District Judge, 22nd Judicial District",,REP,Over Votes,0,0,0,0
Comal,208,"District Judge, 433rd Judicial District",,REP,Dib Waldrip,77,10,98,185
Comal,208,"District Judge, 433rd Judicial District",,REP,Charlie Sullivan,79,3,75,157
Comal,208,"District Judge, 433rd Judicial District",,REP,Cast Votes:,156,13,173,342
Comal,208,"District Judge, 433rd Judicial District",,REP,Under Votes,31,3,27,61
Comal,208,"District Judge, 433rd Judicial District",,REP,Over Votes,0,0,0,0
Comal,208,"Judge, County Court at Law No. 2",,REP,"Charles A. Stephens, II",159,13,174,346
Comal,208,"Judge, County Court at Law No. 2",,REP,Cast Votes:,159,13,174,346
Comal,208,"Judge, County Court at Law No. 2",,REP,Under Votes,28,3,26,57
Comal,208,"Judge, County Court at Law No. 2",,REP,Over Votes,0,0,0,0
Comal,208,"Judge, County Court at Law No. 3",,REP,Deborah Linnartz Wigington,158,13,168,339
Comal,208,"Judge, County Court at Law No. 3",,REP,Cast Votes:,158,13,168,339
Comal,208,"Judge, County Court at Law No. 3",,REP,Under Votes,29,3,32,64
Comal,208,"Judge, County Court at Law No. 3",,REP,Over Votes,0,0,0,0
Comal,208,Sheriff,,REP,Mark Reynolds,162,13,173,348
Comal,208,Sheriff,,REP,Cast Votes:,162,13,173,348
Comal,208,Sheriff,,REP,Under Votes,25,3,27,55
Comal,208,Sheriff,,REP,Over Votes,0,0,0,0
Comal,208,County Tax Assessor-Collector,,REP,Kristen H. Hoyt,108,7,93,208
Comal,208,County Tax Assessor-Collector,,REP,Patrick Aten,44,6,81,131
Comal,208,County Tax Assessor-Collector,,REP,Cast Votes:,152,13,174,339
Comal,208,County Tax Assessor-Collector,,REP,Under Votes,35,3,26,64
Comal,208,County Tax Assessor-Collector,,REP,Over Votes,0,0,0,0
Comal,208,"Constable, Precinct No. 2",,REP,Mark Cheatum,160,13,172,345
Comal,208,"Constable, Precinct No. 2",,REP,Cast Votes:,160,13,172,345
Comal,208,"Constable, Precinct No. 2",,REP,Under Votes,27,3,28,58
Comal,208,"Constable, Precinct No. 2",,REP,Over Votes,0,0,0,0
Comal,208,County Chairman,,REP,Sue Piner,158,13,172,343
Comal,208,County Chairman,,REP,Cast Votes:,158,13,172,343
Comal,208,County Chairman,,REP,Under Votes,29,3,28,60
Comal,208,County Chairman,,REP,Over Votes,0,0,0,0
Comal,208,Proposition 1,,REP,Yes,170,15,184,369
Comal,208,Proposition 1,,REP,No,15,0,11,26
Comal,208,Proposition 1,,REP,Cast Votes:,185,15,195,395
Comal,208,Proposition 1,,REP,Under Votes,2,1,5,8
Comal,208,Proposition 1,,REP,Over Votes,0,0,0,0
Comal,208,Proposition 2,,REP,Yes,161,14,176,351
Comal,208,Proposition 2,,REP,No,25,1,19,45
Comal,208,Proposition 2,,REP,Cast Votes:,186,15,195,396
Comal,208,Proposition 2,,REP,Under Votes,1,1,5,7
Comal,208,Proposition 2,,REP,Over Votes,0,0,0,0
Comal,208,Proposition 3,,REP,Yes,177,15,190,382
Comal,208,Proposition 3,,REP,No,7,0,5,12
Comal,208,Proposition 3,,REP,Cast Votes:,184,15,195,394
Comal,208,Proposition 3,,REP,Under Votes,3,1,5,9
Comal,208,Proposition 3,,REP,Over Votes,0,0,0,0
Comal,208,Proposition 4,,REP,Yes,175,14,185,374
Comal,208,Proposition 4,,REP,No,10,1,10,21
Comal,208,Proposition 4,,REP,Cast Votes:,185,15,195,395
Comal,208,Proposition 4,,REP,Under Votes,2,1,5,8
Comal,208,Proposition 4,,REP,Over Votes,0,0,0,0
Comal,208,Proposition 5,,REP,Yes,179,13,179,371
Comal,208,Proposition 5,,REP,No,5,1,17,23
Comal,208,Proposition 5,,REP,Cast Votes:,184,14,196,394
Comal,208,Proposition 5,,REP,Under Votes,3,2,4,9
Comal,208,Proposition 5,,REP,Over Votes,0,0,0,0
Comal,208,Proposition 6,,REP,Yes,179,13,188,380
Comal,208,Proposition 6,,REP,No,7,2,5,14
Comal,208,Proposition 6,,REP,Cast Votes:,186,15,193,394
Comal,208,Proposition 6,,REP,Under Votes,1,1,7,9
Comal,208,Proposition 6,,REP,Over Votes,0,0,0,0
Comal,208,Proposition 7,,REP,Yes,178,15,182,375
Comal,208,Proposition 7,,REP,No,7,0,13,20
Comal,208,Proposition 7,,REP,Cast Votes:,185,15,195,395
Comal,208,Proposition 7,,REP,Under Votes,2,1,5,8
Comal,208,Proposition 7,,REP,Over Votes,0,0,0,0
Comal,208,Proposition 8,,REP,Yes,184,15,194,393
Comal,208,Proposition 8,,REP,No,2,0,1,3
Comal,208,Proposition 8,,REP,Cast Votes:,186,15,195,396
Comal,208,Proposition 8,,REP,Under Votes,1,1,5,7
Comal,208,Proposition 8,,REP,Over Votes,0,0,0,0
Comal,208,Proposition 9,,REP,Yes,178,15,193,386
Comal,208,Proposition 9,,REP,No,7,0,2,9
Comal,208,Proposition 9,,REP,Cast Votes:,185,15,195,395
Comal,208,Proposition 9,,REP,Under Votes,2,1,5,8
Comal,208,Proposition 9,,REP,Over Votes,0,0,0,0
Comal,208,Proposition 10,,REP,Yes,169,13,183,365
Comal,208,Proposition 10,,REP,No,13,2,10,25
Comal,208,Proposition 10,,REP,Cast Votes:,182,15,193,390
Comal,208,Proposition 10,,REP,Under Votes,5,1,7,13
Comal,208,Proposition 10,,REP,Over Votes,0,0,0,0
Comal,301,President,,REP,Zoltan G. Istvan,0,0,1,1
Comal,301,President,,REP,Bill Weld,1,0,4,5
Comal,301,President,,REP,"Roque ""Rocky"" De La Fuente Guerra",0,0,0,0
Comal,301,President,,REP,Matthew John Matern,0,0,0,0
Comal,301,President,,REP,Donald J. Trump,161,10,122,293
Comal,301,President,,REP,Joe Walsh,6,0,1,7
Comal,301,President,,REP,Bob Ely,0,0,0,0
Comal,301,President,,REP,Uncommitted,5,0,2,7
Comal,301,Ballots Cast,,REP,,173,10,130,313
Comal,301,President,,REP,Under Votes,0,0,1,1
Comal,301,President,,REP,Over Votes,0,0,0,0
Comal,301,U.S. Senate,,REP,John Anthony Castro,16,1,7,24
Comal,301,U.S. Senate,,REP,Virgil Bierschwale,3,0,2,5
Comal,301,U.S. Senate,,REP,John Cornyn,110,5,105,220
Comal,301,U.S. Senate,,REP,Mark Yancey,13,0,1,14
Comal,301,U.S. Senate,,REP,Dwayne Stovall,21,1,8,30
Comal,301,U.S. Senate,,REP,Cast Votes:,163,7,123,293
Comal,301,U.S. Senate,,REP,Under Votes,10,3,8,21
Comal,301,U.S. Senate,,REP,Over Votes,0,0,0,0
Comal,301,U.S. House,35,REP,Jenny Garcia Sharon,70,0,38,108
Comal,301,U.S. House,35,REP,Guillermo William Hayward,35,4,36,75
Comal,301,U.S. House,35,REP,Nick Moutos,41,1,26,68
Comal,301,U.S. House,35,REP,Cast Votes:,146,5,100,251
Comal,301,U.S. House,35,REP,Under Votes,27,5,29,61
Comal,301,U.S. House,35,REP,Over Votes,0,0,2,2
Comal,301,Railroad Commissioner,,REP,"James ""Jim"" Wright",95,2,75,172
Comal,301,Railroad Commissioner,,REP,Ryan Sitton,60,4,39,103
Comal,301,Railroad Commissioner,,REP,Cast Votes:,155,6,114,275
Comal,301,Railroad Commissioner,,REP,Under Votes,18,4,17,39
Comal,301,Railroad Commissioner,,REP,Over Votes,0,0,0,0
Comal,301,"Chief Justice, Supreme Court",,REP,Nathan Hecht,156,5,115,276
Comal,301,"Chief Justice, Supreme Court",,REP,Cast Votes:,156,5,115,276
Comal,301,"Chief Justice, Supreme Court",,REP,Under Votes,17,5,16,38
Comal,301,"Chief Justice, Supreme Court",,REP,Over Votes,0,0,0,0
Comal,301,"Justice, Supreme Court, Place 6 Unexpired Term",,REP,Jane Bland,153,5,113,271
Comal,301,"Justice, Supreme Court, Place 6 Unexpired Term",,REP,Cast Votes:,153,5,113,271
Comal,301,"Justice, Supreme Court, Place 6 Unexpired Term",,REP,Under Votes,20,5,18,43
Comal,301,"Justice, Supreme Court, Place 6 Unexpired Term",,REP,Over Votes,0,0,0,0
Comal,301,"Justice, Supreme Court, Place 7",,REP,Jeff Boyd,153,5,115,273
Comal,301,"Justice, Supreme Court, Place 7",,REP,Cast Votes:,153,5,115,273
Comal,301,"Justice, Supreme Court, Place 7",,REP,Under Votes,20,5,16,41
Comal,301,"Justice, Supreme Court, Place 7",,REP,Over Votes,0,0,0,0
Comal,301,"Justice, Supreme Court, Place 8",,REP,Brett Busby,152,5,115,272
Comal,301,"Justice, Supreme Court, Place 8",,REP,Cast Votes:,152,5,115,272
Comal,301,"Justice, Supreme Court, Place 8",,REP,Under Votes,21,5,16,42
Comal,301,"Justice, Supreme Court, Place 8",,REP,Over Votes,0,0,0,0
Comal,301,"Judge, Court of Criminal Appeals, Place 3",,REP,Gina Parker,81,3,54,138
Comal,301,"Judge, Court of Criminal Appeals, Place 3",,REP,Bert Richardson,77,2,59,138
Comal,301,"Judge, Court of Criminal Appeals, Place 3",,REP,Cast Votes:,158,5,113,276
Comal,301,"Judge, Court of Criminal Appeals, Place 3",,REP,Under Votes,15,5,18,38
Comal,301,"Judge, Court of Criminal Appeals, Place 3",,REP,Over Votes,0,0,0,0
Comal,301,"Judge, Court of Criminal Appeals, Place 4",,REP,Kevin Patrick Yeary,151,5,115,271
Comal,301,"Judge, Court of Criminal Appeals, Place 4",,REP,Cast Votes:,151,5,115,271
Comal,301,"Judge, Court of Criminal Appeals, Place 4",,REP,Under Votes,22,5,16,43
Comal,301,"Judge, Court of Criminal Appeals, Place 4",,REP,Over Votes,0,0,0,0
Comal,301,"Judge, Court of Criminal Appeals, Place 9",,REP,David Newell,151,5,116,272
Comal,301,"Judge, Court of Criminal Appeals, Place 9",,REP,Cast Votes:,151,5,116,272
Comal,301,"Judge, Court of Criminal Appeals, Place 9",,REP,Under Votes,22,5,15,42
Comal,301,"Judge, Court of Criminal Appeals, Place 9",,REP,Over Votes,0,0,0,0
Comal,301,"Member, State Board of Education, District 5",,REP,Lani Popp,50,1,52,103
Comal,301,"Member, State Board of Education, District 5",,REP,Inga Cotton,36,2,16,54
Comal,301,"Member, State Board of Education, District 5",,REP,Robert Morrow,70,2,39,111
Comal,301,"Member, State Board of Education, District 5",,REP,Cast Votes:,156,5,107,268
Comal,301,"Member, State Board of Education, District 5",,REP,Under Votes,17,5,24,46
Comal,301,"Member, State Board of Education, District 5",,REP,Over Votes,0,0,0,0
Comal,301,State Representative,73,REP,Kyle Biedermann,158,5,112,275
Comal,301,State Representative,73,REP,Cast Votes:,158,5,112,275
Comal,301,State Representative,73,REP,Under Votes,15,5,19,39
Comal,301,State Representative,73,REP,Over Votes,0,0,0,0
Comal,301,"Chief Justice, 3rd Court of Appeals District",,REP,Jeff Rose,153,5,110,268
Comal,301,"Chief Justice, 3rd Court of Appeals District",,REP,Cast Votes:,153,5,110,268
Comal,301,"Chief Justice, 3rd Court of Appeals District",,REP,Under Votes,20,5,21,46
Comal,301,"Chief Justice, 3rd Court of Appeals District",,REP,Over Votes,0,0,0,0
Comal,301,"District Judge, 22nd Judicial District",,REP,R. Bruce Boyer,152,5,110,267
Comal,301,"District Judge, 22nd Judicial District",,REP,Cast Votes:,152,5,110,267
Comal,301,"District Judge, 22nd Judicial District",,REP,Under Votes,21,5,21,47
Comal,301,"District Judge, 22nd Judicial District",,REP,Over Votes,0,0,0,0
Comal,301,"District Judge, 433rd Judicial District",,REP,Dib Waldrip,114,7,97,218
Comal,301,"District Judge, 433rd Judicial District",,REP,Charlie Sullivan,52,0,23,75
Comal,301,"District Judge, 433rd Judicial District",,REP,Cast Votes:,166,7,120,293
Comal,301,"District Judge, 433rd Judicial District",,REP,Under Votes,7,3,9,19
Comal,301,"District Judge, 433rd Judicial District",,REP,Over Votes,0,0,2,2
Comal,301,"Judge, County Court at Law No. 2",,REP,"Charles A. Stephens, II",154,6,111,271
Comal,301,"Judge, County Court at Law No. 2",,REP,Cast Votes:,154,6,111,271
Comal,301,"Judge, County Court at Law No. 2",,REP,Under Votes,19,4,20,43
Comal,301,"Judge, County Court at Law No. 2",,REP,Over Votes,0,0,0,0
Comal,301,"Judge, County Court at Law No. 3",,REP,Deborah Linnartz Wigington,152,5,106,263
Comal,301,"Judge, County Court at Law No. 3",,REP,Cast Votes:,152,5,106,263
Comal,301,"Judge, County Court at Law No. 3",,REP,Under Votes,21,5,25,51
Comal,301,"Judge, County Court at Law No. 3",,REP,Over Votes,0,0,0,0
Comal,301,Sheriff,,REP,Mark Reynolds,161,6,114,281
Comal,301,Sheriff,,REP,Cast Votes:,161,6,114,281
Comal,301,Sheriff,,REP,Under Votes,12,4,17,33
Comal,301,Sheriff,,REP,Over Votes,0,0,0,0
Comal,301,County Tax Assessor-Collector,,REP,Kristen H. Hoyt,96,2,68,166
Comal,301,County Tax Assessor-Collector,,REP,Patrick Aten,64,4,50,118
Comal,301,County Tax Assessor-Collector,,REP,Cast Votes:,160,6,118,284
Comal,301,County Tax Assessor-Collector,,REP,Under Votes,13,4,11,28
Comal,301,County Tax Assessor-Collector,,REP,Over Votes,0,0,2,2
Comal,301,"County Commissioner, Precinct 3",,REP,Kevin Webb,154,5,111,270
Comal,301,"County Commissioner, Precinct 3",,REP,Cast Votes:,154,5,111,270
Comal,301,"County Commissioner, Precinct 3",,REP,Under Votes,19,5,20,44
Comal,301,"County Commissioner, Precinct 3",,REP,Over Votes,0,0,0,0
Comal,301,"Constable, Precinct No. 3",,REP,Craig Ackerman,91,3,71,165
Comal,301,"Constable, Precinct No. 3",,REP,Scott Head,67,4,40,111
Comal,301,"Constable, Precinct No. 3",,REP,Cast Votes:,158,7,111,276
Comal,301,"Constable, Precinct No. 3",,REP,Under Votes,15,3,18,36
Comal,301,"Constable, Precinct No. 3",,REP,Over Votes,0,0,2,2
Comal,301,County Chairman,,REP,Sue Piner,151,5,106,262
Comal,301,County Chairman,,REP,Cast Votes:,151,5,106,262
Comal,301,County Chairman,,REP,Under Votes,22,5,25,52
Comal,301,County Chairman,,REP,Over Votes,0,0,0,0
Comal,301,Proposition 1,,REP,Yes,146,7,119,272
Comal,301,Proposition 1,,REP,No,20,2,12,34
Comal,301,Proposition 1,,REP,Cast Votes:,166,9,131,306
Comal,301,Proposition 1,,REP,Under Votes,7,1,0,8
Comal,301,Proposition 1,,REP,Over Votes,0,0,0,0
Comal,301,Proposition 2,,REP,Yes,138,8,108,254
Comal,301,Proposition 2,,REP,No,29,2,21,52
Comal,301,Proposition 2,,REP,Cast Votes:,167,10,129,306
Comal,301,Proposition 2,,REP,Under Votes,6,0,2,8
Comal,301,Proposition 2,,REP,Over Votes,0,0,0,0
Comal,301,Proposition 3,,REP,Yes,154,10,119,283
Comal,301,Proposition 3,,REP,No,10,0,5,15
Comal,301,Proposition 3,,REP,Cast Votes:,164,10,124,298
Comal,301,Proposition 3,,REP,Under Votes,9,0,7,16
Comal,301,Proposition 3,,REP,Over Votes,0,0,0,0
Comal,301,Proposition 4,,REP,Yes,156,10,125,291
Comal,301,Proposition 4,,REP,No,8,0,5,13
Comal,301,Proposition 4,,REP,Cast Votes:,164,10,130,304
Comal,301,Proposition 4,,REP,Under Votes,9,0,1,10
Comal,301,Proposition 4,,REP,Over Votes,0,0,0,0
Comal,301,Proposition 5,,REP,Yes,149,10,109,268
Comal,301,Proposition 5,,REP,No,17,0,18,35
Comal,301,Proposition 5,,REP,Cast Votes:,166,10,127,303
Comal,301,Proposition 5,,REP,Under Votes,7,0,4,11
Comal,301,Proposition 5,,REP,Over Votes,0,0,0,0
Comal,301,Proposition 6,,REP,Yes,157,10,121,288
Comal,301,Proposition 6,,REP,No,7,0,5,12
Comal,301,Proposition 6,,REP,Cast Votes:,164,10,126,300
Comal,301,Proposition 6,,REP,Under Votes,9,0,5,14
Comal,301,Proposition 6,,REP,Over Votes,0,0,0,0
Comal,301,Proposition 7,,REP,Yes,160,10,123,293
Comal,301,Proposition 7,,REP,No,6,0,6,12
Comal,301,Proposition 7,,REP,Cast Votes:,166,10,129,305
Comal,301,Proposition 7,,REP,Under Votes,7,0,2,9
Comal,301,Proposition 7,,REP,Over Votes,0,0,0,0
Comal,301,Proposition 8,,REP,Yes,161,10,128,299
Comal,301,Proposition 8,,REP,No,4,0,2,6
Comal,301,Proposition 8,,REP,Cast Votes:,165,10,130,305
Comal,301,Proposition 8,,REP,Under Votes,8,0,1,9
Comal,301,Proposition 8,,REP,Over Votes,0,0,0,0
Comal,301,Proposition 9,,REP,Yes,146,9,121,276
Comal,301,Proposition 9,,REP,No,18,1,7,26
Comal,301,Proposition 9,,REP,Cast Votes:,164,10,128,302
Comal,301,Proposition 9,,REP,Under Votes,9,0,3,12
Comal,301,Proposition 9,,REP,Over Votes,0,0,0,0
Comal,301,Proposition 10,,REP,Yes,152,10,119,281
Comal,301,Proposition 10,,REP,No,12,0,6,18
Comal,301,Proposition 10,,REP,Cast Votes:,164,10,125,299
Comal,301,Proposition 10,,REP,Under Votes,9,0,6,15
Comal,301,Proposition 10,,REP,Over Votes,0,0,0,0
Comal,302,President,,REP,Zoltan G. Istvan,0,0,0,0
Comal,302,President,,REP,Bill Weld,2,0,4,6
Comal,302,President,,REP,"Roque ""Rocky"" De La Fuente Guerra",1,0,3,4
Comal,302,President,,REP,Matthew John Matern,0,0,1,1
Comal,302,President,,REP,Donald J. Trump,326,18,431,775
Comal,302,President,,REP,Joe Walsh,2,0,3,5
Comal,302,President,,REP,Bob Ely,0,0,2,2
Comal,302,President,,REP,Uncommitted,17,3,10,30
Comal,302,Ballots Cast,,REP,,348,21,454,823
Comal,302,President,,REP,Under Votes,1,0,2,3
Comal,302,President,,REP,Over Votes,0,0,0,0
Comal,302,U.S. Senate,,REP,John Anthony Castro,22,0,18,40
Comal,302,U.S. Senate,,REP,Virgil Bierschwale,4,0,6,10
Comal,302,U.S. Senate,,REP,John Cornyn,240,16,361,617
Comal,302,U.S. Senate,,REP,Mark Yancey,19,1,23,43
Comal,302,U.S. Senate,,REP,Dwayne Stovall,37,3,26,66
Comal,302,U.S. Senate,,REP,Cast Votes:,322,20,434,776
Comal,302,U.S. Senate,,REP,Under Votes,27,1,22,50
Comal,302,U.S. Senate,,REP,Over Votes,0,0,0,0
Comal,302,U.S. House,35,REP,Jenny Garcia Sharon,119,11,177,307
Comal,302,U.S. House,35,REP,Guillermo William Hayward,86,2,98,186
Comal,302,U.S. House,35,REP,Nick Moutos,74,8,93,175
Comal,302,U.S. House,35,REP,Cast Votes:,279,21,368,668
Comal,302,U.S. House,35,REP,Under Votes,70,0,87,157
Comal,302,U.S. House,35,REP,Over Votes,0,0,1,1
Comal,302,Railroad Commissioner,,REP,"James ""Jim"" Wright",177,12,234,423
Comal,302,Railroad Commissioner,,REP,Ryan Sitton,115,7,170,292
Comal,302,Railroad Commissioner,,REP,Cast Votes:,292,19,404,715
Comal,302,Railroad Commissioner,,REP,Under Votes,57,2,52,111
Comal,302,Railroad Commissioner,,REP,Over Votes,0,0,0,0
Comal,302,"Chief Justice, Supreme Court",,REP,Nathan Hecht,292,18,389,699
Comal,302,"Chief Justice, Supreme Court",,REP,Cast Votes:,292,18,389,699
Comal,302,"Chief Justice, Supreme Court",,REP,Under Votes,57,3,67,127
Comal,302,"Chief Justice, Supreme Court",,REP,Over Votes,0,0,0,0
Comal,302,"Justice, Supreme Court, Place 6 Unexpired Term",,REP,Jane Bland,287,18,388,693
Comal,302,"Justice, Supreme Court, Place 6 Unexpired Term",,REP,Cast Votes:,287,18,388,693
Comal,302,"Justice, Supreme Court, Place 6 Unexpired Term",,REP,Under Votes,62,3,68,133
Comal,302,"Justice, Supreme Court, Place 6 Unexpired Term",,REP,Over Votes,0,0,0,0
Comal,302,"Justice, Supreme Court, Place 7",,REP,Jeff Boyd,290,18,389,697
Comal,302,"Justice, Supreme Court, Place 7",,REP,Cast Votes:,290,18,389,697
Comal,302,"Justice, Supreme Court, Place 7",,REP,Under Votes,59,3,67,129
Comal,302,"Justice, Supreme Court, Place 7",,REP,Over Votes,0,0,0,0
Comal,302,"Justice, Supreme Court, Place 8",,REP,Brett Busby,288,18,385,691
Comal,302,"Justice, Supreme Court, Place 8",,REP,Cast Votes:,288,18,385,691
Comal,302,"Justice, Supreme Court, Place 8",,REP,Under Votes,61,3,71,135
Comal,302,"Justice, Supreme Court, Place 8",,REP,Over Votes,0,0,0,0
Comal,302,"Judge, Court of Criminal Appeals, Place 3",,REP,Gina Parker,161,9,181,351
Comal,302,"Judge, Court of Criminal Appeals, Place 3",,REP,Bert Richardson,129,11,202,342
Comal,302,"Judge, Court of Criminal Appeals, Place 3",,REP,Cast Votes:,290,20,383,693
Comal,302,"Judge, Court of Criminal Appeals, Place 3",,REP,Under Votes,59,1,73,133
Comal,302,"Judge, Court of Criminal Appeals, Place 3",,REP,Over Votes,0,0,0,0
Comal,302,"Judge, Court of Criminal Appeals, Place 4",,REP,Kevin Patrick Yeary,283,18,384,685
Comal,302,"Judge, Court of Criminal Appeals, Place 4",,REP,Cast Votes:,283,18,384,685
Comal,302,"Judge, Court of Criminal Appeals, Place 4",,REP,Under Votes,66,3,72,141
Comal,302,"Judge, Court of Criminal Appeals, Place 4",,REP,Over Votes,0,0,0,0
Comal,302,"Judge, Court of Criminal Appeals, Place 9",,REP,David Newell,285,18,380,683
Comal,302,"Judge, Court of Criminal Appeals, Place 9",,REP,Cast Votes:,285,18,380,683
Comal,302,"Judge, Court of Criminal Appeals, Place 9",,REP,Under Votes,64,3,76,143
Comal,302,"Judge, Court of Criminal Appeals, Place 9",,REP,Over Votes,0,0,0,0
Comal,302,"Member, State Board of Education, District 5",,REP,Lani Popp,100,9,163,272
Comal,302,"Member, State Board of Education, District 5",,REP,Inga Cotton,63,5,87,155
Comal,302,"Member, State Board of Education, District 5",,REP,Robert Morrow,121,6,135,262
Comal,302,"Member, State Board of Education, District 5",,REP,Cast Votes:,284,20,385,689
Comal,302,"Member, State Board of Education, District 5",,REP,Under Votes,65,1,71,137
Comal,302,"Member, State Board of Education, District 5",,REP,Over Votes,0,0,0,0
Comal,302,State Representative,73,REP,Kyle Biedermann,299,19,394,712
Comal,302,State Representative,73,REP,Cast Votes:,299,19,394,712
Comal,302,State Representative,73,REP,Under Votes,50,2,62,114
Comal,302,State Representative,73,REP,Over Votes,0,0,0,0
Comal,302,"Chief Justice, 3rd Court of Appeals District",,REP,Jeff Rose,285,18,383,686
Comal,302,"Chief Justice, 3rd Court of Appeals District",,REP,Cast Votes:,285,18,383,686
Comal,302,"Chief Justice, 3rd Court of Appeals District",,REP,Under Votes,64,3,73,140
Comal,302,"Chief Justice, 3rd Court of Appeals District",,REP,Over Votes,0,0,0,0
Comal,302,"District Judge, 22nd Judicial District",,REP,R. Bruce Boyer,291,18,392,701
Comal,302,"District Judge, 22nd Judicial District",,REP,Cast Votes:,291,18,392,701
Comal,302,"District Judge, 22nd Judicial District",,REP,Under Votes,58,3,64,125
Comal,302,"District Judge, 22nd Judicial District",,REP,Over Votes,0,0,0,0
Comal,302,"District Judge, 433rd Judicial District",,REP,Dib Waldrip,238,14,348,600
Comal,302,"District Judge, 433rd Judicial District",,REP,Charlie Sullivan,82,6,76,164
Comal,302,"District Judge, 433rd Judicial District",,REP,Cast Votes:,320,20,424,764
Comal,302,"District Judge, 433rd Judicial District",,REP,Under Votes,29,1,31,61
Comal,302,"District Judge, 433rd Judicial District",,REP,Over Votes,0,0,1,1
Comal,302,"Judge, County Court at Law No. 2",,REP,"Charles A. Stephens, II",290,18,394,702
Comal,302,"Judge, County Court at Law No. 2",,REP,Cast Votes:,290,18,394,702
Comal,302,"Judge, County Court at Law No. 2",,REP,Under Votes,59,3,62,124
Comal,302,"Judge, County Court at Law No. 2",,REP,Over Votes,0,0,0,0
Comal,302,"Judge, County Court at Law No. 3",,REP,Deborah Linnartz Wigington,285,18,385,688
Comal,302,"Judge, County Court at Law No. 3",,REP,Cast Votes:,285,18,385,688
Comal,302,"Judge, County Court at Law No. 3",,REP,Under Votes,64,3,71,138
Comal,302,"Judge, County Court at Law No. 3",,REP,Over Votes,0,0,0,0
Comal,302,Sheriff,,REP,Mark Reynolds,305,18,400,723
Comal,302,Sheriff,,REP,Cast Votes:,305,18,400,723
Comal,302,Sheriff,,REP,Under Votes,44,3,56,103
Comal,302,Sheriff,,REP,Over Votes,0,0,0,0
Comal,302,County Tax Assessor-Collector,,REP,Kristen H. Hoyt,175,11,211,397
Comal,302,County Tax Assessor-Collector,,REP,Patrick Aten,146,9,211,366
Comal,302,County Tax Assessor-Collector,,REP,Cast Votes:,321,20,422,763
Comal,302,County Tax Assessor-Collector,,REP,Under Votes,28,1,33,62
Comal,302,County Tax Assessor-Collector,,REP,Over Votes,0,0,1,1
Comal,302,"County Commissioner, Precinct 3",,REP,Kevin Webb,289,18,391,698
Comal,302,"County Commissioner, Precinct 3",,REP,Cast Votes:,289,18,391,698
Comal,302,"County Commissioner, Precinct 3",,REP,Under Votes,60,3,65,128
Comal,302,"County Commissioner, Precinct 3",,REP,Over Votes,0,0,0,0
Comal,302,"Constable, Precinct No. 3",,REP,Craig Ackerman,169,10,228,407
Comal,302,"Constable, Precinct No. 3",,REP,Scott Head,131,10,173,314
Comal,302,"Constable, Precinct No. 3",,REP,Cast Votes:,300,20,401,721
Comal,302,"Constable, Precinct No. 3",,REP,Under Votes,49,1,54,104
Comal,302,"Constable, Precinct No. 3",,REP,Over Votes,0,0,1,1
Comal,302,County Chairman,,REP,Sue Piner,281,18,381,680
Comal,302,County Chairman,,REP,Cast Votes:,281,18,381,680
Comal,302,County Chairman,,REP,Under Votes,68,3,75,146
Comal,302,County Chairman,,REP,Over Votes,0,0,0,0
Comal,302,Proposition 1,,REP,Yes,311,19,409,739
Comal,302,Proposition 1,,REP,No,37,2,42,81
Comal,302,Proposition 1,,REP,Cast Votes:,348,21,451,820
Comal,302,Proposition 1,,REP,Under Votes,1,0,5,6
Comal,302,Proposition 1,,REP,Over Votes,0,0,0,0
Comal,302,Proposition 2,,REP,Yes,298,16,379,693
Comal,302,Proposition 2,,REP,No,45,5,73,123
Comal,302,Proposition 2,,REP,Cast Votes:,343,21,452,816
Comal,302,Proposition 2,,REP,Under Votes,6,0,4,10
Comal,302,Proposition 2,,REP,Over Votes,0,0,0,0
Comal,302,Proposition 3,,REP,Yes,320,20,419,759
Comal,302,Proposition 3,,REP,No,20,1,26,47
Comal,302,Proposition 3,,REP,Cast Votes:,340,21,445,806
Comal,302,Proposition 3,,REP,Under Votes,9,0,11,20
Comal,302,Proposition 3,,REP,Over Votes,0,0,0,0
Comal,302,Proposition 4,,REP,Yes,310,19,420,749
Comal,302,Proposition 4,,REP,No,26,2,27,55
Comal,302,Proposition 4,,REP,Cast Votes:,336,21,447,804
Comal,302,Proposition 4,,REP,Under Votes,13,0,9,22
Comal,302,Proposition 4,,REP,Over Votes,0,0,0,0
Comal,302,Proposition 5,,REP,Yes,305,19,392,716
Comal,302,Proposition 5,,REP,No,35,1,48,84
Comal,302,Proposition 5,,REP,Cast Votes:,340,20,440,800
Comal,302,Proposition 5,,REP,Under Votes,9,1,16,26
Comal,302,Proposition 5,,REP,Over Votes,0,0,0,0
Comal,302,Proposition 6,,REP,Yes,316,19,407,742
Comal,302,Proposition 6,,REP,No,20,1,34,55
Comal,302,Proposition 6,,REP,Cast Votes:,336,20,441,797
Comal,302,Proposition 6,,REP,Under Votes,13,1,15,29
Comal,302,Proposition 6,,REP,Over Votes,0,0,0,0
Comal,302,Proposition 7,,REP,Yes,328,19,425,772
Comal,302,Proposition 7,,REP,No,13,1,18,32
Comal,302,Proposition 7,,REP,Cast Votes:,341,20,443,804
Comal,302,Proposition 7,,REP,Under Votes,8,1,13,22
Comal,302,Proposition 7,,REP,Over Votes,0,0,0,0
Comal,302,Proposition 8,,REP,Yes,338,20,439,797
Comal,302,Proposition 8,,REP,No,3,0,6,9
Comal,302,Proposition 8,,REP,Cast Votes:,341,20,445,806
Comal,302,Proposition 8,,REP,Under Votes,8,1,11,20
Comal,302,Proposition 8,,REP,Over Votes,0,0,0,0
Comal,302,Proposition 9,,REP,Yes,323,19,428,770
Comal,302,Proposition 9,,REP,No,16,1,21,38
Comal,302,Proposition 9,,REP,Cast Votes:,339,20,449,808
Comal,302,Proposition 9,,REP,Under Votes,10,1,7,18
Comal,302,Proposition 9,,REP,Over Votes,0,0,0,0
Comal,302,Proposition 10,,REP,Yes,322,19,419,760
Comal,302,Proposition 10,,REP,No,15,2,25,42
Comal,302,Proposition 10,,REP,Cast Votes:,337,21,444,802
Comal,302,Proposition 10,,REP,Under Votes,12,0,12,24
Comal,302,Proposition 10,,REP,Over Votes,0,0,0,0
Comal,101,President,,REP,Zoltan G. Istvan,0,0,1,1
Comal,101,President,,REP,Bill Weld,4,0,7,11
Comal,101,President,,REP,"Roque ""Rocky"" De La Fuente Guerra",0,0,3,3
Comal,101,President,,REP,Matthew John Matern,1,0,1,2
Comal,101,President,,REP,Donald J. Trump,322,37,439,798
Comal,101,President,,REP,Joe Walsh,4,1,2,7
Comal,101,President,,REP,Bob Ely,0,0,0,0
Comal,101,President,,REP,Uncommitted,28,1,30,59
Comal,101,Ballots Cast,,REP,,359,39,483,881
Comal,101,President,,REP,Under Votes,0,0,10,10
Comal,101,President,,REP,Over Votes,0,0,0,0
Comal,101,U.S. Senate,,REP,John Anthony Castro,12,1,17,30
Comal,101,U.S. Senate,,REP,Virgil Bierschwale,8,0,6,14
Comal,101,U.S. Senate,,REP,John Cornyn,280,38,403,721
Comal,101,U.S. Senate,,REP,Mark Yancey,13,0,16,29
Comal,101,U.S. Senate,,REP,Dwayne Stovall,24,0,22,46
Comal,101,U.S. Senate,,REP,Cast Votes:,337,39,464,840
Comal,101,U.S. Senate,,REP,Under Votes,22,0,29,51
Comal,101,U.S. Senate,,REP,Over Votes,0,0,0,0
Comal,101,U.S. House,21,REP,Chip Roy,327,34,448,809
Comal,101,U.S. House,21,REP,Cast Votes:,327,34,448,809
Comal,101,U.S. House,21,REP,Under Votes,32,5,45,82
Comal,101,U.S. House,21,REP,Over Votes,0,0,0,0
Comal,101,Railroad Commissioner,,REP,"James ""Jim"" Wright",189,20,232,441
Comal,101,Railroad Commissioner,,REP,Ryan Sitton,125,17,203,345
Comal,101,Railroad Commissioner,,REP,Cast Votes:,314,37,435,786
Comal,101,Railroad Commissioner,,REP,Under Votes,45,2,58,105
Comal,101,Railroad Commissioner,,REP,Over Votes,0,0,0,0
Comal,101,"Chief Justice, Supreme Court",,REP,Nathan Hecht,310,33,421,764
Comal,101,"Chief Justice, Supreme Court",,REP,Cast Votes:,310,33,421,764
Comal,101,"Chief Justice, Supreme Court",,REP,Under Votes,49,6,72,127
Comal,101,"Chief Justice, Supreme Court",,REP,Over Votes,0,0,0,0
Comal,101,"Justice, Supreme Court, Place 6 Unexpired Term",,REP,Jane Bland,308,33,409,750
Comal,101,"Justice, Supreme Court, Place 6 Unexpired Term",,REP,Cast Votes:,308,33,409,750
Comal,101,"Justice, Supreme Court, Place 6 Unexpired Term",,REP,Under Votes,51,6,84,141
Comal,101,"Justice, Supreme Court, Place 6 Unexpired Term",,REP,Over Votes,0,0,0,0
Comal,101,"Justice, Supreme Court, Place 7",,REP,Jeff Boyd,311,33,414,758
Comal,101,"Justice, Supreme Court, Place 7",,REP,Cast Votes:,311,33,414,758
Comal,101,"Justice, Supreme Court, Place 7",,REP,Under Votes,48,6,79,133
Comal,101,"Justice, Supreme Court, Place 7",,REP,Over Votes,0,0,0,0
Comal,101,"Justice, Supreme Court, Place 8",,REP,Brett Busby,306,33,408,747
Comal,101,"Justice, Supreme Court, Place 8",,REP,Cast Votes:,306,33,408,747
Comal,101,"Justice, Supreme Court, Place 8",,REP,Under Votes,53,6,85,144
Comal,101,"Justice, Supreme Court, Place 8",,REP,Over Votes,0,0,0,0
Comal,101,"Judge, Court of Criminal Appeals, Place 3",,REP,Gina Parker,141,15,171,327
Comal,101,"Judge, Court of Criminal Appeals, Place 3",,REP,Bert Richardson,159,19,247,425
Comal,101,"Judge, Court of Criminal Appeals, Place 3",,REP,Cast Votes:,300,34,418,752
Comal,101,"Judge, Court of Criminal Appeals, Place 3",,REP,Under Votes,59,5,75,139
Comal,101,"Judge, Court of Criminal Appeals, Place 3",,REP,Over Votes,0,0,0,0
Comal,101,"Judge, Court of Criminal Appeals, Place 4",,REP,Kevin Patrick Yeary,303,33,413,749
Comal,101,"Judge, Court of Criminal Appeals, Place 4",,REP,Cast Votes:,303,33,413,749
Comal,101,"Judge, Court of Criminal Appeals, Place 4",,REP,Under Votes,56,6,80,142
Comal,101,"Judge, Court of Criminal Appeals, Place 4",,REP,Over Votes,0,0,0,0
Comal,101,"Judge, Court of Criminal Appeals, Place 9",,REP,David Newell,301,33,407,741
Comal,101,"Judge, Court of Criminal Appeals, Place 9",,REP,Cast Votes:,301,33,407,741
Comal,101,"Judge, Court of Criminal Appeals, Place 9",,REP,Under Votes,58,6,86,150
Comal,101,"Judge, Court of Criminal Appeals, Place 9",,REP,Over Votes,0,0,0,0
Comal,101,"Member, State Board of Education, District 5",,REP,Lani Popp,97,14,203,314
Comal,101,"Member, State Board of Education, District 5",,REP,Inga Cotton,83,10,88,181
Comal,101,"Member, State Board of Education, District 5",,REP,Robert Morrow,121,8,118,247
Comal,101,"Member, State Board of Education, District 5",,REP,Cast Votes:,301,32,409,742
Comal,101,"Member, State Board of Education, District 5",,REP,Under Votes,58,6,84,148
Comal,101,"Member, State Board of Education, District 5",,REP,Over Votes,0,1,0,1
Comal,101,State Representative,73,REP,Kyle Biedermann,316,34,409,759
Comal,101,State Representative,73,REP,Cast Votes:,316,34,409,759
Comal,101,State Representative,73,REP,Under Votes,43,5,84,132
Comal,101,State Representative,73,REP,Over Votes,0,0,0,0
Comal,101,"Chief Justice, 3rd Court of Appeals District",,REP,Jeff Rose,308,31,407,746
Comal,101,"Chief Justice, 3rd Court of Appeals District",,REP,Cast Votes:,308,31,407,746
Comal,101,"Chief Justice, 3rd Court of Appeals District",,REP,Under Votes,51,8,86,145
Comal,101,"Chief Justice, 3rd Court of Appeals District",,REP,Over Votes,0,0,0,0
Comal,101,"District Judge, 22nd Judicial District",,REP,R. Bruce Boyer,319,32,439,790
Comal,101,"District Judge, 22nd Judicial District",,REP,Cast Votes:,319,32,439,790
Comal,101,"District Judge, 22nd Judicial District",,REP,Under Votes,40,7,54,101
Comal,101,"District Judge, 22nd Judicial District",,REP,Over Votes,0,0,0,0
Comal,101,"District Judge, 433rd Judicial District",,REP,Dib Waldrip,298,35,430,763
Comal,101,"District Judge, 433rd Judicial District",,REP,Charlie Sullivan,48,4,49,101
Comal,101,"District Judge, 433rd Judicial District",,REP,Cast Votes:,346,39,479,864
Comal,101,"District Judge, 433rd Judicial District",,REP,Under Votes,13,0,14,27
Comal,101,"District Judge, 433rd Judicial District",,REP,Over Votes,0,0,0,0
Comal,101,"Judge, County Court at Law No. 2",,REP,"Charles A. Stephens, II",311,32,428,771
Comal,101,"Judge, County Court at Law No. 2",,REP,Cast Votes:,311,32,428,771
Comal,101,"Judge, County Court at Law No. 2",,REP,Under Votes,48,7,65,120
Comal,101,"Judge, County Court at Law No. 2",,REP,Over Votes,0,0,0,0
Comal,101,"Judge, County Court at Law No. 3",,REP,Deborah Linnartz Wigington,307,32,416,755
Comal,101,"Judge, County Court at Law No. 3",,REP,Cast Votes:,307,32,416,755
Comal,101,"Judge, County Court at Law No. 3",,REP,Under Votes,52,7,77,136
Comal,101,"Judge, County Court at Law No. 3",,REP,Over Votes,0,0,0,0
Comal,101,Sheriff,,REP,Mark Reynolds,311,31,438,780
Comal,101,Sheriff,,REP,Cast Votes:,311,31,438,780
Comal,101,Sheriff,,REP,Under Votes,48,8,55,111
Comal,101,Sheriff,,REP,Over Votes,0,0,0,0
Comal,101,County Tax Assessor-Collector,,REP,Kristen H. Hoyt,136,19,168,323
Comal,101,County Tax Assessor-Collector,,REP,Patrick Aten,198,20,304,522
Comal,101,County Tax Assessor-Collector,,REP,Cast Votes:,334,39,472,845
Comal,101,County Tax Assessor-Collector,,REP,Under Votes,25,0,21,46
Comal,101,County Tax Assessor-Collector,,REP,Over Votes,0,0,0,0
Comal,101,"County Commissioner, Precinct 1",,REP,Richard K. Smith,111,13,171,295
Comal,101,"County Commissioner, Precinct 1",,REP,Donna Eccleston,211,25,280,516
Comal,101,"County Commissioner, Precinct 1",,REP,Cast Votes:,322,38,451,811
Comal,101,"County Commissioner, Precinct 1",,REP,Under Votes,37,1,42,80
Comal,101,"County Commissioner, Precinct 1",,REP,Over Votes,0,0,0,0
Comal,101,"Constable, Precinct No. 1",,REP,Christopher Braun,67,7,97,171
Comal,101,"Constable, Precinct No. 1",,REP,Charlie Motz,240,30,338,608
Comal,101,"Constable, Precinct No. 1",,REP,Cast Votes:,307,37,435,779
Comal,101,"Constable, Precinct No. 1",,REP,Under Votes,52,2,58,112
Comal,101,"Constable, Precinct No. 1",,REP,Over Votes,0,0,0,0
Comal,101,County Chairman,,REP,Sue Piner,296,34,398,728
Comal,101,County Chairman,,REP,Cast Votes:,296,34,398,728
Comal,101,County Chairman,,REP,Under Votes,63,5,95,163
Comal,101,County Chairman,,REP,Over Votes,0,0,0,0
Comal,101,Proposition 1,,REP,Yes,330,34,441,805
Comal,101,Proposition 1,,REP,No,24,4,37,65
Comal,101,Proposition 1,,REP,Cast Votes:,354,38,478,870
Comal,101,Proposition 1,,REP,Under Votes,5,1,15,21
Comal,101,Proposition 1,,REP,Over Votes,0,0,0,0
Comal,101,Proposition 2,,REP,Yes,297,36,396,729
Comal,101,Proposition 2,,REP,No,55,2,80,137
Comal,101,Proposition 2,,REP,Cast Votes:,352,38,476,866
Comal,101,Proposition 2,,REP,Under Votes,7,1,17,25
Comal,101,Proposition 2,,REP,Over Votes,0,0,0,0
Comal,101,Proposition 3,,REP,Yes,326,39,448,813
Comal,101,Proposition 3,,REP,No,19,0,23,42
Comal,101,Proposition 3,,REP,Cast Votes:,345,39,471,855
Comal,101,Proposition 3,,REP,Under Votes,14,0,22,36
Comal,101,Proposition 3,,REP,Over Votes,0,0,0,0
Comal,101,Proposition 4,,REP,Yes,310,37,419,766
Comal,101,Proposition 4,,REP,No,42,2,47,91
Comal,101,Proposition 4,,REP,Cast Votes:,352,39,466,857
Comal,101,Proposition 4,,REP,Under Votes,7,0,27,34
Comal,101,Proposition 4,,REP,Over Votes,0,0,0,0
Comal,101,Proposition 5,,REP,Yes,303,34,403,740
Comal,101,Proposition 5,,REP,No,40,5,68,113
Comal,101,Proposition 5,,REP,Cast Votes:,343,39,471,853
Comal,101,Proposition 5,,REP,Under Votes,16,0,22,38
Comal,101,Proposition 5,,REP,Over Votes,0,0,0,0
Comal,101,Proposition 6,,REP,Yes,319,38,424,781
Comal,101,Proposition 6,,REP,No,27,0,38,65
Comal,101,Proposition 6,,REP,Cast Votes:,346,38,462,846
Comal,101,Proposition 6,,REP,Under Votes,13,1,31,45
Comal,101,Proposition 6,,REP,Over Votes,0,0,0,0
Comal,101,Proposition 7,,REP,Yes,330,39,425,794
Comal,101,Proposition 7,,REP,No,19,0,36,55
Comal,101,Proposition 7,,REP,Cast Votes:,349,39,461,849
Comal,101,Proposition 7,,REP,Under Votes,10,0,32,42
Comal,101,Proposition 7,,REP,Over Votes,0,0,0,0
Comal,101,Proposition 8,,REP,Yes,342,39,462,843
Comal,101,Proposition 8,,REP,No,7,0,18,25
Comal,101,Proposition 8,,REP,Cast Votes:,349,39,480,868
Comal,101,Proposition 8,,REP,Under Votes,10,0,13,23
Comal,101,Proposition 8,,REP,Over Votes,0,0,0,0
Comal,101,Proposition 9,,REP,Yes,330,39,447,816
Comal,101,Proposition 9,,REP,No,18,0,28,46
Comal,101,Proposition 9,,REP,Cast Votes:,348,39,475,862
Comal,101,Proposition 9,,REP,Under Votes,11,0,18,29
Comal,101,Proposition 9,,REP,Over Votes,0,0,0,0
Comal,101,Proposition 10,,REP,Yes,318,38,426,782
Comal,101,Proposition 10,,REP,No,29,1,45,75
Comal,101,Proposition 10,,REP,Cast Votes:,347,39,471,857
Comal,101,Proposition 10,,REP,Under Votes,12,0,22,34
Comal,101,Proposition 10,,REP,Over Votes,0,0,0,0
Comal,303,President,,REP,Zoltan G. Istvan,0,0,2,2
Comal,303,President,,REP,Bill Weld,1,0,0,1
Comal,303,President,,REP,"Roque ""Rocky"" De La Fuente Guerra",1,0,0,1
Comal,303,President,,REP,Matthew John Matern,0,0,0,0
Comal,303,President,,REP,Donald J. Trump,44,2,46,92
Comal,303,President,,REP,Joe Walsh,0,0,1,1
Comal,303,President,,REP,Bob Ely,0,0,0,0
Comal,303,President,,REP,Uncommitted,5,0,6,11
Comal,303,Ballots Cast,,REP,,51,2,55,108
Comal,303,President,,REP,Under Votes,0,0,0,0
Comal,303,President,,REP,Over Votes,0,0,0,0
Comal,303,U.S. Senate,,REP,John Anthony Castro,7,0,6,13
Comal,303,U.S. Senate,,REP,Virgil Bierschwale,0,0,0,0
Comal,303,U.S. Senate,,REP,John Cornyn,33,2,42,77
Comal,303,U.S. Senate,,REP,Mark Yancey,4,0,0,4
Comal,303,U.S. Senate,,REP,Dwayne Stovall,3,0,4,7
Comal,303,U.S. Senate,,REP,Cast Votes:,47,2,52,101
Comal,303,U.S. Senate,,REP,Under Votes,4,0,3,7
Comal,303,U.S. Senate,,REP,Over Votes,0,0,0,0
Comal,303,U.S. House,35,REP,Jenny Garcia Sharon,19,1,25,45
Comal,303,U.S. House,35,REP,Guillermo William Hayward,12,1,9,22
Comal,303,U.S. House,35,REP,Nick Moutos,10,0,13,23
Comal,303,U.S. House,35,REP,Cast Votes:,41,2,47,90
Comal,303,U.S. House,35,REP,Under Votes,10,0,8,18
Comal,303,U.S. House,35,REP,Over Votes,0,0,0,0
Comal,303,Railroad Commissioner,,REP,"James ""Jim"" Wright",29,2,26,57
Comal,303,Railroad Commissioner,,REP,Ryan Sitton,16,0,21,37
Comal,303,Railroad Commissioner,,REP,Cast Votes:,45,2,47,94
Comal,303,Railroad Commissioner,,REP,Under Votes,6,0,8,14
Comal,303,Railroad Commissioner,,REP,Over Votes,0,0,0,0
Comal,303,"Chief Justice, Supreme Court",,REP,Nathan Hecht,43,2,44,89
Comal,303,"Chief Justice, Supreme Court",,REP,Cast Votes:,43,2,44,89
Comal,303,"Chief Justice, Supreme Court",,REP,Under Votes,8,0,11,19
Comal,303,"Chief Justice, Supreme Court",,REP,Over Votes,0,0,0,0
Comal,303,"Justice, Supreme Court, Place 6 Unexpired Term",,REP,Jane Bland,43,2,44,89
Comal,303,"Justice, Supreme Court, Place 6 Unexpired Term",,REP,Cast Votes:,43,2,44,89
Comal,303,"Justice, Supreme Court, Place 6 Unexpired Term",,REP,Under Votes,8,0,11,19
Comal,303,"Justice, Supreme Court, Place 6 Unexpired Term",,REP,Over Votes,0,0,0,0
Comal,303,"Justice, Supreme Court, Place 7",,REP,Jeff Boyd,42,1,45,88
Comal,303,"Justice, Supreme Court, Place 7",,REP,Cast Votes:,42,1,45,88
Comal,303,"Justice, Supreme Court, Place 7",,REP,Under Votes,9,1,10,20
Comal,303,"Justice, Supreme Court, Place 7",,REP,Over Votes,0,0,0,0
Comal,303,"Justice, Supreme Court, Place 8",,REP,Brett Busby,41,2,43,86
Comal,303,"Justice, Supreme Court, Place 8",,REP,Cast Votes:,41,2,43,86
Comal,303,"Justice, Supreme Court, Place 8",,REP,Under Votes,10,0,12,22
Comal,303,"Justice, Supreme Court, Place 8",,REP,Over Votes,0,0,0,0
Comal,303,"Judge, Court of Criminal Appeals, Place 3",,REP,Gina Parker,21,0,22,43
Comal,303,"Judge, Court of Criminal Appeals, Place 3",,REP,Bert Richardson,21,2,24,47
Comal,303,"Judge, Court of Criminal Appeals, Place 3",,REP,Cast Votes:,42,2,46,90
Comal,303,"Judge, Court of Criminal Appeals, Place 3",,REP,Under Votes,9,0,9,18
Comal,303,"Judge, Court of Criminal Appeals, Place 3",,REP,Over Votes,0,0,0,0
Comal,303,"Judge, Court of Criminal Appeals, Place 4",,REP,Kevin Patrick Yeary,42,2,43,87
Comal,303,"Judge, Court of Criminal Appeals, Place 4",,REP,Cast Votes:,42,2,43,87
Comal,303,"Judge, Court of Criminal Appeals, Place 4",,REP,Under Votes,9,0,12,21
Comal,303,"Judge, Court of Criminal Appeals, Place 4",,REP,Over Votes,0,0,0,0
Comal,303,"Judge, Court of Criminal Appeals, Place 9",,REP,David Newell,42,2,44,88
Comal,303,"Judge, Court of Criminal Appeals, Place 9",,REP,Cast Votes:,42,2,44,88
Comal,303,"Judge, Court of Criminal Appeals, Place 9",,REP,Under Votes,9,0,11,20
Comal,303,"Judge, Court of Criminal Appeals, Place 9",,REP,Over Votes,0,0,0,0
Comal,303,"Member, State Board of Education, District 5",,REP,Lani Popp,18,1,18,37
Comal,303,"Member, State Board of Education, District 5",,REP,Inga Cotton,5,1,8,14
Comal,303,"Member, State Board of Education, District 5",,REP,Robert Morrow,22,0,23,45
Comal,303,"Member, State Board of Education, District 5",,REP,Cast Votes:,45,2,49,96
Comal,303,"Member, State Board of Education, District 5",,REP,Under Votes,6,0,6,12
Comal,303,"Member, State Board of Education, District 5",,REP,Over Votes,0,0,0,0
Comal,303,State Representative,73,REP,Kyle Biedermann,44,2,45,91
Comal,303,State Representative,73,REP,Cast Votes:,44,2,45,91
Comal,303,State Representative,73,REP,Under Votes,7,0,10,17
Comal,303,State Representative,73,REP,Over Votes,0,0,0,0
Comal,303,"Chief Justice, 3rd Court of Appeals District",,REP,Jeff Rose,43,2,43,88
Comal,303,"Chief Justice, 3rd Court of Appeals District",,REP,Cast Votes:,43,2,43,88
Comal,303,"Chief Justice, 3rd Court of Appeals District",,REP,Under Votes,8,0,12,20
Comal,303,"Chief Justice, 3rd Court of Appeals District",,REP,Over Votes,0,0,0,0
Comal,303,"District Judge, 22nd Judicial District",,REP,R. Bruce Boyer,44,2,45,91
Comal,303,"District Judge, 22nd Judicial District",,REP,Cast Votes:,44,2,45,91
Comal,303,"District Judge, 22nd Judicial District",,REP,Under Votes,7,0,10,17
Comal,303,"District Judge, 22nd Judicial District",,REP,Over Votes,0,0,0,0
Comal,303,"District Judge, 433rd Judicial District",,REP,Dib Waldrip,33,2,41,76
Comal,303,"District Judge, 433rd Judicial District",,REP,Charlie Sullivan,13,0,12,25
Comal,303,"District Judge, 433rd Judicial District",,REP,Cast Votes:,46,2,53,101
Comal,303,"District Judge, 433rd Judicial District",,REP,Under Votes,5,0,2,7
Comal,303,"District Judge, 433rd Judicial District",,REP,Over Votes,0,0,0,0
Comal,303,"Judge, County Court at Law No. 2",,REP,"Charles A. Stephens, II",42,2,44,88
Comal,303,"Judge, County Court at Law No. 2",,REP,Cast Votes:,42,2,44,88
Comal,303,"Judge, County Court at Law No. 2",,REP,Under Votes,9,0,11,20
Comal,303,"Judge, County Court at Law No. 2",,REP,Over Votes,0,0,0,0
Comal,303,"Judge, County Court at Law No. 3",,REP,Deborah Linnartz Wigington,43,2,43,88
Comal,303,"Judge, County Court at Law No. 3",,REP,Cast Votes:,43,2,43,88
Comal,303,"Judge, County Court at Law No. 3",,REP,Under Votes,8,0,12,20
Comal,303,"Judge, County Court at Law No. 3",,REP,Over Votes,0,0,0,0
Comal,303,Sheriff,,REP,Mark Reynolds,44,2,43,89
Comal,303,Sheriff,,REP,Cast Votes:,44,2,43,89
Comal,303,Sheriff,,REP,Under Votes,7,0,12,19
Comal,303,Sheriff,,REP,Over Votes,0,0,0,0
Comal,303,County Tax Assessor-Collector,,REP,Kristen H. Hoyt,24,1,24,49
Comal,303,County Tax Assessor-Collector,,REP,Patrick Aten,24,1,29,54
Comal,303,County Tax Assessor-Collector,,REP,Cast Votes:,48,2,53,103
Comal,303,County Tax Assessor-Collector,,REP,Under Votes,3,0,2,5
Comal,303,County Tax Assessor-Collector,,REP,Over Votes,0,0,0,0
Comal,303,"County Commissioner, Precinct 3",,REP,Kevin Webb,41,2,44,87
Comal,303,"County Commissioner, Precinct 3",,REP,Cast Votes:,41,2,44,87
Comal,303,"County Commissioner, Precinct 3",,REP,Under Votes,10,0,11,21
Comal,303,"County Commissioner, Precinct 3",,REP,Over Votes,0,0,0,0
Comal,303,"Constable, Precinct No. 3",,REP,Craig Ackerman,27,2,28,57
Comal,303,"Constable, Precinct No. 3",,REP,Scott Head,20,0,19,39
Comal,303,"Constable, Precinct No. 3",,REP,Cast Votes:,47,2,47,96
Comal,303,"Constable, Precinct No. 3",,REP,Under Votes,4,0,8,12
Comal,303,"Constable, Precinct No. 3",,REP,Over Votes,0,0,0,0
Comal,303,County Chairman,,REP,Sue Piner,43,2,43,88
Comal,303,County Chairman,,REP,Cast Votes:,43,2,43,88
Comal,303,County Chairman,,REP,Under Votes,8,0,12,20
Comal,303,County Chairman,,REP,Over Votes,0,0,0,0
Comal,303,Proposition 1,,REP,Yes,42,2,49,93
Comal,303,Proposition 1,,REP,No,7,0,6,13
Comal,303,Proposition 1,,REP,Cast Votes:,49,2,55,106
Comal,303,Proposition 1,,REP,Under Votes,2,0,0,2
Comal,303,Proposition 1,,REP,Over Votes,0,0,0,0
Comal,303,Proposition 2,,REP,Yes,37,2,44,83
Comal,303,Proposition 2,,REP,No,13,0,10,23
Comal,303,Proposition 2,,REP,Cast Votes:,50,2,54,106
Comal,303,Proposition 2,,REP,Under Votes,1,0,1,2
Comal,303,Proposition 2,,REP,Over Votes,0,0,0,0
Comal,303,Proposition 3,,REP,Yes,44,2,52,98
Comal,303,Proposition 3,,REP,No,6,0,2,8
Comal,303,Proposition 3,,REP,Cast Votes:,50,2,54,106
Comal,303,Proposition 3,,REP,Under Votes,1,0,1,2
Comal,303,Proposition 3,,REP,Over Votes,0,0,0,0
Comal,303,Proposition 4,,REP,Yes,41,2,43,86
Comal,303,Proposition 4,,REP,No,9,0,9,18
Comal,303,Proposition 4,,REP,Cast Votes:,50,2,52,104
Comal,303,Proposition 4,,REP,Under Votes,1,0,3,4
Comal,303,Proposition 4,,REP,Over Votes,0,0,0,0
Comal,303,Proposition 5,,REP,Yes,43,1,47,91
Comal,303,Proposition 5,,REP,No,7,1,7,15
Comal,303,Proposition 5,,REP,Cast Votes:,50,2,54,106
Comal,303,Proposition 5,,REP,Under Votes,1,0,1,2
Comal,303,Proposition 5,,REP,Over Votes,0,0,0,0
Comal,303,Proposition 6,,REP,Yes,46,1,49,96
Comal,303,Proposition 6,,REP,No,3,1,5,9
Comal,303,Proposition 6,,REP,Cast Votes:,49,2,54,105
Comal,303,Proposition 6,,REP,Under Votes,2,0,1,3
Comal,303,Proposition 6,,REP,Over Votes,0,0,0,0
Comal,303,Proposition 7,,REP,Yes,50,2,50,102
Comal,303,Proposition 7,,REP,No,1,0,4,5
Comal,303,Proposition 7,,REP,Cast Votes:,51,2,54,107
Comal,303,Proposition 7,,REP,Under Votes,0,0,1,1
Comal,303,Proposition 7,,REP,Over Votes,0,0,0,0
Comal,303,Proposition 8,,REP,Yes,49,2,51,102
Comal,303,Proposition 8,,REP,No,0,0,3,3
Comal,303,Proposition 8,,REP,Cast Votes:,49,2,54,105
Comal,303,Proposition 8,,REP,Under Votes,2,0,1,3
Comal,303,Proposition 8,,REP,Over Votes,0,0,0,0
Comal,303,Proposition 9,,REP,Yes,49,2,49,100
Comal,303,Proposition 9,,REP,No,1,0,4,5
Comal,303,Proposition 9,,REP,Cast Votes:,50,2,53,105
Comal,303,Proposition 9,,REP,Under Votes,1,0,2,3
Comal,303,Proposition 9,,REP,Over Votes,0,0,0,0
Comal,303,Proposition 10,,REP,Yes,46,2,48,96
Comal,303,Proposition 10,,REP,No,2,0,3,5
Comal,303,Proposition 10,,REP,Cast Votes:,48,2,51,101
Comal,303,Proposition 10,,REP,Under Votes,3,0,4,7
Comal,303,Proposition 10,,REP,Over Votes,0,0,0,0
Comal,304,President,,REP,Zoltan G. Istvan,0,0,1,1
Comal,304,President,,REP,Bill Weld,1,0,1,2
Comal,304,President,,REP,"Roque ""Rocky"" De La Fuente Guerra",0,0,1,1
Comal,304,President,,REP,Matthew John Matern,0,0,0,0
Comal,304,President,,REP,Donald J. Trump,223,12,235,470
Comal,304,President,,REP,Joe Walsh,3,0,1,4
Comal,304,President,,REP,Bob Ely,1,0,0,1
Comal,304,President,,REP,Uncommitted,7,0,6,13
Comal,304,Ballots Cast,,REP,,235,12,245,492
Comal,304,President,,REP,Under Votes,1,0,1,2
Comal,304,President,,REP,Over Votes,0,0,0,0
Comal,304,U.S. Senate,,REP,John Anthony Castro,22,0,15,37
Comal,304,U.S. Senate,,REP,Virgil Bierschwale,2,0,2,4
Comal,304,U.S. Senate,,REP,John Cornyn,162,10,187,359
Comal,304,U.S. Senate,,REP,Mark Yancey,23,1,10,34
Comal,304,U.S. Senate,,REP,Dwayne Stovall,13,1,17,31
Comal,304,U.S. Senate,,REP,Cast Votes:,222,12,231,465
Comal,304,U.S. Senate,,REP,Under Votes,14,0,15,29
Comal,304,U.S. Senate,,REP,Over Votes,0,0,0,0
Comal,304,U.S. House,35,REP,Jenny Garcia Sharon,99,6,89,194
Comal,304,U.S. House,35,REP,Guillermo William Hayward,47,1,51,99
Comal,304,U.S. House,35,REP,Nick Moutos,50,4,58,112
Comal,304,U.S. House,35,REP,Cast Votes:,196,11,198,405
Comal,304,U.S. House,35,REP,Under Votes,40,1,48,89
Comal,304,U.S. House,35,REP,Over Votes,0,0,0,0
Comal,304,Railroad Commissioner,,REP,"James ""Jim"" Wright",147,6,127,280
Comal,304,Railroad Commissioner,,REP,Ryan Sitton,63,5,89,157
Comal,304,Railroad Commissioner,,REP,Cast Votes:,210,11,216,437
Comal,304,Railroad Commissioner,,REP,Under Votes,26,1,30,57
Comal,304,Railroad Commissioner,,REP,Over Votes,0,0,0,0
Comal,304,"Chief Justice, Supreme Court",,REP,Nathan Hecht,208,11,216,435
Comal,304,"Chief Justice, Supreme Court",,REP,Cast Votes:,208,11,216,435
Comal,304,"Chief Justice, Supreme Court",,REP,Under Votes,28,1,30,59
Comal,304,"Chief Justice, Supreme Court",,REP,Over Votes,0,0,0,0
Comal,304,"Justice, Supreme Court, Place 6 Unexpired Term",,REP,Jane Bland,204,11,218,433
Comal,304,"Justice, Supreme Court, Place 6 Unexpired Term",,REP,Cast Votes:,204,11,218,433
Comal,304,"Justice, Supreme Court, Place 6 Unexpired Term",,REP,Under Votes,32,1,28,61
Comal,304,"Justice, Supreme Court, Place 6 Unexpired Term",,REP,Over Votes,0,0,0,0
Comal,304,"Justice, Supreme Court, Place 7",,REP,Jeff Boyd,207,11,217,435
Comal,304,"Justice, Supreme Court, Place 7",,REP,Cast Votes:,207,11,217,435
Comal,304,"Justice, Supreme Court, Place 7",,REP,Under Votes,29,1,29,59
Comal,304,"Justice, Supreme Court, Place 7",,REP,Over Votes,0,0,0,0
Comal,304,"Justice, Supreme Court, Place 8",,REP,Brett Busby,208,11,214,433
Comal,304,"Justice, Supreme Court, Place 8",,REP,Cast Votes:,208,11,214,433
Comal,304,"Justice, Supreme Court, Place 8",,REP,Under Votes,28,1,32,61
Comal,304,"Justice, Supreme Court, Place 8",,REP,Over Votes,0,0,0,0
Comal,304,"Judge, Court of Criminal Appeals, Place 3",,REP,Gina Parker,95,2,101,198
Comal,304,"Judge, Court of Criminal Appeals, Place 3",,REP,Bert Richardson,111,9,106,226
Comal,304,"Judge, Court of Criminal Appeals, Place 3",,REP,Cast Votes:,206,11,207,424
Comal,304,"Judge, Court of Criminal Appeals, Place 3",,REP,Under Votes,30,1,39,70
Comal,304,"Judge, Court of Criminal Appeals, Place 3",,REP,Over Votes,0,0,0,0
Comal,304,"Judge, Court of Criminal Appeals, Place 4",,REP,Kevin Patrick Yeary,208,11,213,432
Comal,304,"Judge, Court of Criminal Appeals, Place 4",,REP,Cast Votes:,208,11,213,432
Comal,304,"Judge, Court of Criminal Appeals, Place 4",,REP,Under Votes,28,1,33,62
Comal,304,"Judge, Court of Criminal Appeals, Place 4",,REP,Over Votes,0,0,0,0
Comal,304,"Judge, Court of Criminal Appeals, Place 9",,REP,David Newell,210,11,214,435
Comal,304,"Judge, Court of Criminal Appeals, Place 9",,REP,Cast Votes:,210,11,214,435
Comal,304,"Judge, Court of Criminal Appeals, Place 9",,REP,Under Votes,26,1,32,59
Comal,304,"Judge, Court of Criminal Appeals, Place 9",,REP,Over Votes,0,0,0,0
Comal,304,"Member, State Board of Education, District 5",,REP,Lani Popp,65,5,92,162
Comal,304,"Member, State Board of Education, District 5",,REP,Inga Cotton,38,2,45,85
Comal,304,"Member, State Board of Education, District 5",,REP,Robert Morrow,100,4,75,179
Comal,304,"Member, State Board of Education, District 5",,REP,Cast Votes:,203,11,212,426
Comal,304,"Member, State Board of Education, District 5",,REP,Under Votes,33,1,34,68
Comal,304,"Member, State Board of Education, District 5",,REP,Over Votes,0,0,0,0
Comal,304,State Representative,73,REP,Kyle Biedermann,215,11,222,448
Comal,304,State Representative,73,REP,Cast Votes:,215,11,222,448
Comal,304,State Representative,73,REP,Under Votes,21,1,24,46
Comal,304,State Representative,73,REP,Over Votes,0,0,0,0
Comal,304,"Chief Justice, 3rd Court of Appeals District",,REP,Jeff Rose,211,10,211,432
Comal,304,"Chief Justice, 3rd Court of Appeals District",,REP,Cast Votes:,211,10,211,432
Comal,304,"Chief Justice, 3rd Court of Appeals District",,REP,Under Votes,25,2,35,62
Comal,304,"Chief Justice, 3rd Court of Appeals District",,REP,Over Votes,0,0,0,0
Comal,304,"District Judge, 22nd Judicial District",,REP,R. Bruce Boyer,218,11,216,445
Comal,304,"District Judge, 22nd Judicial District",,REP,Cast Votes:,218,11,216,445
Comal,304,"District Judge, 22nd Judicial District",,REP,Under Votes,18,1,30,49
Comal,304,"District Judge, 22nd Judicial District",,REP,Over Votes,0,0,0,0
Comal,304,"District Judge, 433rd Judicial District",,REP,Dib Waldrip,159,7,157,323
Comal,304,"District Judge, 433rd Judicial District",,REP,Charlie Sullivan,58,5,72,135
Comal,304,"District Judge, 433rd Judicial District",,REP,Cast Votes:,217,12,229,458
Comal,304,"District Judge, 433rd Judicial District",,REP,Under Votes,19,0,17,36
Comal,304,"District Judge, 433rd Judicial District",,REP,Over Votes,0,0,0,0
Comal,304,"Judge, County Court at Law No. 2",,REP,"Charles A. Stephens, II",218,11,214,443
Comal,304,"Judge, County Court at Law No. 2",,REP,Cast Votes:,218,11,214,443
Comal,304,"Judge, County Court at Law No. 2",,REP,Under Votes,18,1,32,51
Comal,304,"Judge, County Court at Law No. 2",,REP,Over Votes,0,0,0,0
Comal,304,"Judge, County Court at Law No. 3",,REP,Deborah Linnartz Wigington,210,11,216,437
Comal,304,"Judge, County Court at Law No. 3",,REP,Cast Votes:,210,11,216,437
Comal,304,"Judge, County Court at Law No. 3",,REP,Under Votes,26,1,30,57
Comal,304,"Judge, County Court at Law No. 3",,REP,Over Votes,0,0,0,0
Comal,304,Sheriff,,REP,Mark Reynolds,218,11,222,451
Comal,304,Sheriff,,REP,Cast Votes:,218,11,222,451
Comal,304,Sheriff,,REP,Under Votes,18,1,24,43
Comal,304,Sheriff,,REP,Over Votes,0,0,0,0
Comal,304,County Tax Assessor-Collector,,REP,Kristen H. Hoyt,138,9,125,272
Comal,304,County Tax Assessor-Collector,,REP,Patrick Aten,81,3,101,185
Comal,304,County Tax Assessor-Collector,,REP,Cast Votes:,219,12,226,457
Comal,304,County Tax Assessor-Collector,,REP,Under Votes,17,0,20,37
Comal,304,County Tax Assessor-Collector,,REP,Over Votes,0,0,0,0
Comal,304,"County Commissioner, Precinct 3",,REP,Kevin Webb,217,11,217,445
Comal,304,"County Commissioner, Precinct 3",,REP,Cast Votes:,217,11,217,445
Comal,304,"County Commissioner, Precinct 3",,REP,Under Votes,19,1,29,49
Comal,304,"County Commissioner, Precinct 3",,REP,Over Votes,0,0,0,0
Comal,304,"Constable, Precinct No. 3",,REP,Craig Ackerman,133,9,144,286
Comal,304,"Constable, Precinct No. 3",,REP,Scott Head,86,3,79,168
Comal,304,"Constable, Precinct No. 3",,REP,Cast Votes:,219,12,223,454
Comal,304,"Constable, Precinct No. 3",,REP,Under Votes,17,0,23,40
Comal,304,"Constable, Precinct No. 3",,REP,Over Votes,0,0,0,0
Comal,304,County Chairman,,REP,Sue Piner,207,10,216,433
Comal,304,County Chairman,,REP,Cast Votes:,207,10,216,433
Comal,304,County Chairman,,REP,Under Votes,29,2,30,61
Comal,304,County Chairman,,REP,Over Votes,0,0,0,0
Comal,304,Proposition 1,,REP,Yes,211,12,211,434
Comal,304,Proposition 1,,REP,No,20,0,28,48
Comal,304,Proposition 1,,REP,Cast Votes:,231,12,239,482
Comal,304,Proposition 1,,REP,Under Votes,5,0,7,12
Comal,304,Proposition 1,,REP,Over Votes,0,0,0,0
Comal,304,Proposition 2,,REP,Yes,203,11,206,420
Comal,304,Proposition 2,,REP,No,28,1,36,65
Comal,304,Proposition 2,,REP,Cast Votes:,231,12,242,485
Comal,304,Proposition 2,,REP,Under Votes,5,0,4,9
Comal,304,Proposition 2,,REP,Over Votes,0,0,0,0
Comal,304,Proposition 3,,REP,Yes,219,12,226,457
Comal,304,Proposition 3,,REP,No,12,0,14,26
Comal,304,Proposition 3,,REP,Cast Votes:,231,12,240,483
Comal,304,Proposition 3,,REP,Under Votes,5,0,6,11
Comal,304,Proposition 3,,REP,Over Votes,0,0,0,0
Comal,304,Proposition 4,,REP,Yes,214,11,228,453
Comal,304,Proposition 4,,REP,No,16,1,14,31
Comal,304,Proposition 4,,REP,Cast Votes:,230,12,242,484
Comal,304,Proposition 4,,REP,Under Votes,6,0,4,10
Comal,304,Proposition 4,,REP,Over Votes,0,0,0,0
Comal,304,Proposition 5,,REP,Yes,213,11,223,447
Comal,304,Proposition 5,,REP,No,16,1,20,37
Comal,304,Proposition 5,,REP,Cast Votes:,229,12,243,484
Comal,304,Proposition 5,,REP,Under Votes,7,0,3,10
Comal,304,Proposition 5,,REP,Over Votes,0,0,0,0
Comal,304,Proposition 6,,REP,Yes,225,11,232,468
Comal,304,Proposition 6,,REP,No,7,1,8,16
Comal,304,Proposition 6,,REP,Cast Votes:,232,12,240,484
Comal,304,Proposition 6,,REP,Under Votes,4,0,6,10
Comal,304,Proposition 6,,REP,Over Votes,0,0,0,0
Comal,304,Proposition 7,,REP,Yes,228,12,235,475
Comal,304,Proposition 7,,REP,No,4,0,6,10
Comal,304,Proposition 7,,REP,Cast Votes:,232,12,241,485
Comal,304,Proposition 7,,REP,Under Votes,4,0,5,9
Comal,304,Proposition 7,,REP,Over Votes,0,0,0,0
Comal,304,Proposition 8,,REP,Yes,227,12,240,479
Comal,304,Proposition 8,,REP,No,4,0,2,6
Comal,304,Proposition 8,,REP,Cast Votes:,231,12,242,485
Comal,304,Proposition 8,,REP,Under Votes,5,0,4,9
Comal,304,Proposition 8,,REP,Over Votes,0,0,0,0
Comal,304,Proposition 9,,REP,Yes,224,12,226,462
Comal,304,Proposition 9,,REP,No,7,0,13,20
Comal,304,Proposition 9,,REP,Cast Votes:,231,12,239,482
Comal,304,Proposition 9,,REP,Under Votes,5,0,7,12
Comal,304,Proposition 9,,REP,Over Votes,0,0,0,0
Comal,304,Proposition 10,,REP,Yes,211,12,222,445
Comal,304,Proposition 10,,REP,No,18,0,20,38
Comal,304,Proposition 10,,REP,Cast Votes:,229,12,242,483
Comal,304,Proposition 10,,REP,Under Votes,7,0,4,11
Comal,304,Proposition 10,,REP,Over Votes,0,0,0,0
Comal,305,President,,REP,Zoltan G. Istvan,0,0,1,1
Comal,305,President,,REP,Bill Weld,3,0,4,7
Comal,305,President,,REP,"Roque ""Rocky"" De La Fuente Guerra",1,0,1,2
Comal,305,President,,REP,Matthew John Matern,0,0,0,0
Comal,305,President,,REP,Donald J. Trump,192,13,171,376
Comal,305,President,,REP,Joe Walsh,2,0,0,2
Comal,305,President,,REP,Bob Ely,0,0,0,0
Comal,305,President,,REP,Uncommitted,11,2,3,16
Comal,305,Ballots Cast,,REP,,209,15,180,404
Comal,305,President,,REP,Under Votes,1,0,0,1
Comal,305,President,,REP,Over Votes,0,0,0,0
Comal,305,U.S. Senate,,REP,John Anthony Castro,20,0,7,27
Comal,305,U.S. Senate,,REP,Virgil Bierschwale,2,1,3,6
Comal,305,U.S. Senate,,REP,John Cornyn,136,11,134,281
Comal,305,U.S. Senate,,REP,Mark Yancey,20,3,13,36
Comal,305,U.S. Senate,,REP,Dwayne Stovall,18,0,14,32
Comal,305,U.S. Senate,,REP,Cast Votes:,196,15,171,382
Comal,305,U.S. Senate,,REP,Under Votes,14,0,9,23
Comal,305,U.S. Senate,,REP,Over Votes,0,0,0,0
Comal,305,U.S. House,21,REP,Chip Roy,193,12,167,372
Comal,305,U.S. House,21,REP,Cast Votes:,193,12,167,372
Comal,305,U.S. House,21,REP,Under Votes,17,3,13,33
Comal,305,U.S. House,21,REP,Over Votes,0,0,0,0
Comal,305,Railroad Commissioner,,REP,"James ""Jim"" Wright",118,2,100,220
Comal,305,Railroad Commissioner,,REP,Ryan Sitton,60,10,64,134
Comal,305,Railroad Commissioner,,REP,Cast Votes:,178,12,164,354
Comal,305,Railroad Commissioner,,REP,Under Votes,32,3,16,51
Comal,305,Railroad Commissioner,,REP,Over Votes,0,0,0,0
Comal,305,"Chief Justice, Supreme Court",,REP,Nathan Hecht,185,12,162,359
Comal,305,"Chief Justice, Supreme Court",,REP,Cast Votes:,185,12,162,359
Comal,305,"Chief Justice, Supreme Court",,REP,Under Votes,25,3,18,46
Comal,305,"Chief Justice, Supreme Court",,REP,Over Votes,0,0,0,0
Comal,305,"Justice, Supreme Court, Place 6 Unexpired Term",,REP,Jane Bland,185,11,160,356
Comal,305,"Justice, Supreme Court, Place 6 Unexpired Term",,REP,Cast Votes:,185,11,160,356
Comal,305,"Justice, Supreme Court, Place 6 Unexpired Term",,REP,Under Votes,25,4,20,49
Comal,305,"Justice, Supreme Court, Place 6 Unexpired Term",,REP,Over Votes,0,0,0,0
Comal,305,"Justice, Supreme Court, Place 7",,REP,Jeff Boyd,182,13,160,355
Comal,305,"Justice, Supreme Court, Place 7",,REP,Cast Votes:,182,13,160,355
Comal,305,"Justice, Supreme Court, Place 7",,REP,Under Votes,28,2,20,50
Comal,305,"Justice, Supreme Court, Place 7",,REP,Over Votes,0,0,0,0
Comal,305,"Justice, Supreme Court, Place 8",,REP,Brett Busby,180,13,161,354
Comal,305,"Justice, Supreme Court, Place 8",,REP,Cast Votes:,180,13,161,354
Comal,305,"Justice, Supreme Court, Place 8",,REP,Under Votes,30,2,19,51
Comal,305,"Justice, Supreme Court, Place 8",,REP,Over Votes,0,0,0,0
Comal,305,"Judge, Court of Criminal Appeals, Place 3",,REP,Gina Parker,83,3,79,165
Comal,305,"Judge, Court of Criminal Appeals, Place 3",,REP,Bert Richardson,92,9,82,183
Comal,305,"Judge, Court of Criminal Appeals, Place 3",,REP,Cast Votes:,175,12,161,348
Comal,305,"Judge, Court of Criminal Appeals, Place 3",,REP,Under Votes,35,3,19,57
Comal,305,"Judge, Court of Criminal Appeals, Place 3",,REP,Over Votes,0,0,0,0
Comal,305,"Judge, Court of Criminal Appeals, Place 4",,REP,Kevin Patrick Yeary,182,13,161,356
Comal,305,"Judge, Court of Criminal Appeals, Place 4",,REP,Cast Votes:,182,13,161,356
Comal,305,"Judge, Court of Criminal Appeals, Place 4",,REP,Under Votes,28,2,19,49
Comal,305,"Judge, Court of Criminal Appeals, Place 4",,REP,Over Votes,0,0,0,0
Comal,305,"Judge, Court of Criminal Appeals, Place 9",,REP,David Newell,179,13,160,352
Comal,305,"Judge, Court of Criminal Appeals, Place 9",,REP,Cast Votes:,179,13,160,352
Comal,305,"Judge, Court of Criminal Appeals, Place 9",,REP,Under Votes,31,2,20,53
Comal,305,"Judge, Court of Criminal Appeals, Place 9",,REP,Over Votes,0,0,0,0
Comal,305,"Member, State Board of Education, District 5",,REP,Lani Popp,67,6,69,142
Comal,305,"Member, State Board of Education, District 5",,REP,Inga Cotton,35,1,25,61
Comal,305,"Member, State Board of Education, District 5",,REP,Robert Morrow,74,5,63,142
Comal,305,"Member, State Board of Education, District 5",,REP,Cast Votes:,176,12,157,345
Comal,305,"Member, State Board of Education, District 5",,REP,Under Votes,34,3,23,60
Comal,305,"Member, State Board of Education, District 5",,REP,Over Votes,0,0,0,0
Comal,305,State Representative,73,REP,Kyle Biedermann,179,13,164,356
Comal,305,State Representative,73,REP,Cast Votes:,179,13,164,356
Comal,305,State Representative,73,REP,Under Votes,31,2,16,49
Comal,305,State Representative,73,REP,Over Votes,0,0,0,0
Comal,305,"Chief Justice, 3rd Court of Appeals District",,REP,Jeff Rose,183,12,159,354
Comal,305,"Chief Justice, 3rd Court of Appeals District",,REP,Cast Votes:,183,12,159,354
Comal,305,"Chief Justice, 3rd Court of Appeals District",,REP,Under Votes,27,3,21,51
Comal,305,"Chief Justice, 3rd Court of Appeals District",,REP,Over Votes,0,0,0,0
Comal,305,"District Judge, 22nd Judicial District",,REP,R. Bruce Boyer,181,13,160,354
Comal,305,"District Judge, 22nd Judicial District",,REP,Cast Votes:,181,13,160,354
Comal,305,"District Judge, 22nd Judicial District",,REP,Under Votes,29,2,20,51
Comal,305,"District Judge, 22nd Judicial District",,REP,Over Votes,0,0,0,0
Comal,305,"District Judge, 433rd Judicial District",,REP,Dib Waldrip,115,12,106,233
Comal,305,"District Judge, 433rd Judicial District",,REP,Charlie Sullivan,70,2,57,129
Comal,305,"District Judge, 433rd Judicial District",,REP,Cast Votes:,185,14,163,362
Comal,305,"District Judge, 433rd Judicial District",,REP,Under Votes,25,1,17,43
Comal,305,"District Judge, 433rd Judicial District",,REP,Over Votes,0,0,0,0
Comal,305,"Judge, County Court at Law No. 2",,REP,"Charles A. Stephens, II",178,11,157,346
Comal,305,"Judge, County Court at Law No. 2",,REP,Cast Votes:,178,11,157,346
Comal,305,"Judge, County Court at Law No. 2",,REP,Under Votes,32,4,23,59
Comal,305,"Judge, County Court at Law No. 2",,REP,Over Votes,0,0,0,0
Comal,305,"Judge, County Court at Law No. 3",,REP,Deborah Linnartz Wigington,176,11,158,345
Comal,305,"Judge, County Court at Law No. 3",,REP,Cast Votes:,176,11,158,345
Comal,305,"Judge, County Court at Law No. 3",,REP,Under Votes,34,4,22,60
Comal,305,"Judge, County Court at Law No. 3",,REP,Over Votes,0,0,0,0
Comal,305,Sheriff,,REP,Mark Reynolds,182,13,166,361
Comal,305,Sheriff,,REP,Cast Votes:,182,13,166,361
Comal,305,Sheriff,,REP,Under Votes,28,2,14,44
Comal,305,Sheriff,,REP,Over Votes,0,0,0,0
Comal,305,County Tax Assessor-Collector,,REP,Kristen H. Hoyt,132,7,105,244
Comal,305,County Tax Assessor-Collector,,REP,Patrick Aten,58,6,64,128
Comal,305,County Tax Assessor-Collector,,REP,Cast Votes:,190,13,169,372
Comal,305,County Tax Assessor-Collector,,REP,Under Votes,20,2,11,33
Comal,305,County Tax Assessor-Collector,,REP,Over Votes,0,0,0,0
Comal,305,"County Commissioner, Precinct 3",,REP,Kevin Webb,175,13,160,348
Comal,305,"County Commissioner, Precinct 3",,REP,Cast Votes:,175,13,160,348
Comal,305,"County Commissioner, Precinct 3",,REP,Under Votes,35,2,20,57
Comal,305,"County Commissioner, Precinct 3",,REP,Over Votes,0,0,0,0
Comal,305,"Constable, Precinct No. 3",,REP,Craig Ackerman,76,8,84,168
Comal,305,"Constable, Precinct No. 3",,REP,Scott Head,109,6,85,200
Comal,305,"Constable, Precinct No. 3",,REP,Cast Votes:,185,14,169,368
Comal,305,"Constable, Precinct No. 3",,REP,Under Votes,25,1,11,37
Comal,305,"Constable, Precinct No. 3",,REP,Over Votes,0,0,0,0
Comal,305,County Chairman,,REP,Sue Piner,175,11,155,341
Comal,305,County Chairman,,REP,Cast Votes:,175,11,155,341
Comal,305,County Chairman,,REP,Under Votes,35,4,25,64
Comal,305,County Chairman,,REP,Over Votes,0,0,0,0
Comal,305,Proposition 1,,REP,Yes,187,13,160,360
Comal,305,Proposition 1,,REP,No,20,2,18,40
Comal,305,Proposition 1,,REP,Cast Votes:,207,15,178,400
Comal,305,Proposition 1,,REP,Under Votes,3,0,2,5
Comal,305,Proposition 1,,REP,Over Votes,0,0,0,0
Comal,305,Proposition 2,,REP,Yes,188,12,150,350
Comal,305,Proposition 2,,REP,No,20,3,29,52
Comal,305,Proposition 2,,REP,Cast Votes:,208,15,179,402
Comal,305,Proposition 2,,REP,Under Votes,2,0,1,3
Comal,305,Proposition 2,,REP,Over Votes,0,0,0,0
Comal,305,Proposition 3,,REP,Yes,194,15,170,379
Comal,305,Proposition 3,,REP,No,11,0,9,20
Comal,305,Proposition 3,,REP,Cast Votes:,205,15,179,399
Comal,305,Proposition 3,,REP,Under Votes,5,0,1,6
Comal,305,Proposition 3,,REP,Over Votes,0,0,0,0
Comal,305,Proposition 4,,REP,Yes,192,13,173,378
Comal,305,Proposition 4,,REP,No,15,2,6,23
Comal,305,Proposition 4,,REP,Cast Votes:,207,15,179,401
Comal,305,Proposition 4,,REP,Under Votes,3,0,1,4
Comal,305,Proposition 4,,REP,Over Votes,0,0,0,0
Comal,305,Proposition 5,,REP,Yes,188,11,165,364
Comal,305,Proposition 5,,REP,No,18,2,13,33
Comal,305,Proposition 5,,REP,Cast Votes:,206,13,178,397
Comal,305,Proposition 5,,REP,Under Votes,4,2,2,8
Comal,305,Proposition 5,,REP,Over Votes,0,0,0,0
Comal,305,Proposition 6,,REP,Yes,193,15,174,382
Comal,305,Proposition 6,,REP,No,12,0,5,17
Comal,305,Proposition 6,,REP,Cast Votes:,205,15,179,399
Comal,305,Proposition 6,,REP,Under Votes,5,0,1,6
Comal,305,Proposition 6,,REP,Over Votes,0,0,0,0
Comal,305,Proposition 7,,REP,Yes,195,15,171,381
Comal,305,Proposition 7,,REP,No,7,0,6,13
Comal,305,Proposition 7,,REP,Cast Votes:,202,15,177,394
Comal,305,Proposition 7,,REP,Under Votes,8,0,3,11
Comal,305,Proposition 7,,REP,Over Votes,0,0,0,0
Comal,305,Proposition 8,,REP,Yes,203,15,173,391
Comal,305,Proposition 8,,REP,No,3,0,3,6
Comal,305,Proposition 8,,REP,Cast Votes:,206,15,176,397
Comal,305,Proposition 8,,REP,Under Votes,4,0,4,8
Comal,305,Proposition 8,,REP,Over Votes,0,0,0,0
Comal,305,Proposition 9,,REP,Yes,193,15,167,375
Comal,305,Proposition 9,,REP,No,10,0,11,21
Comal,305,Proposition 9,,REP,Cast Votes:,203,15,178,396
Comal,305,Proposition 9,,REP,Under Votes,7,0,2,9
Comal,305,Proposition 9,,REP,Over Votes,0,0,0,0
Comal,305,Proposition 10,,REP,Yes,190,13,164,367
Comal,305,Proposition 10,,REP,No,15,2,10,27
Comal,305,Proposition 10,,REP,Cast Votes:,205,15,174,394
Comal,305,Proposition 10,,REP,Under Votes,5,0,6,11
Comal,305,Proposition 10,,REP,Over Votes,0,0,0,0
Comal,306,President,,REP,Zoltan G. Istvan,0,0,0,0
Comal,306,President,,REP,Bill Weld,1,0,1,2
Comal,306,President,,REP,"Roque ""Rocky"" De La Fuente Guerra",0,0,2,2
Comal,306,President,,REP,Matthew John Matern,0,0,0,0
Comal,306,President,,REP,Donald J. Trump,90,3,101,194
Comal,306,President,,REP,Joe Walsh,1,0,1,2
Comal,306,President,,REP,Bob Ely,0,0,0,0
Comal,306,President,,REP,Uncommitted,6,0,2,8
Comal,306,Ballots Cast,,REP,,98,3,107,208
Comal,306,President,,REP,Under Votes,0,0,0,0
Comal,306,President,,REP,Over Votes,0,0,0,0
Comal,306,U.S. Senate,,REP,John Anthony Castro,10,0,10,20
Comal,306,U.S. Senate,,REP,Virgil Bierschwale,2,0,1,3
Comal,306,U.S. Senate,,REP,John Cornyn,61,3,76,140
Comal,306,U.S. Senate,,REP,Mark Yancey,12,0,4,16
Comal,306,U.S. Senate,,REP,Dwayne Stovall,4,0,10,14
Comal,306,U.S. Senate,,REP,Cast Votes:,89,3,101,193
Comal,306,U.S. Senate,,REP,Under Votes,9,0,6,15
Comal,306,U.S. Senate,,REP,Over Votes,0,0,0,0
Comal,306,U.S. House,35,REP,Jenny Garcia Sharon,43,0,42,85
Comal,306,U.S. House,35,REP,Guillermo William Hayward,25,0,25,50
Comal,306,U.S. House,35,REP,Nick Moutos,18,2,22,42
Comal,306,U.S. House,35,REP,Cast Votes:,86,2,89,177
Comal,306,U.S. House,35,REP,Under Votes,12,1,18,31
Comal,306,U.S. House,35,REP,Over Votes,0,0,0,0
Comal,306,Railroad Commissioner,,REP,"James ""Jim"" Wright",47,0,63,110
Comal,306,Railroad Commissioner,,REP,Ryan Sitton,40,2,29,71
Comal,306,Railroad Commissioner,,REP,Cast Votes:,87,2,92,181
Comal,306,Railroad Commissioner,,REP,Under Votes,11,1,15,27
Comal,306,Railroad Commissioner,,REP,Over Votes,0,0,0,0
Comal,306,"Chief Justice, Supreme Court",,REP,Nathan Hecht,90,2,89,181
Comal,306,"Chief Justice, Supreme Court",,REP,Cast Votes:,90,2,89,181
Comal,306,"Chief Justice, Supreme Court",,REP,Under Votes,8,1,18,27
Comal,306,"Chief Justice, Supreme Court",,REP,Over Votes,0,0,0,0
Comal,306,"Justice, Supreme Court, Place 6 Unexpired Term",,REP,Jane Bland,88,2,88,178
Comal,306,"Justice, Supreme Court, Place 6 Unexpired Term",,REP,Cast Votes:,88,2,88,178
Comal,306,"Justice, Supreme Court, Place 6 Unexpired Term",,REP,Under Votes,10,1,19,30
Comal,306,"Justice, Supreme Court, Place 6 Unexpired Term",,REP,Over Votes,0,0,0,0
Comal,306,"Justice, Supreme Court, Place 7",,REP,Jeff Boyd,89,2,88,179
Comal,306,"Justice, Supreme Court, Place 7",,REP,Cast Votes:,89,2,88,179
Comal,306,"Justice, Supreme Court, Place 7",,REP,Under Votes,9,1,19,29
Comal,306,"Justice, Supreme Court, Place 7",,REP,Over Votes,0,0,0,0
Comal,306,"Justice, Supreme Court, Place 8",,REP,Brett Busby,90,2,86,178
Comal,306,"Justice, Supreme Court, Place 8",,REP,Cast Votes:,90,2,86,178
Comal,306,"Justice, Supreme Court, Place 8",,REP,Under Votes,8,1,21,30
Comal,306,"Justice, Supreme Court, Place 8",,REP,Over Votes,0,0,0,0
Comal,306,"Judge, Court of Criminal Appeals, Place 3",,REP,Gina Parker,45,0,30,75
Comal,306,"Judge, Court of Criminal Appeals, Place 3",,REP,Bert Richardson,42,2,59,103
Comal,306,"Judge, Court of Criminal Appeals, Place 3",,REP,Cast Votes:,87,2,89,178
Comal,306,"Judge, Court of Criminal Appeals, Place 3",,REP,Under Votes,11,1,18,30
Comal,306,"Judge, Court of Criminal Appeals, Place 3",,REP,Over Votes,0,0,0,0
Comal,306,"Judge, Court of Criminal Appeals, Place 4",,REP,Kevin Patrick Yeary,89,2,84,175
Comal,306,"Judge, Court of Criminal Appeals, Place 4",,REP,Cast Votes:,89,2,84,175
Comal,306,"Judge, Court of Criminal Appeals, Place 4",,REP,Under Votes,9,1,23,33
Comal,306,"Judge, Court of Criminal Appeals, Place 4",,REP,Over Votes,0,0,0,0
Comal,306,"Judge, Court of Criminal Appeals, Place 9",,REP,David Newell,87,2,85,174
Comal,306,"Judge, Court of Criminal Appeals, Place 9",,REP,Cast Votes:,87,2,85,174
Comal,306,"Judge, Court of Criminal Appeals, Place 9",,REP,Under Votes,11,1,22,34
Comal,306,"Judge, Court of Criminal Appeals, Place 9",,REP,Over Votes,0,0,0,0
Comal,306,"Member, State Board of Education, District 5",,REP,Lani Popp,31,0,30,61
Comal,306,"Member, State Board of Education, District 5",,REP,Inga Cotton,26,2,19,47
Comal,306,"Member, State Board of Education, District 5",,REP,Robert Morrow,30,0,42,72
Comal,306,"Member, State Board of Education, District 5",,REP,Cast Votes:,87,2,91,180
Comal,306,"Member, State Board of Education, District 5",,REP,Under Votes,11,1,16,28
Comal,306,"Member, State Board of Education, District 5",,REP,Over Votes,0,0,0,0
Comal,306,State Representative,73,REP,Kyle Biedermann,90,2,86,178
Comal,306,State Representative,73,REP,Cast Votes:,90,2,86,178
Comal,306,State Representative,73,REP,Under Votes,8,1,21,30
Comal,306,State Representative,73,REP,Over Votes,0,0,0,0
Comal,306,"Chief Justice, 3rd Court of Appeals District",,REP,Jeff Rose,87,2,86,175
Comal,306,"Chief Justice, 3rd Court of Appeals District",,REP,Cast Votes:,87,2,86,175
Comal,306,"Chief Justice, 3rd Court of Appeals District",,REP,Under Votes,11,1,21,33
Comal,306,"Chief Justice, 3rd Court of Appeals District",,REP,Over Votes,0,0,0,0
Comal,306,"District Judge, 22nd Judicial District",,REP,R. Bruce Boyer,89,2,86,177
Comal,306,"District Judge, 22nd Judicial District",,REP,Cast Votes:,89,2,86,177
Comal,306,"District Judge, 22nd Judicial District",,REP,Under Votes,9,1,21,31
Comal,306,"District Judge, 22nd Judicial District",,REP,Over Votes,0,0,0,0
Comal,306,"District Judge, 433rd Judicial District",,REP,Dib Waldrip,61,2,64,127
Comal,306,"District Judge, 433rd Judicial District",,REP,Charlie Sullivan,29,0,30,59
Comal,306,"District Judge, 433rd Judicial District",,REP,Cast Votes:,90,2,94,186
Comal,306,"District Judge, 433rd Judicial District",,REP,Under Votes,8,1,13,22
Comal,306,"District Judge, 433rd Judicial District",,REP,Over Votes,0,0,0,0
Comal,306,"Judge, County Court at Law No. 2",,REP,"Charles A. Stephens, II",86,2,85,173
Comal,306,"Judge, County Court at Law No. 2",,REP,Cast Votes:,86,2,85,173
Comal,306,"Judge, County Court at Law No. 2",,REP,Under Votes,12,1,22,35
Comal,306,"Judge, County Court at Law No. 2",,REP,Over Votes,0,0,0,0
Comal,306,"Judge, County Court at Law No. 3",,REP,Deborah Linnartz Wigington,90,2,84,176
Comal,306,"Judge, County Court at Law No. 3",,REP,Cast Votes:,90,2,84,176
Comal,306,"Judge, County Court at Law No. 3",,REP,Under Votes,8,1,23,32
Comal,306,"Judge, County Court at Law No. 3",,REP,Over Votes,0,0,0,0
Comal,306,Sheriff,,REP,Mark Reynolds,93,2,88,183
Comal,306,Sheriff,,REP,Cast Votes:,93,2,88,183
Comal,306,Sheriff,,REP,Under Votes,5,1,19,25
Comal,306,Sheriff,,REP,Over Votes,0,0,0,0
Comal,306,County Tax Assessor-Collector,,REP,Kristen H. Hoyt,58,2,44,104
Comal,306,County Tax Assessor-Collector,,REP,Patrick Aten,28,0,50,78
Comal,306,County Tax Assessor-Collector,,REP,Cast Votes:,86,2,94,182
Comal,306,County Tax Assessor-Collector,,REP,Under Votes,12,1,13,26
Comal,306,County Tax Assessor-Collector,,REP,Over Votes,0,0,0,0
Comal,306,"County Commissioner, Precinct 3",,REP,Kevin Webb,88,2,86,176
Comal,306,"County Commissioner, Precinct 3",,REP,Cast Votes:,88,2,86,176
Comal,306,"County Commissioner, Precinct 3",,REP,Under Votes,10,1,21,32
Comal,306,"County Commissioner, Precinct 3",,REP,Over Votes,0,0,0,0
Comal,306,"Constable, Precinct No. 3",,REP,Craig Ackerman,58,2,52,112
Comal,306,"Constable, Precinct No. 3",,REP,Scott Head,27,0,41,68
Comal,306,"Constable, Precinct No. 3",,REP,Cast Votes:,85,2,93,180
Comal,306,"Constable, Precinct No. 3",,REP,Under Votes,13,1,14,28
Comal,306,"Constable, Precinct No. 3",,REP,Over Votes,0,0,0,0
Comal,306,County Chairman,,REP,Sue Piner,86,2,83,171
Comal,306,County Chairman,,REP,Cast Votes:,86,2,83,171
Comal,306,County Chairman,,REP,Under Votes,12,1,24,37
Comal,306,County Chairman,,REP,Over Votes,0,0,0,0
Comal,306,Proposition 1,,REP,Yes,90,3,92,185
Comal,306,Proposition 1,,REP,No,5,0,14,19
Comal,306,Proposition 1,,REP,Cast Votes:,95,3,106,204
Comal,306,Proposition 1,,REP,Under Votes,3,0,1,4
Comal,306,Proposition 1,,REP,Over Votes,0,0,0,0
Comal,306,Proposition 2,,REP,Yes,88,3,87,178
Comal,306,Proposition 2,,REP,No,9,0,20,29
Comal,306,Proposition 2,,REP,Cast Votes:,97,3,107,207
Comal,306,Proposition 2,,REP,Under Votes,1,0,0,1
Comal,306,Proposition 2,,REP,Over Votes,0,0,0,0
Comal,306,Proposition 3,,REP,Yes,92,3,94,189
Comal,306,Proposition 3,,REP,No,3,0,9,12
Comal,306,Proposition 3,,REP,Cast Votes:,95,3,103,201
Comal,306,Proposition 3,,REP,Under Votes,3,0,4,7
Comal,306,Proposition 3,,REP,Over Votes,0,0,0,0
Comal,306,Proposition 4,,REP,Yes,89,3,95,187
Comal,306,Proposition 4,,REP,No,8,0,8,16
Comal,306,Proposition 4,,REP,Cast Votes:,97,3,103,203
Comal,306,Proposition 4,,REP,Under Votes,1,0,4,5
Comal,306,Proposition 4,,REP,Over Votes,0,0,0,0
Comal,306,Proposition 5,,REP,Yes,84,3,98,185
Comal,306,Proposition 5,,REP,No,11,0,5,16
Comal,306,Proposition 5,,REP,Cast Votes:,95,3,103,201
Comal,306,Proposition 5,,REP,Under Votes,3,0,4,7
Comal,306,Proposition 5,,REP,Over Votes,0,0,0,0
Comal,306,Proposition 6,,REP,Yes,94,3,96,193
Comal,306,Proposition 6,,REP,No,2,0,9,11
Comal,306,Proposition 6,,REP,Cast Votes:,96,3,105,204
Comal,306,Proposition 6,,REP,Under Votes,2,0,2,4
Comal,306,Proposition 6,,REP,Over Votes,0,0,0,0
Comal,306,Proposition 7,,REP,Yes,92,3,104,199
Comal,306,Proposition 7,,REP,No,3,0,3,6
Comal,306,Proposition 7,,REP,Cast Votes:,95,3,107,205
Comal,306,Proposition 7,,REP,Under Votes,3,0,0,3
Comal,306,Proposition 7,,REP,Over Votes,0,0,0,0
Comal,306,Proposition 8,,REP,Yes,95,3,106,204
Comal,306,Proposition 8,,REP,No,1,0,1,2
Comal,306,Proposition 8,,REP,Cast Votes:,96,3,107,206
Comal,306,Proposition 8,,REP,Under Votes,2,0,0,2
Comal,306,Proposition 8,,REP,Over Votes,0,0,0,0
Comal,306,Proposition 9,,REP,Yes,94,3,98,195
Comal,306,Proposition 9,,REP,No,2,0,7,9
Comal,306,Proposition 9,,REP,Cast Votes:,96,3,105,204
Comal,306,Proposition 9,,REP,Under Votes,2,0,2,4
Comal,306,Proposition 9,,REP,Over Votes,0,0,0,0
Comal,306,Proposition 10,,REP,Yes,94,3,97,194
Comal,306,Proposition 10,,REP,No,2,0,7,9
Comal,306,Proposition 10,,REP,Cast Votes:,96,3,104,203
Comal,306,Proposition 10,,REP,Under Votes,2,0,3,5
Comal,306,Proposition 10,,REP,Over Votes,0,0,0,0
Comal,401,President,,REP,Zoltan G. Istvan,0,0,1,1
Comal,401,President,,REP,Bill Weld,3,0,6,9
Comal,401,President,,REP,"Roque ""Rocky"" De La Fuente Guerra",0,0,3,3
Comal,401,President,,REP,Matthew John Matern,1,0,0,1
Comal,401,President,,REP,Donald J. Trump,210,21,264,495
Comal,401,President,,REP,Joe Walsh,1,0,0,1
Comal,401,President,,REP,Bob Ely,1,0,0,1
Comal,401,President,,REP,Uncommitted,19,2,23,44
Comal,401,Ballots Cast,,REP,,235,23,297,555
Comal,401,President,,REP,Under Votes,3,2,3,8
Comal,401,President,,REP,Over Votes,0,0,0,0
Comal,401,U.S. Senate,,REP,John Anthony Castro,5,0,7,12
Comal,401,U.S. Senate,,REP,Virgil Bierschwale,4,0,3,7
Comal,401,U.S. Senate,,REP,John Cornyn,192,22,251,465
Comal,401,U.S. Senate,,REP,Mark Yancey,5,0,10,15
Comal,401,U.S. Senate,,REP,Dwayne Stovall,14,0,15,29
Comal,401,U.S. Senate,,REP,Cast Votes:,220,22,286,528
Comal,401,U.S. Senate,,REP,Under Votes,18,3,14,35
Comal,401,U.S. Senate,,REP,Over Votes,0,0,0,0
Comal,401,U.S. House,21,REP,Chip Roy,220,21,267,508
Comal,401,U.S. House,21,REP,Cast Votes:,220,21,267,508
Comal,401,U.S. House,21,REP,Under Votes,18,4,33,55
Comal,401,U.S. House,21,REP,Over Votes,0,0,0,0
Comal,401,Railroad Commissioner,,REP,"James ""Jim"" Wright",108,9,121,238
Comal,401,Railroad Commissioner,,REP,Ryan Sitton,90,11,128,229
Comal,401,Railroad Commissioner,,REP,Cast Votes:,198,20,249,467
Comal,401,Railroad Commissioner,,REP,Under Votes,40,5,51,96
Comal,401,Railroad Commissioner,,REP,Over Votes,0,0,0,0
Comal,401,"Chief Justice, Supreme Court",,REP,Nathan Hecht,194,20,247,461
Comal,401,"Chief Justice, Supreme Court",,REP,Cast Votes:,194,20,247,461
Comal,401,"Chief Justice, Supreme Court",,REP,Under Votes,44,5,53,102
Comal,401,"Chief Justice, Supreme Court",,REP,Over Votes,0,0,0,0
Comal,401,"Justice, Supreme Court, Place 6 Unexpired Term",,REP,Jane Bland,193,20,238,451
Comal,401,"Justice, Supreme Court, Place 6 Unexpired Term",,REP,Cast Votes:,193,20,238,451
Comal,401,"Justice, Supreme Court, Place 6 Unexpired Term",,REP,Under Votes,45,5,62,112
Comal,401,"Justice, Supreme Court, Place 6 Unexpired Term",,REP,Over Votes,0,0,0,0
Comal,401,"Justice, Supreme Court, Place 7",,REP,Jeff Boyd,192,20,239,451
Comal,401,"Justice, Supreme Court, Place 7",,REP,Cast Votes:,192,20,239,451
Comal,401,"Justice, Supreme Court, Place 7",,REP,Under Votes,46,5,61,112
Comal,401,"Justice, Supreme Court, Place 7",,REP,Over Votes,0,0,0,0
Comal,401,"Justice, Supreme Court, Place 8",,REP,Brett Busby,186,20,236,442
Comal,401,"Justice, Supreme Court, Place 8",,REP,Cast Votes:,186,20,236,442
Comal,401,"Justice, Supreme Court, Place 8",,REP,Under Votes,52,5,64,121
Comal,401,"Justice, Supreme Court, Place 8",,REP,Over Votes,0,0,0,0
Comal,401,"Judge, Court of Criminal Appeals, Place 3",,REP,Gina Parker,80,9,101,190
Comal,401,"Judge, Court of Criminal Appeals, Place 3",,REP,Bert Richardson,118,12,136,266
Comal,401,"Judge, Court of Criminal Appeals, Place 3",,REP,Cast Votes:,198,21,237,456
Comal,401,"Judge, Court of Criminal Appeals, Place 3",,REP,Under Votes,40,4,63,107
Comal,401,"Judge, Court of Criminal Appeals, Place 3",,REP,Over Votes,0,0,0,0
Comal,401,"Judge, Court of Criminal Appeals, Place 4",,REP,Kevin Patrick Yeary,186,20,232,438
Comal,401,"Judge, Court of Criminal Appeals, Place 4",,REP,Cast Votes:,186,20,232,438
Comal,401,"Judge, Court of Criminal Appeals, Place 4",,REP,Under Votes,52,5,68,125
Comal,401,"Judge, Court of Criminal Appeals, Place 4",,REP,Over Votes,0,0,0,0
Comal,401,"Judge, Court of Criminal Appeals, Place 9",,REP,David Newell,190,20,233,443
Comal,401,"Judge, Court of Criminal Appeals, Place 9",,REP,Cast Votes:,190,20,233,443
Comal,401,"Judge, Court of Criminal Appeals, Place 9",,REP,Under Votes,48,5,67,120
Comal,401,"Judge, Court of Criminal Appeals, Place 9",,REP,Over Votes,0,0,0,0
Comal,401,"Member, State Board of Education, District 5",,REP,Lani Popp,67,8,132,207
Comal,401,"Member, State Board of Education, District 5",,REP,Inga Cotton,58,4,36,98
Comal,401,"Member, State Board of Education, District 5",,REP,Robert Morrow,61,5,61,127
Comal,401,"Member, State Board of Education, District 5",,REP,Cast Votes:,186,17,229,432
Comal,401,"Member, State Board of Education, District 5",,REP,Under Votes,52,8,71,131
Comal,401,"Member, State Board of Education, District 5",,REP,Over Votes,0,0,0,0
Comal,401,State Representative,73,REP,Kyle Biedermann,198,20,252,470
Comal,401,State Representative,73,REP,Cast Votes:,198,20,252,470
Comal,401,State Representative,73,REP,Under Votes,40,5,48,93
Comal,401,State Representative,73,REP,Over Votes,0,0,0,0
Comal,401,"Chief Justice, 3rd Court of Appeals District",,REP,Jeff Rose,190,20,235,445
Comal,401,"Chief Justice, 3rd Court of Appeals District",,REP,Cast Votes:,190,20,235,445
Comal,401,"Chief Justice, 3rd Court of Appeals District",,REP,Under Votes,48,5,65,118
Comal,401,"Chief Justice, 3rd Court of Appeals District",,REP,Over Votes,0,0,0,0
Comal,401,"District Judge, 22nd Judicial District",,REP,R. Bruce Boyer,199,22,254,475
Comal,401,"District Judge, 22nd Judicial District",,REP,Cast Votes:,199,22,254,475
Comal,401,"District Judge, 22nd Judicial District",,REP,Under Votes,39,3,46,88
Comal,401,"District Judge, 22nd Judicial District",,REP,Over Votes,0,0,0,0
Comal,401,"District Judge, 433rd Judicial District",,REP,Dib Waldrip,184,21,234,439
Comal,401,"District Judge, 433rd Judicial District",,REP,Charlie Sullivan,40,3,45,88
Comal,401,"District Judge, 433rd Judicial District",,REP,Cast Votes:,224,24,279,527
Comal,401,"District Judge, 433rd Judicial District",,REP,Under Votes,14,1,21,36
Comal,401,"District Judge, 433rd Judicial District",,REP,Over Votes,0,0,0,0
Comal,401,"Judge, County Court at Law No. 2",,REP,"Charles A. Stephens, II",195,22,247,464
Comal,401,"Judge, County Court at Law No. 2",,REP,Cast Votes:,195,22,247,464
Comal,401,"Judge, County Court at Law No. 2",,REP,Under Votes,43,3,53,99
Comal,401,"Judge, County Court at Law No. 2",,REP,Over Votes,0,0,0,0
Comal,401,"Judge, County Court at Law No. 3",,REP,Deborah Linnartz Wigington,199,21,234,454
Comal,401,"Judge, County Court at Law No. 3",,REP,Cast Votes:,199,21,234,454
Comal,401,"Judge, County Court at Law No. 3",,REP,Under Votes,39,4,66,109
Comal,401,"Judge, County Court at Law No. 3",,REP,Over Votes,0,0,0,0
Comal,401,Sheriff,,REP,Mark Reynolds,199,22,250,471
Comal,401,Sheriff,,REP,Cast Votes:,199,22,250,471
Comal,401,Sheriff,,REP,Under Votes,39,3,50,92
Comal,401,Sheriff,,REP,Over Votes,0,0,0,0
Comal,401,County Tax Assessor-Collector,,REP,Kristen H. Hoyt,92,7,86,185
Comal,401,County Tax Assessor-Collector,,REP,Patrick Aten,128,16,203,347
Comal,401,County Tax Assessor-Collector,,REP,Cast Votes:,220,23,289,532
Comal,401,County Tax Assessor-Collector,,REP,Under Votes,18,2,11,31
Comal,401,County Tax Assessor-Collector,,REP,Over Votes,0,0,0,0
Comal,401,"Constable, Precinct No. 4",,REP,Shane Rapp,156,18,172,346
Comal,401,"Constable, Precinct No. 4",,REP,Jerry Airola,50,5,92,147
Comal,401,"Constable, Precinct No. 4",,REP,Cast Votes:,206,23,264,493
Comal,401,"Constable, Precinct No. 4",,REP,Under Votes,32,2,36,70
Comal,401,"Constable, Precinct No. 4",,REP,Over Votes,0,0,0,0
Comal,401,County Chairman,,REP,Sue Piner,194,21,226,441
Comal,401,County Chairman,,REP,Cast Votes:,194,21,226,441
Comal,401,County Chairman,,REP,Under Votes,44,4,74,122
Comal,401,County Chairman,,REP,Over Votes,0,0,0,0
Comal,401,Proposition 1,,REP,Yes,208,24,267,499
Comal,401,Proposition 1,,REP,No,19,1,21,41
Comal,401,Proposition 1,,REP,Cast Votes:,227,25,288,540
Comal,401,Proposition 1,,REP,Under Votes,11,0,12,23
Comal,401,Proposition 1,,REP,Over Votes,0,0,0,0
Comal,401,Proposition 2,,REP,Yes,183,24,237,444
Comal,401,Proposition 2,,REP,No,41,1,50,92
Comal,401,Proposition 2,,REP,Cast Votes:,224,25,287,536
Comal,401,Proposition 2,,REP,Under Votes,14,0,13,27
Comal,401,Proposition 2,,REP,Over Votes,0,0,0,0
Comal,401,Proposition 3,,REP,Yes,209,23,274,506
Comal,401,Proposition 3,,REP,No,14,2,12,28
Comal,401,Proposition 3,,REP,Cast Votes:,223,25,286,534
Comal,401,Proposition 3,,REP,Under Votes,15,0,14,29
Comal,401,Proposition 3,,REP,Over Votes,0,0,0,0
Comal,401,Proposition 4,,REP,Yes,202,23,264,489
Comal,401,Proposition 4,,REP,No,22,2,27,51
Comal,401,Proposition 4,,REP,Cast Votes:,224,25,291,540
Comal,401,Proposition 4,,REP,Under Votes,14,0,9,23
Comal,401,Proposition 4,,REP,Over Votes,0,0,0,0
Comal,401,Proposition 5,,REP,Yes,191,20,252,463
Comal,401,Proposition 5,,REP,No,33,5,32,70
Comal,401,Proposition 5,,REP,Cast Votes:,224,25,284,533
Comal,401,Proposition 5,,REP,Under Votes,14,0,16,30
Comal,401,Proposition 5,,REP,Over Votes,0,0,0,0
Comal,401,Proposition 6,,REP,Yes,213,25,271,509
Comal,401,Proposition 6,,REP,No,10,0,14,24
Comal,401,Proposition 6,,REP,Cast Votes:,223,25,285,533
Comal,401,Proposition 6,,REP,Under Votes,15,0,15,30
Comal,401,Proposition 6,,REP,Over Votes,0,0,0,0
Comal,401,Proposition 7,,REP,Yes,212,25,261,498
Comal,401,Proposition 7,,REP,No,11,0,23,34
Comal,401,Proposition 7,,REP,Cast Votes:,223,25,284,532
Comal,401,Proposition 7,,REP,Under Votes,15,0,16,31
Comal,401,Proposition 7,,REP,Over Votes,0,0,0,0
Comal,401,Proposition 8,,REP,Yes,223,22,283,528
Comal,401,Proposition 8,,REP,No,2,2,9,13
Comal,401,Proposition 8,,REP,Cast Votes:,225,24,292,541
Comal,401,Proposition 8,,REP,Under Votes,13,1,8,22
Comal,401,Proposition 8,,REP,Over Votes,0,0,0,0
Comal,401,Proposition 9,,REP,Yes,215,25,261,501
Comal,401,Proposition 9,,REP,No,9,0,25,34
Comal,401,Proposition 9,,REP,Cast Votes:,224,25,286,535
Comal,401,Proposition 9,,REP,Under Votes,14,0,14,28
Comal,401,Proposition 9,,REP,Over Votes,0,0,0,0
Comal,401,Proposition 10,,REP,Yes,206,21,265,492
Comal,401,Proposition 10,,REP,No,16,4,23,43
Comal,401,Proposition 10,,REP,Cast Votes:,222,25,288,535
Comal,401,Proposition 10,,REP,Under Votes,16,0,12,28
Comal,401,Proposition 10,,REP,Over Votes,0,0,0,0
Comal,402,President,,REP,Zoltan G. Istvan,1,0,0,1
Comal,402,President,,REP,Bill Weld,2,0,9,11
Comal,402,President,,REP,"Roque ""Rocky"" De La Fuente Guerra",0,0,0,0
Comal,402,President,,REP,Matthew John Matern,0,0,0,0
Comal,402,President,,REP,Donald J. Trump,428,28,654,1110
Comal,402,President,,REP,Joe Walsh,0,0,3,3
Comal,402,President,,REP,Bob Ely,1,1,0,2
Comal,402,President,,REP,Uncommitted,18,2,15,35
Comal,402,Ballots Cast,,REP,,450,31,681,1162
Comal,402,President,,REP,Under Votes,2,0,2,4
Comal,402,President,,REP,Over Votes,0,0,0,0
Comal,402,U.S. Senate,,REP,John Anthony Castro,24,1,22,47
Comal,402,U.S. Senate,,REP,Virgil Bierschwale,10,0,9,19
Comal,402,U.S. Senate,,REP,John Cornyn,321,28,541,890
Comal,402,U.S. Senate,,REP,Mark Yancey,29,1,25,55
Comal,402,U.S. Senate,,REP,Dwayne Stovall,38,0,64,102
Comal,402,U.S. Senate,,REP,Cast Votes:,422,30,661,1113
Comal,402,U.S. Senate,,REP,Under Votes,30,1,22,53
Comal,402,U.S. Senate,,REP,Over Votes,0,0,0,0
Comal,402,U.S. House,21,REP,Chip Roy,415,26,638,1079
Comal,402,U.S. House,21,REP,Cast Votes:,415,26,638,1079
Comal,402,U.S. House,21,REP,Under Votes,37,5,45,87
Comal,402,U.S. House,21,REP,Over Votes,0,0,0,0
Comal,402,Railroad Commissioner,,REP,"James ""Jim"" Wright",248,14,351,613
Comal,402,Railroad Commissioner,,REP,Ryan Sitton,154,13,274,441
Comal,402,Railroad Commissioner,,REP,Cast Votes:,402,27,625,1054
Comal,402,Railroad Commissioner,,REP,Under Votes,50,4,58,112
Comal,402,Railroad Commissioner,,REP,Over Votes,0,0,0,0
Comal,402,"Chief Justice, Supreme Court",,REP,Nathan Hecht,397,25,614,1036
Comal,402,"Chief Justice, Supreme Court",,REP,Cast Votes:,397,25,614,1036
Comal,402,"Chief Justice, Supreme Court",,REP,Under Votes,55,6,69,130
Comal,402,"Chief Justice, Supreme Court",,REP,Over Votes,0,0,0,0
Comal,402,"Justice, Supreme Court, Place 6 Unexpired Term",,REP,Jane Bland,391,25,600,1016
Comal,402,"Justice, Supreme Court, Place 6 Unexpired Term",,REP,Cast Votes:,391,25,600,1016
Comal,402,"Justice, Supreme Court, Place 6 Unexpired Term",,REP,Under Votes,61,6,83,150
Comal,402,"Justice, Supreme Court, Place 6 Unexpired Term",,REP,Over Votes,0,0,0,0
Comal,402,"Justice, Supreme Court, Place 7",,REP,Jeff Boyd,397,25,599,1021
Comal,402,"Justice, Supreme Court, Place 7",,REP,Cast Votes:,397,25,599,1021
Comal,402,"Justice, Supreme Court, Place 7",,REP,Under Votes,55,6,84,145
Comal,402,"Justice, Supreme Court, Place 7",,REP,Over Votes,0,0,0,0
Comal,402,"Justice, Supreme Court, Place 8",,REP,Brett Busby,389,25,603,1017
Comal,402,"Justice, Supreme Court, Place 8",,REP,Cast Votes:,389,25,603,1017
Comal,402,"Justice, Supreme Court, Place 8",,REP,Under Votes,63,6,80,149
Comal,402,"Justice, Supreme Court, Place 8",,REP,Over Votes,0,0,0,0
Comal,402,"Judge, Court of Criminal Appeals, Place 3",,REP,Gina Parker,204,13,284,501
Comal,402,"Judge, Court of Criminal Appeals, Place 3",,REP,Bert Richardson,185,14,322,521
Comal,402,"Judge, Court of Criminal Appeals, Place 3",,REP,Cast Votes:,389,27,606,1022
Comal,402,"Judge, Court of Criminal Appeals, Place 3",,REP,Under Votes,63,4,77,144
Comal,402,"Judge, Court of Criminal Appeals, Place 3",,REP,Over Votes,0,0,0,0
Comal,402,"Judge, Court of Criminal Appeals, Place 4",,REP,Kevin Patrick Yeary,386,25,601,1012
Comal,402,"Judge, Court of Criminal Appeals, Place 4",,REP,Cast Votes:,386,25,601,1012
Comal,402,"Judge, Court of Criminal Appeals, Place 4",,REP,Under Votes,66,6,82,154
Comal,402,"Judge, Court of Criminal Appeals, Place 4",,REP,Over Votes,0,0,0,0
Comal,402,"Judge, Court of Criminal Appeals, Place 9",,REP,David Newell,385,24,595,1004
Comal,402,"Judge, Court of Criminal Appeals, Place 9",,REP,Cast Votes:,385,24,595,1004
Comal,402,"Judge, Court of Criminal Appeals, Place 9",,REP,Under Votes,67,7,88,162
Comal,402,"Judge, Court of Criminal Appeals, Place 9",,REP,Over Votes,0,0,0,0
Comal,402,"Member, State Board of Education, District 5",,REP,Lani Popp,110,6,233,349
Comal,402,"Member, State Board of Education, District 5",,REP,Inga Cotton,126,12,134,272
Comal,402,"Member, State Board of Education, District 5",,REP,Robert Morrow,153,8,237,398
Comal,402,"Member, State Board of Education, District 5",,REP,Cast Votes:,389,26,604,1019
Comal,402,"Member, State Board of Education, District 5",,REP,Under Votes,63,5,79,147
Comal,402,"Member, State Board of Education, District 5",,REP,Over Votes,0,0,0,0
Comal,402,State Representative,73,REP,Kyle Biedermann,396,26,621,1043
Comal,402,State Representative,73,REP,Cast Votes:,396,26,621,1043
Comal,402,State Representative,73,REP,Under Votes,56,5,62,123
Comal,402,State Representative,73,REP,Over Votes,0,0,0,0
Comal,402,"Chief Justice, 3rd Court of Appeals District",,REP,Jeff Rose,388,24,600,1012
Comal,402,"Chief Justice, 3rd Court of Appeals District",,REP,Cast Votes:,388,24,600,1012
Comal,402,"Chief Justice, 3rd Court of Appeals District",,REP,Under Votes,64,7,83,154
Comal,402,"Chief Justice, 3rd Court of Appeals District",,REP,Over Votes,0,0,0,0
Comal,402,"District Judge, 22nd Judicial District",,REP,R. Bruce Boyer,392,25,605,1022
Comal,402,"District Judge, 22nd Judicial District",,REP,Cast Votes:,392,25,605,1022
Comal,402,"District Judge, 22nd Judicial District",,REP,Under Votes,60,6,78,144
Comal,402,"District Judge, 22nd Judicial District",,REP,Over Votes,0,0,0,0
Comal,402,"District Judge, 433rd Judicial District",,REP,Dib Waldrip,260,24,443,727
Comal,402,"District Judge, 433rd Judicial District",,REP,Charlie Sullivan,148,5,203,356
Comal,402,"District Judge, 433rd Judicial District",,REP,Cast Votes:,408,29,646,1083
Comal,402,"District Judge, 433rd Judicial District",,REP,Under Votes,44,2,36,82
Comal,402,"District Judge, 433rd Judicial District",,REP,Over Votes,0,0,1,1
Comal,402,"Judge, County Court at Law No. 2",,REP,"Charles A. Stephens, II",388,25,605,1018
Comal,402,"Judge, County Court at Law No. 2",,REP,Cast Votes:,388,25,605,1018
Comal,402,"Judge, County Court at Law No. 2",,REP,Under Votes,64,6,78,148
Comal,402,"Judge, County Court at Law No. 2",,REP,Over Votes,0,0,0,0
Comal,402,"Judge, County Court at Law No. 3",,REP,Deborah Linnartz Wigington,384,25,600,1009
Comal,402,"Judge, County Court at Law No. 3",,REP,Cast Votes:,384,25,600,1009
Comal,402,"Judge, County Court at Law No. 3",,REP,Under Votes,68,6,83,157
Comal,402,"Judge, County Court at Law No. 3",,REP,Over Votes,0,0,0,0
Comal,402,Sheriff,,REP,Mark Reynolds,393,28,632,1053
Comal,402,Sheriff,,REP,Cast Votes:,393,28,632,1053
Comal,402,Sheriff,,REP,Under Votes,59,3,51,113
Comal,402,Sheriff,,REP,Over Votes,0,0,0,0
Comal,402,County Tax Assessor-Collector,,REP,Kristen H. Hoyt,282,17,367,666
Comal,402,County Tax Assessor-Collector,,REP,Patrick Aten,137,10,276,423
Comal,402,County Tax Assessor-Collector,,REP,Cast Votes:,419,27,643,1089
Comal,402,County Tax Assessor-Collector,,REP,Under Votes,33,4,39,76
Comal,402,County Tax Assessor-Collector,,REP,Over Votes,0,0,1,1
Comal,402,"Constable, Precinct No. 4",,REP,Shane Rapp,327,23,543,893
Comal,402,"Constable, Precinct No. 4",,REP,Jerry Airola,103,5,115,223
Comal,402,"Constable, Precinct No. 4",,REP,Cast Votes:,430,28,658,1116
Comal,402,"Constable, Precinct No. 4",,REP,Under Votes,22,3,24,49
Comal,402,"Constable, Precinct No. 4",,REP,Over Votes,0,0,1,1
Comal,402,County Chairman,,REP,Sue Piner,386,25,601,1012
Comal,402,County Chairman,,REP,Cast Votes:,386,25,601,1012
Comal,402,County Chairman,,REP,Under Votes,66,6,82,154
Comal,402,County Chairman,,REP,Over Votes,0,0,0,0
Comal,402,Proposition 1,,REP,Yes,398,30,611,1039
Comal,402,Proposition 1,,REP,No,46,1,57,104
Comal,402,Proposition 1,,REP,Cast Votes:,444,31,668,1143
Comal,402,Proposition 1,,REP,Under Votes,8,0,15,23
Comal,402,Proposition 1,,REP,Over Votes,0,0,0,0
Comal,402,Proposition 2,,REP,Yes,387,25,600,1012
Comal,402,Proposition 2,,REP,No,58,5,73,136
Comal,402,Proposition 2,,REP,Cast Votes:,445,30,673,1148
Comal,402,Proposition 2,,REP,Under Votes,7,1,10,18
Comal,402,Proposition 2,,REP,Over Votes,0,0,0,0
Comal,402,Proposition 3,,REP,Yes,424,29,645,1098
Comal,402,Proposition 3,,REP,No,20,2,24,46
Comal,402,Proposition 3,,REP,Cast Votes:,444,31,669,1144
Comal,402,Proposition 3,,REP,Under Votes,8,0,14,22
Comal,402,Proposition 3,,REP,Over Votes,0,0,0,0
Comal,402,Proposition 4,,REP,Yes,417,28,630,1075
Comal,402,Proposition 4,,REP,No,24,3,35,62
Comal,402,Proposition 4,,REP,Cast Votes:,441,31,665,1137
Comal,402,Proposition 4,,REP,Under Votes,11,0,18,29
Comal,402,Proposition 4,,REP,Over Votes,0,0,0,0
Comal,402,Proposition 5,,REP,Yes,406,24,608,1038
Comal,402,Proposition 5,,REP,No,31,6,53,90
Comal,402,Proposition 5,,REP,Cast Votes:,437,30,661,1128
Comal,402,Proposition 5,,REP,Under Votes,15,1,22,38
Comal,402,Proposition 5,,REP,Over Votes,0,0,0,0
Comal,402,Proposition 6,,REP,Yes,417,30,634,1081
Comal,402,Proposition 6,,REP,No,21,0,24,45
Comal,402,Proposition 6,,REP,Cast Votes:,438,30,658,1126
Comal,402,Proposition 6,,REP,Under Votes,14,1,25,40
Comal,402,Proposition 6,,REP,Over Votes,0,0,0,0
Comal,402,Proposition 7,,REP,Yes,438,30,638,1106
Comal,402,Proposition 7,,REP,No,7,1,23,31
Comal,402,Proposition 7,,REP,Cast Votes:,445,31,661,1137
Comal,402,Proposition 7,,REP,Under Votes,7,0,22,29
Comal,402,Proposition 7,,REP,Over Votes,0,0,0,0
Comal,402,Proposition 8,,REP,Yes,442,28,660,1130
Comal,402,Proposition 8,,REP,No,4,2,8,14
Comal,402,Proposition 8,,REP,Cast Votes:,446,30,668,1144
Comal,402,Proposition 8,,REP,Under Votes,6,1,15,22
Comal,402,Proposition 8,,REP,Over Votes,0,0,0,0
Comal,402,Proposition 9,,REP,Yes,410,30,644,1084
Comal,402,Proposition 9,,REP,No,31,0,23,54
Comal,402,Proposition 9,,REP,Cast Votes:,441,30,667,1138
Comal,402,Proposition 9,,REP,Under Votes,11,1,16,28
Comal,402,Proposition 9,,REP,Over Votes,0,0,0,0
Comal,402,Proposition 10,,REP,Yes,414,29,633,1076
Comal,402,Proposition 10,,REP,No,22,1,32,55
Comal,402,Proposition 10,,REP,Cast Votes:,436,30,665,1131
Comal,402,Proposition 10,,REP,Under Votes,16,1,18,35
Comal,402,Proposition 10,,REP,Over Votes,0,0,0,0
Comal,403,President,,REP,Zoltan G. Istvan,0,0,0,0
Comal,403,President,,REP,Bill Weld,0,0,5,5
Comal,403,President,,REP,"Roque ""Rocky"" De La Fuente Guerra",0,0,0,0
Comal,403,President,,REP,Matthew John Matern,1,1,2,4
Comal,403,President,,REP,Donald J. Trump,569,28,819,1416
Comal,403,President,,REP,Joe Walsh,0,0,3,3
Comal,403,President,,REP,Bob Ely,1,0,1,2
Comal,403,President,,REP,Uncommitted,17,0,16,33
Comal,403,Ballots Cast,,REP,,588,29,846,1463
Comal,403,President,,REP,Under Votes,1,0,3,4
Comal,403,President,,REP,Over Votes,0,0,0,0
Comal,403,U.S. Senate,,REP,John Anthony Castro,26,0,28,54
Comal,403,U.S. Senate,,REP,Virgil Bierschwale,5,1,3,9
Comal,403,U.S. Senate,,REP,John Cornyn,441,28,665,1134
Comal,403,U.S. Senate,,REP,Mark Yancey,21,0,30,51
Comal,403,U.S. Senate,,REP,Dwayne Stovall,58,0,93,151
Comal,403,U.S. Senate,,REP,Cast Votes:,551,29,819,1399
Comal,403,U.S. Senate,,REP,Under Votes,38,0,30,68
Comal,403,U.S. Senate,,REP,Over Votes,0,0,0,0
Comal,403,U.S. House,21,REP,Chip Roy,550,28,802,1380
Comal,403,U.S. House,21,REP,Cast Votes:,550,28,802,1380
Comal,403,U.S. House,21,REP,Under Votes,39,1,47,87
Comal,403,U.S. House,21,REP,Over Votes,0,0,0,0
Comal,403,Railroad Commissioner,,REP,"James ""Jim"" Wright",307,15,404,726
Comal,403,Railroad Commissioner,,REP,Ryan Sitton,224,12,375,611
Comal,403,Railroad Commissioner,,REP,Cast Votes:,531,27,779,1337
Comal,403,Railroad Commissioner,,REP,Under Votes,58,2,70,130
Comal,403,Railroad Commissioner,,REP,Over Votes,0,0,0,0
Comal,403,"Chief Justice, Supreme Court",,REP,Nathan Hecht,527,26,780,1333
Comal,403,"Chief Justice, Supreme Court",,REP,Cast Votes:,527,26,780,1333
Comal,403,"Chief Justice, Supreme Court",,REP,Under Votes,62,3,69,134
Comal,403,"Chief Justice, Supreme Court",,REP,Over Votes,0,0,0,0
Comal,403,"Justice, Supreme Court, Place 6 Unexpired Term",,REP,Jane Bland,519,26,776,1321
Comal,403,"Justice, Supreme Court, Place 6 Unexpired Term",,REP,Cast Votes:,519,26,776,1321
Comal,403,"Justice, Supreme Court, Place 6 Unexpired Term",,REP,Under Votes,70,3,73,146
Comal,403,"Justice, Supreme Court, Place 6 Unexpired Term",,REP,Over Votes,0,0,0,0
Comal,403,"Justice, Supreme Court, Place 7",,REP,Jeff Boyd,526,25,771,1322
Comal,403,"Justice, Supreme Court, Place 7",,REP,Cast Votes:,526,25,771,1322
Comal,403,"Justice, Supreme Court, Place 7",,REP,Under Votes,63,4,78,145
Comal,403,"Justice, Supreme Court, Place 7",,REP,Over Votes,0,0,0,0
Comal,403,"Justice, Supreme Court, Place 8",,REP,Brett Busby,520,26,771,1317
Comal,403,"Justice, Supreme Court, Place 8",,REP,Cast Votes:,520,26,771,1317
Comal,403,"Justice, Supreme Court, Place 8",,REP,Under Votes,69,3,78,150
Comal,403,"Justice, Supreme Court, Place 8",,REP,Over Votes,0,0,0,0
Comal,403,"Judge, Court of Criminal Appeals, Place 3",,REP,Gina Parker,266,13,399,678
Comal,403,"Judge, Court of Criminal Appeals, Place 3",,REP,Bert Richardson,252,14,366,632
Comal,403,"Judge, Court of Criminal Appeals, Place 3",,REP,Cast Votes:,518,27,765,1310
Comal,403,"Judge, Court of Criminal Appeals, Place 3",,REP,Under Votes,71,2,84,157
Comal,403,"Judge, Court of Criminal Appeals, Place 3",,REP,Over Votes,0,0,0,0
Comal,403,"Judge, Court of Criminal Appeals, Place 4",,REP,Kevin Patrick Yeary,523,26,767,1316
Comal,403,"Judge, Court of Criminal Appeals, Place 4",,REP,Cast Votes:,523,26,767,1316
Comal,403,"Judge, Court of Criminal Appeals, Place 4",,REP,Under Votes,66,3,82,151
Comal,403,"Judge, Court of Criminal Appeals, Place 4",,REP,Over Votes,0,0,0,0
Comal,403,"Judge, Court of Criminal Appeals, Place 9",,REP,David Newell,525,26,761,1312
Comal,403,"Judge, Court of Criminal Appeals, Place 9",,REP,Cast Votes:,525,26,761,1312
Comal,403,"Judge, Court of Criminal Appeals, Place 9",,REP,Under Votes,64,3,88,155
Comal,403,"Judge, Court of Criminal Appeals, Place 9",,REP,Over Votes,0,0,0,0
Comal,403,"Member, State Board of Education, District 5",,REP,Lani Popp,165,17,321,503
Comal,403,"Member, State Board of Education, District 5",,REP,Inga Cotton,149,8,163,320
Comal,403,"Member, State Board of Education, District 5",,REP,Robert Morrow,193,2,260,455
Comal,403,"Member, State Board of Education, District 5",,REP,Cast Votes:,507,27,744,1278
Comal,403,"Member, State Board of Education, District 5",,REP,Under Votes,82,2,105,189
Comal,403,"Member, State Board of Education, District 5",,REP,Over Votes,0,0,0,0
Comal,403,State Representative,73,REP,Kyle Biedermann,532,26,770,1328
Comal,403,State Representative,73,REP,Cast Votes:,532,26,770,1328
Comal,403,State Representative,73,REP,Under Votes,57,3,79,139
Comal,403,State Representative,73,REP,Over Votes,0,0,0,0
Comal,403,"Chief Justice, 3rd Court of Appeals District",,REP,Jeff Rose,529,26,761,1316
Comal,403,"Chief Justice, 3rd Court of Appeals District",,REP,Cast Votes:,529,26,761,1316
Comal,403,"Chief Justice, 3rd Court of Appeals District",,REP,Under Votes,60,3,88,151
Comal,403,"Chief Justice, 3rd Court of Appeals District",,REP,Over Votes,0,0,0,0
Comal,403,"District Judge, 22nd Judicial District",,REP,R. Bruce Boyer,526,26,764,1316
Comal,403,"District Judge, 22nd Judicial District",,REP,Cast Votes:,526,26,764,1316
Comal,403,"District Judge, 22nd Judicial District",,REP,Under Votes,63,3,85,151
Comal,403,"District Judge, 22nd Judicial District",,REP,Over Votes,0,0,0,0
Comal,403,"District Judge, 433rd Judicial District",,REP,Dib Waldrip,314,20,479,813
Comal,403,"District Judge, 433rd Judicial District",,REP,Charlie Sullivan,220,8,304,532
Comal,403,"District Judge, 433rd Judicial District",,REP,Cast Votes:,534,28,783,1345
Comal,403,"District Judge, 433rd Judicial District",,REP,Under Votes,55,1,66,122
Comal,403,"District Judge, 433rd Judicial District",,REP,Over Votes,0,0,0,0
Comal,403,"Judge, County Court at Law No. 2",,REP,"Charles A. Stephens, II",515,26,758,1299
Comal,403,"Judge, County Court at Law No. 2",,REP,Cast Votes:,515,26,758,1299
Comal,403,"Judge, County Court at Law No. 2",,REP,Under Votes,74,3,91,168
Comal,403,"Judge, County Court at Law No. 2",,REP,Over Votes,0,0,0,0
Comal,403,"Judge, County Court at Law No. 3",,REP,Deborah Linnartz Wigington,511,26,743,1280
Comal,403,"Judge, County Court at Law No. 3",,REP,Cast Votes:,511,26,743,1280
Comal,403,"Judge, County Court at Law No. 3",,REP,Under Votes,78,3,106,187
Comal,403,"Judge, County Court at Law No. 3",,REP,Over Votes,0,0,0,0
Comal,403,Sheriff,,REP,Mark Reynolds,539,26,777,1342
Comal,403,Sheriff,,REP,Cast Votes:,539,26,777,1342
Comal,403,Sheriff,,REP,Under Votes,50,3,72,125
Comal,403,Sheriff,,REP,Over Votes,0,0,0,0
Comal,403,County Tax Assessor-Collector,,REP,Kristen H. Hoyt,348,13,433,794
Comal,403,County Tax Assessor-Collector,,REP,Patrick Aten,192,15,361,568
Comal,403,County Tax Assessor-Collector,,REP,Cast Votes:,540,28,794,1362
Comal,403,County Tax Assessor-Collector,,REP,Under Votes,49,1,55,105
Comal,403,County Tax Assessor-Collector,,REP,Over Votes,0,0,0,0
Comal,403,"Constable, Precinct No. 4",,REP,Shane Rapp,443,17,658,1118
Comal,403,"Constable, Precinct No. 4",,REP,Jerry Airola,107,10,149,266
Comal,403,"Constable, Precinct No. 4",,REP,Cast Votes:,550,27,807,1384
Comal,403,"Constable, Precinct No. 4",,REP,Under Votes,39,2,42,83
Comal,403,"Constable, Precinct No. 4",,REP,Over Votes,0,0,0,0
Comal,403,County Chairman,,REP,Sue Piner,517,26,753,1296
Comal,403,County Chairman,,REP,Cast Votes:,517,26,753,1296
Comal,403,County Chairman,,REP,Under Votes,72,3,96,171
Comal,403,County Chairman,,REP,Over Votes,0,0,0,0
Comal,403,Proposition 1,,REP,Yes,534,25,797,1356
Comal,403,Proposition 1,,REP,No,48,1,47,96
Comal,403,Proposition 1,,REP,Cast Votes:,582,26,844,1452
Comal,403,Proposition 1,,REP,Under Votes,7,3,5,15
Comal,403,Proposition 1,,REP,Over Votes,0,0,0,0
Comal,403,Proposition 2,,REP,Yes,527,22,776,1325
Comal,403,Proposition 2,,REP,No,53,3,62,118
Comal,403,Proposition 2,,REP,Cast Votes:,580,25,838,1443
Comal,403,Proposition 2,,REP,Under Votes,9,4,11,24
Comal,403,Proposition 2,,REP,Over Votes,0,0,0,0
Comal,403,Proposition 3,,REP,Yes,558,25,813,1396
Comal,403,Proposition 3,,REP,No,21,0,26,47
Comal,403,Proposition 3,,REP,Cast Votes:,579,25,839,1443
Comal,403,Proposition 3,,REP,Under Votes,10,4,10,24
Comal,403,Proposition 3,,REP,Over Votes,0,0,0,0
Comal,403,Proposition 4,,REP,Yes,564,25,812,1401
Comal,403,Proposition 4,,REP,No,20,1,25,46
Comal,403,Proposition 4,,REP,Cast Votes:,584,26,837,1447
Comal,403,Proposition 4,,REP,Under Votes,5,3,12,20
Comal,403,Proposition 4,,REP,Over Votes,0,0,0,0
Comal,403,Proposition 5,,REP,Yes,540,24,770,1334
Comal,403,Proposition 5,,REP,No,41,1,57,99
Comal,403,Proposition 5,,REP,Cast Votes:,581,25,827,1433
Comal,403,Proposition 5,,REP,Under Votes,8,4,22,34
Comal,403,Proposition 5,,REP,Over Votes,0,0,0,0
Comal,403,Proposition 6,,REP,Yes,553,26,805,1384
Comal,403,Proposition 6,,REP,No,25,0,25,50
Comal,403,Proposition 6,,REP,Cast Votes:,578,26,830,1434
Comal,403,Proposition 6,,REP,Under Votes,11,3,19,33
Comal,403,Proposition 6,,REP,Over Votes,0,0,0,0
Comal,403,Proposition 7,,REP,Yes,569,25,811,1405
Comal,403,Proposition 7,,REP,No,14,0,21,35
Comal,403,Proposition 7,,REP,Cast Votes:,583,25,832,1440
Comal,403,Proposition 7,,REP,Under Votes,6,4,17,27
Comal,403,Proposition 7,,REP,Over Votes,0,0,0,0
Comal,403,Proposition 8,,REP,Yes,578,26,838,1442
Comal,403,Proposition 8,,REP,No,2,0,1,3
Comal,403,Proposition 8,,REP,Cast Votes:,580,26,839,1445
Comal,403,Proposition 8,,REP,Under Votes,9,3,10,22
Comal,403,Proposition 8,,REP,Over Votes,0,0,0,0
Comal,403,Proposition 9,,REP,Yes,565,26,801,1392
Comal,403,Proposition 9,,REP,No,19,0,34,53
Comal,403,Proposition 9,,REP,Cast Votes:,584,26,835,1445
Comal,403,Proposition 9,,REP,Under Votes,5,3,14,22
Comal,403,Proposition 9,,REP,Over Votes,0,0,0,0
Comal,403,Proposition 10,,REP,Yes,543,25,793,1361
Comal,403,Proposition 10,,REP,No,34,1,41,76
Comal,403,Proposition 10,,REP,Cast Votes:,577,26,834,1437
Comal,403,Proposition 10,,REP,Under Votes,12,3,15,30
Comal,403,Proposition 10,,REP,Over Votes,0,0,0,0
Comal,404,President,,REP,Zoltan G. Istvan,1,0,0,1
Comal,404,President,,REP,Bill Weld,6,0,3,9
Comal,404,President,,REP,"Roque ""Rocky"" De La Fuente Guerra",0,0,0,0
Comal,404,President,,REP,Matthew John Matern,2,0,0,2
Comal,404,President,,REP,Donald J. Trump,334,27,427,788
Comal,404,President,,REP,Joe Walsh,3,0,4,7
Comal,404,President,,REP,Bob Ely,0,0,0,0
Comal,404,President,,REP,Uncommitted,14,0,13,27
Comal,404,Ballots Cast,,REP,,360,27,447,834
Comal,404,President,,REP,Under Votes,2,0,1,3
Comal,404,President,,REP,Over Votes,0,0,0,0
Comal,404,U.S. Senate,,REP,John Anthony Castro,13,1,20,34
Comal,404,U.S. Senate,,REP,Virgil Bierschwale,5,0,3,8
Comal,404,U.S. Senate,,REP,John Cornyn,273,24,357,654
Comal,404,U.S. Senate,,REP,Mark Yancey,9,1,16,26
Comal,404,U.S. Senate,,REP,Dwayne Stovall,30,0,31,61
Comal,404,U.S. Senate,,REP,Cast Votes:,330,26,427,783
Comal,404,U.S. Senate,,REP,Under Votes,32,1,21,54
Comal,404,U.S. Senate,,REP,Over Votes,0,0,0,0
Comal,404,U.S. House,21,REP,Chip Roy,340,23,422,785
Comal,404,U.S. House,21,REP,Cast Votes:,340,23,422,785
Comal,404,U.S. House,21,REP,Under Votes,22,4,26,52
Comal,404,U.S. House,21,REP,Over Votes,0,0,0,0
Comal,404,Railroad Commissioner,,REP,"James ""Jim"" Wright",184,13,235,432
Comal,404,Railroad Commissioner,,REP,Ryan Sitton,117,14,175,306
Comal,404,Railroad Commissioner,,REP,Cast Votes:,301,27,410,738
Comal,404,Railroad Commissioner,,REP,Under Votes,61,0,38,99
Comal,404,Railroad Commissioner,,REP,Over Votes,0,0,0,0
Comal,404,"Chief Justice, Supreme Court",,REP,Nathan Hecht,316,22,400,738
Comal,404,"Chief Justice, Supreme Court",,REP,Cast Votes:,316,22,400,738
Comal,404,"Chief Justice, Supreme Court",,REP,Under Votes,46,5,48,99
Comal,404,"Chief Justice, Supreme Court",,REP,Over Votes,0,0,0,0
Comal,404,"Justice, Supreme Court, Place 6 Unexpired Term",,REP,Jane Bland,315,22,398,735
Comal,404,"Justice, Supreme Court, Place 6 Unexpired Term",,REP,Cast Votes:,315,22,398,735
Comal,404,"Justice, Supreme Court, Place 6 Unexpired Term",,REP,Under Votes,47,5,50,102
Comal,404,"Justice, Supreme Court, Place 6 Unexpired Term",,REP,Over Votes,0,0,0,0
Comal,404,"Justice, Supreme Court, Place 7",,REP,Jeff Boyd,313,22,398,733
Comal,404,"Justice, Supreme Court, Place 7",,REP,Cast Votes:,313,22,398,733
Comal,404,"Justice, Supreme Court, Place 7",,REP,Under Votes,49,5,50,104
Comal,404,"Justice, Supreme Court, Place 7",,REP,Over Votes,0,0,0,0
Comal,404,"Justice, Supreme Court, Place 8",,REP,Brett Busby,312,21,394,727
Comal,404,"Justice, Supreme Court, Place 8",,REP,Cast Votes:,312,21,394,727
Comal,404,"Justice, Supreme Court, Place 8",,REP,Under Votes,50,6,54,110
Comal,404,"Justice, Supreme Court, Place 8",,REP,Over Votes,0,0,0,0
Comal,404,"Judge, Court of Criminal Appeals, Place 3",,REP,Gina Parker,153,16,196,365
Comal,404,"Judge, Court of Criminal Appeals, Place 3",,REP,Bert Richardson,144,10,205,359
Comal,404,"Judge, Court of Criminal Appeals, Place 3",,REP,Cast Votes:,297,26,401,724
Comal,404,"Judge, Court of Criminal Appeals, Place 3",,REP,Under Votes,65,1,47,113
Comal,404,"Judge, Court of Criminal Appeals, Place 3",,REP,Over Votes,0,0,0,0
Comal,404,"Judge, Court of Criminal Appeals, Place 4",,REP,Kevin Patrick Yeary,307,22,393,722
Comal,404,"Judge, Court of Criminal Appeals, Place 4",,REP,Cast Votes:,307,22,393,722
Comal,404,"Judge, Court of Criminal Appeals, Place 4",,REP,Under Votes,55,5,55,115
Comal,404,"Judge, Court of Criminal Appeals, Place 4",,REP,Over Votes,0,0,0,0
Comal,404,"Judge, Court of Criminal Appeals, Place 9",,REP,David Newell,304,22,392,718
Comal,404,"Judge, Court of Criminal Appeals, Place 9",,REP,Cast Votes:,304,22,392,718
Comal,404,"Judge, Court of Criminal Appeals, Place 9",,REP,Under Votes,58,5,56,119
Comal,404,"Judge, Court of Criminal Appeals, Place 9",,REP,Over Votes,0,0,0,0
Comal,404,"Member, State Board of Education, District 5",,REP,Lani Popp,108,16,160,284
Comal,404,"Member, State Board of Education, District 5",,REP,Inga Cotton,73,3,91,167
Comal,404,"Member, State Board of Education, District 5",,REP,Robert Morrow,106,6,139,251
Comal,404,"Member, State Board of Education, District 5",,REP,Cast Votes:,287,25,390,702
Comal,404,"Member, State Board of Education, District 5",,REP,Under Votes,75,2,58,135
Comal,404,"Member, State Board of Education, District 5",,REP,Over Votes,0,0,0,0
Comal,404,State Representative,73,REP,Kyle Biedermann,319,23,398,740
Comal,404,State Representative,73,REP,Cast Votes:,319,23,398,740
Comal,404,State Representative,73,REP,Under Votes,43,4,50,97
Comal,404,State Representative,73,REP,Over Votes,0,0,0,0
Comal,404,"Chief Justice, 3rd Court of Appeals District",,REP,Jeff Rose,309,22,397,728
Comal,404,"Chief Justice, 3rd Court of Appeals District",,REP,Cast Votes:,309,22,397,728
Comal,404,"Chief Justice, 3rd Court of Appeals District",,REP,Under Votes,53,5,51,109
Comal,404,"Chief Justice, 3rd Court of Appeals District",,REP,Over Votes,0,0,0,0
Comal,404,"District Judge, 22nd Judicial District",,REP,R. Bruce Boyer,319,22,404,745
Comal,404,"District Judge, 22nd Judicial District",,REP,Cast Votes:,319,22,404,745
Comal,404,"District Judge, 22nd Judicial District",,REP,Under Votes,43,5,44,92
Comal,404,"District Judge, 22nd Judicial District",,REP,Over Votes,0,0,0,0
Comal,404,"District Judge, 433rd Judicial District",,REP,Dib Waldrip,260,25,332,617
Comal,404,"District Judge, 433rd Judicial District",,REP,Charlie Sullivan,72,1,92,165
Comal,404,"District Judge, 433rd Judicial District",,REP,Cast Votes:,332,26,424,782
Comal,404,"District Judge, 433rd Judicial District",,REP,Under Votes,30,1,24,55
Comal,404,"District Judge, 433rd Judicial District",,REP,Over Votes,0,0,0,0
Comal,404,"Judge, County Court at Law No. 2",,REP,"Charles A. Stephens, II",310,22,400,732
Comal,404,"Judge, County Court at Law No. 2",,REP,Cast Votes:,310,22,400,732
Comal,404,"Judge, County Court at Law No. 2",,REP,Under Votes,52,5,48,105
Comal,404,"Judge, County Court at Law No. 2",,REP,Over Votes,0,0,0,0
Comal,404,"Judge, County Court at Law No. 3",,REP,Deborah Linnartz Wigington,302,22,397,721
Comal,404,"Judge, County Court at Law No. 3",,REP,Cast Votes:,302,22,397,721
Comal,404,"Judge, County Court at Law No. 3",,REP,Under Votes,60,5,51,116
Comal,404,"Judge, County Court at Law No. 3",,REP,Over Votes,0,0,0,0
Comal,404,Sheriff,,REP,Mark Reynolds,320,22,407,749
Comal,404,Sheriff,,REP,Cast Votes:,320,22,407,749
Comal,404,Sheriff,,REP,Under Votes,42,5,41,88
Comal,404,Sheriff,,REP,Over Votes,0,0,0,0
Comal,404,County Tax Assessor-Collector,,REP,Kristen H. Hoyt,179,17,241,437
Comal,404,County Tax Assessor-Collector,,REP,Patrick Aten,143,10,182,335
Comal,404,County Tax Assessor-Collector,,REP,Cast Votes:,322,27,423,772
Comal,404,County Tax Assessor-Collector,,REP,Under Votes,40,0,25,65
Comal,404,County Tax Assessor-Collector,,REP,Over Votes,0,0,0,0
Comal,404,"Constable, Precinct No. 4",,REP,Shane Rapp,226,19,301,546
Comal,404,"Constable, Precinct No. 4",,REP,Jerry Airola,106,7,127,240
Comal,404,"Constable, Precinct No. 4",,REP,Cast Votes:,332,26,428,786
Comal,404,"Constable, Precinct No. 4",,REP,Under Votes,30,1,20,51
Comal,404,"Constable, Precinct No. 4",,REP,Over Votes,0,0,0,0
Comal,404,County Chairman,,REP,Sue Piner,304,22,401,727
Comal,404,County Chairman,,REP,Cast Votes:,304,22,401,727
Comal,404,County Chairman,,REP,Under Votes,58,5,47,110
Comal,404,County Chairman,,REP,Over Votes,0,0,0,0
Comal,404,Proposition 1,,REP,Yes,325,25,413,763
Comal,404,Proposition 1,,REP,No,33,2,30,65
Comal,404,Proposition 1,,REP,Cast Votes:,358,27,443,828
Comal,404,Proposition 1,,REP,Under Votes,4,0,5,9
Comal,404,Proposition 1,,REP,Over Votes,0,0,0,0
Comal,404,Proposition 2,,REP,Yes,314,22,376,712
Comal,404,Proposition 2,,REP,No,42,4,65,111
Comal,404,Proposition 2,,REP,Cast Votes:,356,26,441,823
Comal,404,Proposition 2,,REP,Under Votes,6,1,7,14
Comal,404,Proposition 2,,REP,Over Votes,0,0,0,0
Comal,404,Proposition 3,,REP,Yes,344,27,419,790
Comal,404,Proposition 3,,REP,No,6,0,20,26
Comal,404,Proposition 3,,REP,Cast Votes:,350,27,439,816
Comal,404,Proposition 3,,REP,Under Votes,12,0,9,21
Comal,404,Proposition 3,,REP,Over Votes,0,0,0,0
Comal,404,Proposition 4,,REP,Yes,334,25,416,775
Comal,404,Proposition 4,,REP,No,22,2,23,47
Comal,404,Proposition 4,,REP,Cast Votes:,356,27,439,822
Comal,404,Proposition 4,,REP,Under Votes,6,0,9,15
Comal,404,Proposition 4,,REP,Over Votes,0,0,0,0
Comal,404,Proposition 5,,REP,Yes,329,23,400,752
Comal,404,Proposition 5,,REP,No,28,2,36,66
Comal,404,Proposition 5,,REP,Cast Votes:,357,25,436,818
Comal,404,Proposition 5,,REP,Under Votes,5,2,12,19
Comal,404,Proposition 5,,REP,Over Votes,0,0,0,0
Comal,404,Proposition 6,,REP,Yes,341,23,415,779
Comal,404,Proposition 6,,REP,No,15,2,25,42
Comal,404,Proposition 6,,REP,Cast Votes:,356,25,440,821
Comal,404,Proposition 6,,REP,Under Votes,6,2,8,16
Comal,404,Proposition 6,,REP,Over Votes,0,0,0,0
Comal,404,Proposition 7,,REP,Yes,342,24,427,793
Comal,404,Proposition 7,,REP,No,14,3,8,25
Comal,404,Proposition 7,,REP,Cast Votes:,356,27,435,818
Comal,404,Proposition 7,,REP,Under Votes,6,0,13,19
Comal,404,Proposition 7,,REP,Over Votes,0,0,0,0
Comal,404,Proposition 8,,REP,Yes,355,27,431,813
Comal,404,Proposition 8,,REP,No,3,0,6,9
Comal,404,Proposition 8,,REP,Cast Votes:,358,27,437,822
Comal,404,Proposition 8,,REP,Under Votes,4,0,11,15
Comal,404,Proposition 8,,REP,Over Votes,0,0,0,0
Comal,404,Proposition 9,,REP,Yes,340,25,423,788
Comal,404,Proposition 9,,REP,No,16,1,16,33
Comal,404,Proposition 9,,REP,Cast Votes:,356,26,439,821
Comal,404,Proposition 9,,REP,Under Votes,6,1,9,16
Comal,404,Proposition 9,,REP,Over Votes,0,0,0,0
Comal,404,Proposition 10,,REP,Yes,318,25,414,757
Comal,404,Proposition 10,,REP,No,33,2,24,59
Comal,404,Proposition 10,,REP,Cast Votes:,351,27,438,816
Comal,404,Proposition 10,,REP,Under Votes,11,0,10,21
Comal,404,Proposition 10,,REP,Over Votes,0,0,0,0
Comal,405,President,,REP,Zoltan G. Istvan,0,0,0,0
Comal,405,President,,REP,Bill Weld,3,0,3,6
Comal,405,President,,REP,"Roque ""Rocky"" De La Fuente Guerra",0,0,0,0
Comal,405,President,,REP,Matthew John Matern,0,0,1,1
Comal,405,President,,REP,Donald J. Trump,385,26,434,845
Comal,405,President,,REP,Joe Walsh,0,0,1,1
Comal,405,President,,REP,Bob Ely,0,0,0,0
Comal,405,President,,REP,Uncommitted,11,3,6,20
Comal,405,Ballots Cast,,REP,,399,29,445,873
Comal,405,President,,REP,Under Votes,1,0,2,3
Comal,405,President,,REP,Over Votes,0,0,0,0
Comal,405,U.S. Senate,,REP,John Anthony Castro,23,1,15,39
Comal,405,U.S. Senate,,REP,Virgil Bierschwale,10,0,6,16
Comal,405,U.S. Senate,,REP,John Cornyn,269,21,325,615
Comal,405,U.S. Senate,,REP,Mark Yancey,20,0,16,36
Comal,405,U.S. Senate,,REP,Dwayne Stovall,46,6,61,113
Comal,405,U.S. Senate,,REP,Cast Votes:,368,28,423,819
Comal,405,U.S. Senate,,REP,Under Votes,32,1,24,57
Comal,405,U.S. Senate,,REP,Over Votes,0,0,0,0
Comal,405,U.S. House,21,REP,Chip Roy,365,29,424,818
Comal,405,U.S. House,21,REP,Cast Votes:,365,29,424,818
Comal,405,U.S. House,21,REP,Under Votes,35,0,23,58
Comal,405,U.S. House,21,REP,Over Votes,0,0,0,0
Comal,405,Railroad Commissioner,,REP,"James ""Jim"" Wright",213,19,220,452
Comal,405,Railroad Commissioner,,REP,Ryan Sitton,138,10,183,331
Comal,405,Railroad Commissioner,,REP,Cast Votes:,351,29,403,783
Comal,405,Railroad Commissioner,,REP,Under Votes,49,0,44,93
Comal,405,Railroad Commissioner,,REP,Over Votes,0,0,0,0
Comal,405,"Chief Justice, Supreme Court",,REP,Nathan Hecht,349,28,396,773
Comal,405,"Chief Justice, Supreme Court",,REP,Cast Votes:,349,28,396,773
Comal,405,"Chief Justice, Supreme Court",,REP,Under Votes,51,1,51,103
Comal,405,"Chief Justice, Supreme Court",,REP,Over Votes,0,0,0,0
Comal,405,"Justice, Supreme Court, Place 6 Unexpired Term",,REP,Jane Bland,344,28,391,763
Comal,405,"Justice, Supreme Court, Place 6 Unexpired Term",,REP,Cast Votes:,344,28,391,763
Comal,405,"Justice, Supreme Court, Place 6 Unexpired Term",,REP,Under Votes,56,1,56,113
Comal,405,"Justice, Supreme Court, Place 6 Unexpired Term",,REP,Over Votes,0,0,0,0
Comal,405,"Justice, Supreme Court, Place 7",,REP,Jeff Boyd,350,28,391,769
Comal,405,"Justice, Supreme Court, Place 7",,REP,Cast Votes:,350,28,391,769
Comal,405,"Justice, Supreme Court, Place 7",,REP,Under Votes,50,1,56,107
Comal,405,"Justice, Supreme Court, Place 7",,REP,Over Votes,0,0,0,0
Comal,405,"Justice, Supreme Court, Place 8",,REP,Brett Busby,344,27,387,758
Comal,405,"Justice, Supreme Court, Place 8",,REP,Cast Votes:,344,27,387,758
Comal,405,"Justice, Supreme Court, Place 8",,REP,Under Votes,56,2,60,118
Comal,405,"Justice, Supreme Court, Place 8",,REP,Over Votes,0,0,0,0
Comal,405,"Judge, Court of Criminal Appeals, Place 3",,REP,Gina Parker,185,15,199,399
Comal,405,"Judge, Court of Criminal Appeals, Place 3",,REP,Bert Richardson,151,14,195,360
Comal,405,"Judge, Court of Criminal Appeals, Place 3",,REP,Cast Votes:,336,29,394,759
Comal,405,"Judge, Court of Criminal Appeals, Place 3",,REP,Under Votes,64,0,53,117
Comal,405,"Judge, Court of Criminal Appeals, Place 3",,REP,Over Votes,0,0,0,0
Comal,405,"Judge, Court of Criminal Appeals, Place 4",,REP,Kevin Patrick Yeary,343,28,384,755
Comal,405,"Judge, Court of Criminal Appeals, Place 4",,REP,Cast Votes:,343,28,384,755
Comal,405,"Judge, Court of Criminal Appeals, Place 4",,REP,Under Votes,57,1,63,121
Comal,405,"Judge, Court of Criminal Appeals, Place 4",,REP,Over Votes,0,0,0,0
Comal,405,"Judge, Court of Criminal Appeals, Place 9",,REP,David Newell,341,28,382,751
Comal,405,"Judge, Court of Criminal Appeals, Place 9",,REP,Cast Votes:,341,28,382,751
Comal,405,"Judge, Court of Criminal Appeals, Place 9",,REP,Under Votes,59,1,65,125
Comal,405,"Judge, Court of Criminal Appeals, Place 9",,REP,Over Votes,0,0,0,0
Comal,405,"Member, State Board of Education, District 5",,REP,Lani Popp,124,6,171,301
Comal,405,"Member, State Board of Education, District 5",,REP,Inga Cotton,83,8,83,174
Comal,405,"Member, State Board of Education, District 5",,REP,Robert Morrow,132,15,139,286
Comal,405,"Member, State Board of Education, District 5",,REP,Cast Votes:,339,29,393,761
Comal,405,"Member, State Board of Education, District 5",,REP,Under Votes,61,0,54,115
Comal,405,"Member, State Board of Education, District 5",,REP,Over Votes,0,0,0,0
Comal,405,State Representative,73,REP,Kyle Biedermann,352,29,397,778
Comal,405,State Representative,73,REP,Cast Votes:,352,29,397,778
Comal,405,State Representative,73,REP,Under Votes,48,0,50,98
Comal,405,State Representative,73,REP,Over Votes,0,0,0,0
Comal,405,"Chief Justice, 3rd Court of Appeals District",,REP,Jeff Rose,340,28,380,748
Comal,405,"Chief Justice, 3rd Court of Appeals District",,REP,Cast Votes:,340,28,380,748
Comal,405,"Chief Justice, 3rd Court of Appeals District",,REP,Under Votes,60,1,67,128
Comal,405,"Chief Justice, 3rd Court of Appeals District",,REP,Over Votes,0,0,0,0
Comal,405,"District Judge, 22nd Judicial District",,REP,R. Bruce Boyer,339,28,385,752
Comal,405,"District Judge, 22nd Judicial District",,REP,Cast Votes:,339,28,385,752
Comal,405,"District Judge, 22nd Judicial District",,REP,Under Votes,61,1,62,124
Comal,405,"District Judge, 22nd Judicial District",,REP,Over Votes,0,0,0,0
Comal,405,"District Judge, 433rd Judicial District",,REP,Dib Waldrip,230,20,243,493
Comal,405,"District Judge, 433rd Judicial District",,REP,Charlie Sullivan,124,9,150,283
Comal,405,"District Judge, 433rd Judicial District",,REP,Cast Votes:,354,29,393,776
Comal,405,"District Judge, 433rd Judicial District",,REP,Under Votes,46,0,53,99
Comal,405,"District Judge, 433rd Judicial District",,REP,Over Votes,0,0,1,1
Comal,405,"Judge, County Court at Law No. 2",,REP,"Charles A. Stephens, II",339,28,379,746
Comal,405,"Judge, County Court at Law No. 2",,REP,Cast Votes:,339,28,379,746
Comal,405,"Judge, County Court at Law No. 2",,REP,Under Votes,61,1,68,130
Comal,405,"Judge, County Court at Law No. 2",,REP,Over Votes,0,0,0,0
Comal,405,"Judge, County Court at Law No. 3",,REP,Deborah Linnartz Wigington,335,28,378,741
Comal,405,"Judge, County Court at Law No. 3",,REP,Cast Votes:,335,28,378,741
Comal,405,"Judge, County Court at Law No. 3",,REP,Under Votes,65,1,69,135
Comal,405,"Judge, County Court at Law No. 3",,REP,Over Votes,0,0,0,0
Comal,405,Sheriff,,REP,Mark Reynolds,352,28,394,774
Comal,405,Sheriff,,REP,Cast Votes:,352,28,394,774
Comal,405,Sheriff,,REP,Under Votes,48,1,53,102
Comal,405,Sheriff,,REP,Over Votes,0,0,0,0
Comal,405,County Tax Assessor-Collector,,REP,Kristen H. Hoyt,260,14,244,518
Comal,405,County Tax Assessor-Collector,,REP,Patrick Aten,99,15,159,273
Comal,405,County Tax Assessor-Collector,,REP,Cast Votes:,359,29,403,791
Comal,405,County Tax Assessor-Collector,,REP,Under Votes,41,0,43,84
Comal,405,County Tax Assessor-Collector,,REP,Over Votes,0,0,1,1
Comal,405,"Constable, Precinct No. 4",,REP,Shane Rapp,248,23,306,577
Comal,405,"Constable, Precinct No. 4",,REP,Jerry Airola,103,5,89,197
Comal,405,"Constable, Precinct No. 4",,REP,Cast Votes:,351,28,395,774
Comal,405,"Constable, Precinct No. 4",,REP,Under Votes,49,1,51,101
Comal,405,"Constable, Precinct No. 4",,REP,Over Votes,0,0,1,1
Comal,405,County Chairman,,REP,Sue Piner,335,28,369,732
Comal,405,County Chairman,,REP,Cast Votes:,335,28,369,732
Comal,405,County Chairman,,REP,Under Votes,65,1,78,144
Comal,405,County Chairman,,REP,Over Votes,0,0,0,0
Comal,405,Proposition 1,,REP,Yes,350,29,399,778
Comal,405,Proposition 1,,REP,No,43,0,35,78
Comal,405,Proposition 1,,REP,Cast Votes:,393,29,434,856
Comal,405,Proposition 1,,REP,Under Votes,7,0,13,20
Comal,405,Proposition 1,,REP,Over Votes,0,0,0,0
Comal,405,Proposition 2,,REP,Yes,341,25,396,762
Comal,405,Proposition 2,,REP,No,49,4,39,92
Comal,405,Proposition 2,,REP,Cast Votes:,390,29,435,854
Comal,405,Proposition 2,,REP,Under Votes,10,0,12,22
Comal,405,Proposition 2,,REP,Over Votes,0,0,0,0
Comal,405,Proposition 3,,REP,Yes,373,27,417,817
Comal,405,Proposition 3,,REP,No,18,2,18,38
Comal,405,Proposition 3,,REP,Cast Votes:,391,29,435,855
Comal,405,Proposition 3,,REP,Under Votes,9,0,12,21
Comal,405,Proposition 3,,REP,Over Votes,0,0,0,0
Comal,405,Proposition 4,,REP,Yes,370,27,422,819
Comal,405,Proposition 4,,REP,No,22,2,11,35
Comal,405,Proposition 4,,REP,Cast Votes:,392,29,433,854
Comal,405,Proposition 4,,REP,Under Votes,8,0,14,22
Comal,405,Proposition 4,,REP,Over Votes,0,0,0,0
Comal,405,Proposition 5,,REP,Yes,353,23,408,784
Comal,405,Proposition 5,,REP,No,32,6,20,58
Comal,405,Proposition 5,,REP,Cast Votes:,385,29,428,842
Comal,405,Proposition 5,,REP,Under Votes,15,0,19,34
Comal,405,Proposition 5,,REP,Over Votes,0,0,0,0
Comal,405,Proposition 6,,REP,Yes,369,27,421,817
Comal,405,Proposition 6,,REP,No,17,1,13,31
Comal,405,Proposition 6,,REP,Cast Votes:,386,28,434,848
Comal,405,Proposition 6,,REP,Under Votes,14,1,13,28
Comal,405,Proposition 6,,REP,Over Votes,0,0,0,0
Comal,405,Proposition 7,,REP,Yes,383,27,422,832
Comal,405,Proposition 7,,REP,No,6,2,11,19
Comal,405,Proposition 7,,REP,Cast Votes:,389,29,433,851
Comal,405,Proposition 7,,REP,Under Votes,11,0,14,25
Comal,405,Proposition 7,,REP,Over Votes,0,0,0,0
Comal,405,Proposition 8,,REP,Yes,387,29,431,847
Comal,405,Proposition 8,,REP,No,2,0,3,5
Comal,405,Proposition 8,,REP,Cast Votes:,389,29,434,852
Comal,405,Proposition 8,,REP,Under Votes,11,0,13,24
Comal,405,Proposition 8,,REP,Over Votes,0,0,0,0
Comal,405,Proposition 9,,REP,Yes,382,28,414,824
Comal,405,Proposition 9,,REP,No,7,1,18,26
Comal,405,Proposition 9,,REP,Cast Votes:,389,29,432,850
Comal,405,Proposition 9,,REP,Under Votes,11,0,15,26
Comal,405,Proposition 9,,REP,Over Votes,0,0,0,0
Comal,405,Proposition 10,,REP,Yes,366,27,402,795
Comal,405,Proposition 10,,REP,No,19,2,28,49
Comal,405,Proposition 10,,REP,Cast Votes:,385,29,430,844
Comal,405,Proposition 10,,REP,Under Votes,15,0,17,32
Comal,405,Proposition 10,,REP,Over Votes,0,0,0,0
Comal,406,President,,REP,Zoltan G. Istvan,0,0,0,0
Comal,406,President,,REP,Bill Weld,2,3,6,11
Comal,406,President,,REP,"Roque ""Rocky"" De La Fuente Guerra",0,0,3,3
Comal,406,President,,REP,Matthew John Matern,1,0,0,1
Comal,406,President,,REP,Donald J. Trump,442,51,543,1036
Comal,406,President,,REP,Joe Walsh,1,0,4,5
Comal,406,President,,REP,Bob Ely,0,0,0,0
Comal,406,President,,REP,Uncommitted,19,2,28,49
Comal,406,Ballots Cast,,REP,,465,56,584,1105
Comal,406,President,,REP,Under Votes,2,0,3,5
Comal,406,President,,REP,Over Votes,0,0,0,0
Comal,406,U.S. Senate,,REP,John Anthony Castro,26,1,20,47
Comal,406,U.S. Senate,,REP,Virgil Bierschwale,4,0,6,10
Comal,406,U.S. Senate,,REP,John Cornyn,356,49,483,888
Comal,406,U.S. Senate,,REP,Mark Yancey,14,1,16,31
Comal,406,U.S. Senate,,REP,Dwayne Stovall,37,4,34,75
Comal,406,U.S. Senate,,REP,Cast Votes:,437,55,559,1051
Comal,406,U.S. Senate,,REP,Under Votes,30,1,28,59
Comal,406,U.S. Senate,,REP,Over Votes,0,0,0,0
Comal,406,U.S. House,21,REP,Chip Roy,431,48,534,1013
Comal,406,U.S. House,21,REP,Cast Votes:,431,48,534,1013
Comal,406,U.S. House,21,REP,Under Votes,36,8,53,97
Comal,406,U.S. House,21,REP,Over Votes,0,0,0,0
Comal,406,Railroad Commissioner,,REP,"James ""Jim"" Wright",253,19,281,553
Comal,406,Railroad Commissioner,,REP,Ryan Sitton,158,25,230,413
Comal,406,Railroad Commissioner,,REP,Cast Votes:,411,44,511,966
Comal,406,Railroad Commissioner,,REP,Under Votes,56,12,76,144
Comal,406,Railroad Commissioner,,REP,Over Votes,0,0,0,0
Comal,406,"Chief Justice, Supreme Court",,REP,Nathan Hecht,409,42,499,950
Comal,406,"Chief Justice, Supreme Court",,REP,Cast Votes:,409,42,499,950
Comal,406,"Chief Justice, Supreme Court",,REP,Under Votes,58,14,88,160
Comal,406,"Chief Justice, Supreme Court",,REP,Over Votes,0,0,0,0
Comal,406,"Justice, Supreme Court, Place 6 Unexpired Term",,REP,Jane Bland,408,43,491,942
Comal,406,"Justice, Supreme Court, Place 6 Unexpired Term",,REP,Cast Votes:,408,43,491,942
Comal,406,"Justice, Supreme Court, Place 6 Unexpired Term",,REP,Under Votes,59,13,96,168
Comal,406,"Justice, Supreme Court, Place 6 Unexpired Term",,REP,Over Votes,0,0,0,0
Comal,406,"Justice, Supreme Court, Place 7",,REP,Jeff Boyd,404,43,500,947
Comal,406,"Justice, Supreme Court, Place 7",,REP,Cast Votes:,404,43,500,947
Comal,406,"Justice, Supreme Court, Place 7",,REP,Under Votes,63,13,87,163
Comal,406,"Justice, Supreme Court, Place 7",,REP,Over Votes,0,0,0,0
Comal,406,"Justice, Supreme Court, Place 8",,REP,Brett Busby,403,43,492,938
Comal,406,"Justice, Supreme Court, Place 8",,REP,Cast Votes:,403,43,492,938
Comal,406,"Justice, Supreme Court, Place 8",,REP,Under Votes,64,13,95,172
Comal,406,"Justice, Supreme Court, Place 8",,REP,Over Votes,0,0,0,0
Comal,406,"Judge, Court of Criminal Appeals, Place 3",,REP,Gina Parker,184,25,242,451
Comal,406,"Judge, Court of Criminal Appeals, Place 3",,REP,Bert Richardson,202,16,262,480
Comal,406,"Judge, Court of Criminal Appeals, Place 3",,REP,Cast Votes:,386,41,504,931
Comal,406,"Judge, Court of Criminal Appeals, Place 3",,REP,Under Votes,81,15,83,179
Comal,406,"Judge, Court of Criminal Appeals, Place 3",,REP,Over Votes,0,0,0,0
Comal,406,"Judge, Court of Criminal Appeals, Place 4",,REP,Kevin Patrick Yeary,396,43,486,925
Comal,406,"Judge, Court of Criminal Appeals, Place 4",,REP,Cast Votes:,396,43,486,925
Comal,406,"Judge, Court of Criminal Appeals, Place 4",,REP,Under Votes,71,13,101,185
Comal,406,"Judge, Court of Criminal Appeals, Place 4",,REP,Over Votes,0,0,0,0
Comal,406,"Judge, Court of Criminal Appeals, Place 9",,REP,David Newell,395,43,479,917
Comal,406,"Judge, Court of Criminal Appeals, Place 9",,REP,Cast Votes:,395,43,479,917
Comal,406,"Judge, Court of Criminal Appeals, Place 9",,REP,Under Votes,72,13,108,193
Comal,406,"Judge, Court of Criminal Appeals, Place 9",,REP,Over Votes,0,0,0,0
Comal,406,"Member, State Board of Education, District 5",,REP,Lani Popp,119,19,178,316
Comal,406,"Member, State Board of Education, District 5",,REP,Inga Cotton,122,9,113,244
Comal,406,"Member, State Board of Education, District 5",,REP,Robert Morrow,156,10,200,366
Comal,406,"Member, State Board of Education, District 5",,REP,Cast Votes:,397,38,491,926
Comal,406,"Member, State Board of Education, District 5",,REP,Under Votes,70,18,96,184
Comal,406,"Member, State Board of Education, District 5",,REP,Over Votes,0,0,0,0
Comal,406,State Representative,73,REP,Kyle Biedermann,413,43,505,961
Comal,406,State Representative,73,REP,Cast Votes:,413,43,505,961
Comal,406,State Representative,73,REP,Under Votes,54,13,82,149
Comal,406,State Representative,73,REP,Over Votes,0,0,0,0
Comal,406,"Chief Justice, 3rd Court of Appeals District",,REP,Jeff Rose,396,43,488,927
Comal,406,"Chief Justice, 3rd Court of Appeals District",,REP,Cast Votes:,396,43,488,927
Comal,406,"Chief Justice, 3rd Court of Appeals District",,REP,Under Votes,71,13,99,183
Comal,406,"Chief Justice, 3rd Court of Appeals District",,REP,Over Votes,0,0,0,0
Comal,406,"District Judge, 22nd Judicial District",,REP,R. Bruce Boyer,413,44,510,967
Comal,406,"District Judge, 22nd Judicial District",,REP,Cast Votes:,413,44,510,967
Comal,406,"District Judge, 22nd Judicial District",,REP,Under Votes,54,12,77,143
Comal,406,"District Judge, 22nd Judicial District",,REP,Over Votes,0,0,0,0
Comal,406,"District Judge, 433rd Judicial District",,REP,Dib Waldrip,339,38,427,804
Comal,406,"District Judge, 433rd Judicial District",,REP,Charlie Sullivan,90,9,122,221
Comal,406,"District Judge, 433rd Judicial District",,REP,Cast Votes:,429,47,549,1025
Comal,406,"District Judge, 433rd Judicial District",,REP,Under Votes,38,9,38,85
Comal,406,"District Judge, 433rd Judicial District",,REP,Over Votes,0,0,0,0
Comal,406,"Judge, County Court at Law No. 2",,REP,"Charles A. Stephens, II",403,41,495,939
Comal,406,"Judge, County Court at Law No. 2",,REP,Cast Votes:,403,41,495,939
Comal,406,"Judge, County Court at Law No. 2",,REP,Under Votes,64,15,92,171
Comal,406,"Judge, County Court at Law No. 2",,REP,Over Votes,0,0,0,0
Comal,406,"Judge, County Court at Law No. 3",,REP,Deborah Linnartz Wigington,392,44,485,921
Comal,406,"Judge, County Court at Law No. 3",,REP,Cast Votes:,392,44,485,921
Comal,406,"Judge, County Court at Law No. 3",,REP,Under Votes,75,12,102,189
Comal,406,"Judge, County Court at Law No. 3",,REP,Over Votes,0,0,0,0
Comal,406,Sheriff,,REP,Mark Reynolds,414,43,520,977
Comal,406,Sheriff,,REP,Cast Votes:,414,43,520,977
Comal,406,Sheriff,,REP,Under Votes,53,13,67,133
Comal,406,Sheriff,,REP,Over Votes,0,0,0,0
Comal,406,County Tax Assessor-Collector,,REP,Kristen H. Hoyt,215,24,284,523
Comal,406,County Tax Assessor-Collector,,REP,Patrick Aten,215,24,272,511
Comal,406,County Tax Assessor-Collector,,REP,Cast Votes:,430,48,556,1034
Comal,406,County Tax Assessor-Collector,,REP,Under Votes,37,8,31,76
Comal,406,County Tax Assessor-Collector,,REP,Over Votes,0,0,0,0
Comal,406,"Constable, Precinct No. 4",,REP,Shane Rapp,316,33,384,733
Comal,406,"Constable, Precinct No. 4",,REP,Jerry Airola,108,13,157,278
Comal,406,"Constable, Precinct No. 4",,REP,Cast Votes:,424,46,541,1011
Comal,406,"Constable, Precinct No. 4",,REP,Under Votes,43,10,46,99
Comal,406,"Constable, Precinct No. 4",,REP,Over Votes,0,0,0,0
Comal,406,County Chairman,,REP,Sue Piner,392,39,487,918
Comal,406,County Chairman,,REP,Cast Votes:,392,39,487,918
Comal,406,County Chairman,,REP,Under Votes,75,17,100,192
Comal,406,County Chairman,,REP,Over Votes,0,0,0,0
Comal,406,Proposition 1,,REP,Yes,424,49,524,997
Comal,406,Proposition 1,,REP,No,32,4,48,84
Comal,406,Proposition 1,,REP,Cast Votes:,456,53,572,1081
Comal,406,Proposition 1,,REP,Under Votes,11,3,15,29
Comal,406,Proposition 1,,REP,Over Votes,0,0,0,0
Comal,406,Proposition 2,,REP,Yes,388,46,495,929
Comal,406,Proposition 2,,REP,No,71,7,74,152
Comal,406,Proposition 2,,REP,Cast Votes:,459,53,569,1081
Comal,406,Proposition 2,,REP,Under Votes,8,3,18,29
Comal,406,Proposition 2,,REP,Over Votes,0,0,0,0
Comal,406,Proposition 3,,REP,Yes,427,54,539,1020
Comal,406,Proposition 3,,REP,No,26,0,27,53
Comal,406,Proposition 3,,REP,Cast Votes:,453,54,566,1073
Comal,406,Proposition 3,,REP,Under Votes,14,2,21,37
Comal,406,Proposition 3,,REP,Over Votes,0,0,0,0
Comal,406,Proposition 4,,REP,Yes,434,49,529,1012
Comal,406,Proposition 4,,REP,No,25,2,37,64
Comal,406,Proposition 4,,REP,Cast Votes:,459,51,566,1076
Comal,406,Proposition 4,,REP,Under Votes,8,5,21,34
Comal,406,Proposition 4,,REP,Over Votes,0,0,0,0
Comal,406,Proposition 5,,REP,Yes,414,45,513,972
Comal,406,Proposition 5,,REP,No,41,8,52,101
Comal,406,Proposition 5,,REP,Cast Votes:,455,53,565,1073
Comal,406,Proposition 5,,REP,Under Votes,12,3,22,37
Comal,406,Proposition 5,,REP,Over Votes,0,0,0,0
Comal,406,Proposition 6,,REP,Yes,424,54,537,1015
Comal,406,Proposition 6,,REP,No,25,0,25,50
Comal,406,Proposition 6,,REP,Cast Votes:,449,54,562,1065
Comal,406,Proposition 6,,REP,Under Votes,18,2,25,45
Comal,406,Proposition 6,,REP,Over Votes,0,0,0,0
Comal,406,Proposition 7,,REP,Yes,445,52,547,1044
Comal,406,Proposition 7,,REP,No,5,1,22,28
Comal,406,Proposition 7,,REP,Cast Votes:,450,53,569,1072
Comal,406,Proposition 7,,REP,Under Votes,17,3,18,38
Comal,406,Proposition 7,,REP,Over Votes,0,0,0,0
Comal,406,Proposition 8,,REP,Yes,452,52,553,1057
Comal,406,Proposition 8,,REP,No,4,3,15,22
Comal,406,Proposition 8,,REP,Cast Votes:,456,55,568,1079
Comal,406,Proposition 8,,REP,Under Votes,11,1,19,31
Comal,406,Proposition 8,,REP,Over Votes,0,0,0,0
Comal,406,Proposition 9,,REP,Yes,435,55,542,1032
Comal,406,Proposition 9,,REP,No,18,0,17,35
Comal,406,Proposition 9,,REP,Cast Votes:,453,55,559,1067
Comal,406,Proposition 9,,REP,Under Votes,14,1,28,43
Comal,406,Proposition 9,,REP,Over Votes,0,0,0,0
Comal,406,Proposition 10,,REP,Yes,414,51,538,1003
Comal,406,Proposition 10,,REP,No,36,2,31,69
Comal,406,Proposition 10,,REP,Cast Votes:,450,53,569,1072
Comal,406,Proposition 10,,REP,Under Votes,17,3,18,38
Comal,406,Proposition 10,,REP,Over Votes,0,0,0,0
Comal,102,President,,REP,Zoltan G. Istvan,1,0,0,1
Comal,102,President,,REP,Bill Weld,1,0,5,6
Comal,102,President,,REP,"Roque ""Rocky"" De La Fuente Guerra",0,0,0,0
Comal,102,President,,REP,Matthew John Matern,1,0,0,1
Comal,102,President,,REP,Donald J. Trump,300,21,519,840
Comal,102,President,,REP,Joe Walsh,0,0,1,1
Comal,102,President,,REP,Bob Ely,0,0,0,0
Comal,102,President,,REP,Uncommitted,6,1,4,11
Comal,102,Ballots Cast,,REP,,309,22,529,860
Comal,102,President,,REP,Under Votes,0,0,2,2
Comal,102,President,,REP,Over Votes,0,0,0,0
Comal,102,U.S. Senate,,REP,John Anthony Castro,11,0,10,21
Comal,102,U.S. Senate,,REP,Virgil Bierschwale,3,1,2,6
Comal,102,U.S. Senate,,REP,John Cornyn,232,15,422,669
Comal,102,U.S. Senate,,REP,Mark Yancey,14,2,26,42
Comal,102,U.S. Senate,,REP,Dwayne Stovall,30,3,46,79
Comal,102,U.S. Senate,,REP,Cast Votes:,290,21,506,817
Comal,102,U.S. Senate,,REP,Under Votes,19,1,25,45
Comal,102,U.S. Senate,,REP,Over Votes,0,0,0,0
Comal,102,U.S. House,21,REP,Chip Roy,288,20,503,811
Comal,102,U.S. House,21,REP,Cast Votes:,288,20,503,811
Comal,102,U.S. House,21,REP,Under Votes,21,2,28,51
Comal,102,U.S. House,21,REP,Over Votes,0,0,0,0
Comal,102,Railroad Commissioner,,REP,"James ""Jim"" Wright",149,12,266,427
Comal,102,Railroad Commissioner,,REP,Ryan Sitton,112,7,219,338
Comal,102,Railroad Commissioner,,REP,Cast Votes:,261,19,485,765
Comal,102,Railroad Commissioner,,REP,Under Votes,48,3,46,97
Comal,102,Railroad Commissioner,,REP,Over Votes,0,0,0,0
Comal,102,"Chief Justice, Supreme Court",,REP,Nathan Hecht,259,20,478,757
Comal,102,"Chief Justice, Supreme Court",,REP,Cast Votes:,259,20,478,757
Comal,102,"Chief Justice, Supreme Court",,REP,Under Votes,50,2,53,105
Comal,102,"Chief Justice, Supreme Court",,REP,Over Votes,0,0,0,0
Comal,102,"Justice, Supreme Court, Place 6 Unexpired Term",,REP,Jane Bland,260,20,468,748
Comal,102,"Justice, Supreme Court, Place 6 Unexpired Term",,REP,Cast Votes:,260,20,468,748
Comal,102,"Justice, Supreme Court, Place 6 Unexpired Term",,REP,Under Votes,49,2,63,114
Comal,102,"Justice, Supreme Court, Place 6 Unexpired Term",,REP,Over Votes,0,0,0,0
Comal,102,"Justice, Supreme Court, Place 7",,REP,Jeff Boyd,259,20,472,751
Comal,102,"Justice, Supreme Court, Place 7",,REP,Cast Votes:,259,20,472,751
Comal,102,"Justice, Supreme Court, Place 7",,REP,Under Votes,50,2,59,111
Comal,102,"Justice, Supreme Court, Place 7",,REP,Over Votes,0,0,0,0
Comal,102,"Justice, Supreme Court, Place 8",,REP,Brett Busby,257,20,467,744
Comal,102,"Justice, Supreme Court, Place 8",,REP,Cast Votes:,257,20,467,744
Comal,102,"Justice, Supreme Court, Place 8",,REP,Under Votes,52,2,64,118
Comal,102,"Justice, Supreme Court, Place 8",,REP,Over Votes,0,0,0,0
Comal,102,"Judge, Court of Criminal Appeals, Place 3",,REP,Gina Parker,124,10,206,340
Comal,102,"Judge, Court of Criminal Appeals, Place 3",,REP,Bert Richardson,133,10,257,400
Comal,102,"Judge, Court of Criminal Appeals, Place 3",,REP,Cast Votes:,257,20,463,740
Comal,102,"Judge, Court of Criminal Appeals, Place 3",,REP,Under Votes,52,2,68,122
Comal,102,"Judge, Court of Criminal Appeals, Place 3",,REP,Over Votes,0,0,0,0
Comal,102,"Judge, Court of Criminal Appeals, Place 4",,REP,Kevin Patrick Yeary,252,20,469,741
Comal,102,"Judge, Court of Criminal Appeals, Place 4",,REP,Cast Votes:,252,20,469,741
Comal,102,"Judge, Court of Criminal Appeals, Place 4",,REP,Under Votes,57,2,62,121
Comal,102,"Judge, Court of Criminal Appeals, Place 4",,REP,Over Votes,0,0,0,0
Comal,102,"Judge, Court of Criminal Appeals, Place 9",,REP,David Newell,254,20,456,730
Comal,102,"Judge, Court of Criminal Appeals, Place 9",,REP,Cast Votes:,254,20,456,730
Comal,102,"Judge, Court of Criminal Appeals, Place 9",,REP,Under Votes,55,2,75,132
Comal,102,"Judge, Court of Criminal Appeals, Place 9",,REP,Over Votes,0,0,0,0
Comal,102,"Member, State Board of Education, District 5",,REP,Lani Popp,91,12,194,297
Comal,102,"Member, State Board of Education, District 5",,REP,Inga Cotton,61,1,112,174
Comal,102,"Member, State Board of Education, District 5",,REP,Robert Morrow,111,6,164,281
Comal,102,"Member, State Board of Education, District 5",,REP,Cast Votes:,263,19,470,752
Comal,102,"Member, State Board of Education, District 5",,REP,Under Votes,46,3,61,110
Comal,102,"Member, State Board of Education, District 5",,REP,Over Votes,0,0,0,0
Comal,102,State Representative,73,REP,Kyle Biedermann,264,20,483,767
Comal,102,State Representative,73,REP,Cast Votes:,264,20,483,767
Comal,102,State Representative,73,REP,Under Votes,45,2,48,95
Comal,102,State Representative,73,REP,Over Votes,0,0,0,0
Comal,102,"Chief Justice, 3rd Court of Appeals District",,REP,Jeff Rose,251,20,468,739
Comal,102,"Chief Justice, 3rd Court of Appeals District",,REP,Cast Votes:,251,20,468,739
Comal,102,"Chief Justice, 3rd Court of Appeals District",,REP,Under Votes,58,2,63,123
Comal,102,"Chief Justice, 3rd Court of Appeals District",,REP,Over Votes,0,0,0,0
Comal,102,"District Judge, 22nd Judicial District",,REP,R. Bruce Boyer,252,20,469,741
Comal,102,"District Judge, 22nd Judicial District",,REP,Cast Votes:,252,20,469,741
Comal,102,"District Judge, 22nd Judicial District",,REP,Under Votes,57,2,62,121
Comal,102,"District Judge, 22nd Judicial District",,REP,Over Votes,0,0,0,0
Comal,102,"District Judge, 433rd Judicial District",,REP,Dib Waldrip,169,18,296,483
Comal,102,"District Judge, 433rd Judicial District",,REP,Charlie Sullivan,98,4,181,283
Comal,102,"District Judge, 433rd Judicial District",,REP,Cast Votes:,267,22,477,766
Comal,102,"District Judge, 433rd Judicial District",,REP,Under Votes,42,0,54,96
Comal,102,"District Judge, 433rd Judicial District",,REP,Over Votes,0,0,0,0
Comal,102,"Judge, County Court at Law No. 2",,REP,"Charles A. Stephens, II",251,20,462,733
Comal,102,"Judge, County Court at Law No. 2",,REP,Cast Votes:,251,20,462,733
Comal,102,"Judge, County Court at Law No. 2",,REP,Under Votes,58,2,69,129
Comal,102,"Judge, County Court at Law No. 2",,REP,Over Votes,0,0,0,0
Comal,102,"Judge, County Court at Law No. 3",,REP,Deborah Linnartz Wigington,247,20,459,726
Comal,102,"Judge, County Court at Law No. 3",,REP,Cast Votes:,247,20,459,726
Comal,102,"Judge, County Court at Law No. 3",,REP,Under Votes,62,2,72,136
Comal,102,"Judge, County Court at Law No. 3",,REP,Over Votes,0,0,0,0
Comal,102,Sheriff,,REP,Mark Reynolds,263,20,471,754
Comal,102,Sheriff,,REP,Cast Votes:,263,20,471,754
Comal,102,Sheriff,,REP,Under Votes,46,2,60,108
Comal,102,Sheriff,,REP,Over Votes,0,0,0,0
Comal,102,County Tax Assessor-Collector,,REP,Kristen H. Hoyt,196,14,329,539
Comal,102,County Tax Assessor-Collector,,REP,Patrick Aten,65,8,150,223
Comal,102,County Tax Assessor-Collector,,REP,Cast Votes:,261,22,479,762
Comal,102,County Tax Assessor-Collector,,REP,Under Votes,48,0,52,100
Comal,102,County Tax Assessor-Collector,,REP,Over Votes,0,0,0,0
Comal,102,"County Commissioner, Precinct 1",,REP,Richard K. Smith,136,10,258,404
Comal,102,"County Commissioner, Precinct 1",,REP,Donna Eccleston,127,12,213,352
Comal,102,"County Commissioner, Precinct 1",,REP,Cast Votes:,263,22,471,756
Comal,102,"County Commissioner, Precinct 1",,REP,Under Votes,46,0,60,106
Comal,102,"County Commissioner, Precinct 1",,REP,Over Votes,0,0,0,0
Comal,102,"Constable, Precinct No. 1",,REP,Christopher Braun,91,7,190,288
Comal,102,"Constable, Precinct No. 1",,REP,Charlie Motz,161,15,269,445
Comal,102,"Constable, Precinct No. 1",,REP,Cast Votes:,252,22,459,733
Comal,102,"Constable, Precinct No. 1",,REP,Under Votes,57,0,72,129
Comal,102,"Constable, Precinct No. 1",,REP,Over Votes,0,0,0,0
Comal,102,County Chairman,,REP,Sue Piner,242,20,461,723
Comal,102,County Chairman,,REP,Cast Votes:,242,20,461,723
Comal,102,County Chairman,,REP,Under Votes,67,2,70,139
Comal,102,County Chairman,,REP,Over Votes,0,0,0,0
Comal,102,Proposition 1,,REP,Yes,276,19,480,775
Comal,102,Proposition 1,,REP,No,25,3,41,69
Comal,102,Proposition 1,,REP,Cast Votes:,301,22,521,844
Comal,102,Proposition 1,,REP,Under Votes,8,0,10,18
Comal,102,Proposition 1,,REP,Over Votes,0,0,0,0
Comal,102,Proposition 2,,REP,Yes,275,20,475,770
Comal,102,Proposition 2,,REP,No,29,2,47,78
Comal,102,Proposition 2,,REP,Cast Votes:,304,22,522,848
Comal,102,Proposition 2,,REP,Under Votes,5,0,9,14
Comal,102,Proposition 2,,REP,Over Votes,0,0,0,0
Comal,102,Proposition 3,,REP,Yes,290,20,508,818
Comal,102,Proposition 3,,REP,No,14,2,11,27
Comal,102,Proposition 3,,REP,Cast Votes:,304,22,519,845
Comal,102,Proposition 3,,REP,Under Votes,5,0,12,17
Comal,102,Proposition 3,,REP,Over Votes,0,0,0,0
Comal,102,Proposition 4,,REP,Yes,287,21,513,821
Comal,102,Proposition 4,,REP,No,16,1,12,29
Comal,102,Proposition 4,,REP,Cast Votes:,303,22,525,850
Comal,102,Proposition 4,,REP,Under Votes,6,0,6,12
Comal,102,Proposition 4,,REP,Over Votes,0,0,0,0
Comal,102,Proposition 5,,REP,Yes,276,21,482,779
Comal,102,Proposition 5,,REP,No,24,1,35,60
Comal,102,Proposition 5,,REP,Cast Votes:,300,22,517,839
Comal,102,Proposition 5,,REP,Under Votes,9,0,14,23
Comal,102,Proposition 5,,REP,Over Votes,0,0,0,0
Comal,102,Proposition 6,,REP,Yes,289,19,495,803
Comal,102,Proposition 6,,REP,No,13,3,20,36
Comal,102,Proposition 6,,REP,Cast Votes:,302,22,515,839
Comal,102,Proposition 6,,REP,Under Votes,7,0,16,23
Comal,102,Proposition 6,,REP,Over Votes,0,0,0,0
Comal,102,Proposition 7,,REP,Yes,296,21,510,827
Comal,102,Proposition 7,,REP,No,6,1,14,21
Comal,102,Proposition 7,,REP,Cast Votes:,302,22,524,848
Comal,102,Proposition 7,,REP,Under Votes,7,0,7,14
Comal,102,Proposition 7,,REP,Over Votes,0,0,0,0
Comal,102,Proposition 8,,REP,Yes,300,22,525,847
Comal,102,Proposition 8,,REP,No,3,0,1,4
Comal,102,Proposition 8,,REP,Cast Votes:,303,22,526,851
Comal,102,Proposition 8,,REP,Under Votes,6,0,5,11
Comal,102,Proposition 8,,REP,Over Votes,0,0,0,0
Comal,102,Proposition 9,,REP,Yes,283,20,504,807
Comal,102,Proposition 9,,REP,No,16,2,15,33
Comal,102,Proposition 9,,REP,Cast Votes:,299,22,519,840
Comal,102,Proposition 9,,REP,Under Votes,10,0,12,22
Comal,102,Proposition 9,,REP,Over Votes,0,0,0,0
Comal,102,Proposition 10,,REP,Yes,285,22,483,790
Comal,102,Proposition 10,,REP,No,15,0,31,46
Comal,102,Proposition 10,,REP,Cast Votes:,300,22,514,836
Comal,102,Proposition 10,,REP,Under Votes,9,0,17,26
Comal,102,Proposition 10,,REP,Over Votes,0,0,0,0
Comal,407,President,,REP,Zoltan G. Istvan,0,0,0,0
Comal,407,President,,REP,Bill Weld,3,0,2,5
Comal,407,President,,REP,"Roque ""Rocky"" De La Fuente Guerra",0,0,1,1
Comal,407,President,,REP,Matthew John Matern,0,0,0,0
Comal,407,President,,REP,Donald J. Trump,403,15,410,828
Comal,407,President,,REP,Joe Walsh,3,0,2,5
Comal,407,President,,REP,Bob Ely,0,0,0,0
Comal,407,President,,REP,Uncommitted,19,0,14,33
Comal,407,Ballots Cast,,REP,,428,15,429,872
Comal,407,President,,REP,Under Votes,2,0,4,6
Comal,407,President,,REP,Over Votes,0,0,0,0
Comal,407,U.S. Senate,,REP,John Anthony Castro,25,0,14,39
Comal,407,U.S. Senate,,REP,Virgil Bierschwale,4,0,0,4
Comal,407,U.S. Senate,,REP,John Cornyn,295,13,356,664
Comal,407,U.S. Senate,,REP,Mark Yancey,17,1,10,28
Comal,407,U.S. Senate,,REP,Dwayne Stovall,54,1,43,98
Comal,407,U.S. Senate,,REP,Cast Votes:,395,15,423,833
Comal,407,U.S. Senate,,REP,Under Votes,35,0,10,45
Comal,407,U.S. Senate,,REP,Over Votes,0,0,0,0
Comal,407,U.S. House,21,REP,Chip Roy,405,12,421,838
Comal,407,U.S. House,21,REP,Cast Votes:,405,12,421,838
Comal,407,U.S. House,21,REP,Under Votes,25,3,12,40
Comal,407,U.S. House,21,REP,Over Votes,0,0,0,0
Comal,407,Railroad Commissioner,,REP,"James ""Jim"" Wright",233,5,202,440
Comal,407,Railroad Commissioner,,REP,Ryan Sitton,137,9,194,340
Comal,407,Railroad Commissioner,,REP,Cast Votes:,370,14,396,780
Comal,407,Railroad Commissioner,,REP,Under Votes,60,1,37,98
Comal,407,Railroad Commissioner,,REP,Over Votes,0,0,0,0
Comal,407,"Chief Justice, Supreme Court",,REP,Nathan Hecht,387,11,402,800
Comal,407,"Chief Justice, Supreme Court",,REP,Cast Votes:,387,11,402,800
Comal,407,"Chief Justice, Supreme Court",,REP,Under Votes,43,4,31,78
Comal,407,"Chief Justice, Supreme Court",,REP,Over Votes,0,0,0,0
Comal,407,"Justice, Supreme Court, Place 6 Unexpired Term",,REP,Jane Bland,378,11,397,786
Comal,407,"Justice, Supreme Court, Place 6 Unexpired Term",,REP,Cast Votes:,378,11,397,786
Comal,407,"Justice, Supreme Court, Place 6 Unexpired Term",,REP,Under Votes,52,4,36,92
Comal,407,"Justice, Supreme Court, Place 6 Unexpired Term",,REP,Over Votes,0,0,0,0
Comal,407,"Justice, Supreme Court, Place 7",,REP,Jeff Boyd,382,11,397,790
Comal,407,"Justice, Supreme Court, Place 7",,REP,Cast Votes:,382,11,397,790
Comal,407,"Justice, Supreme Court, Place 7",,REP,Under Votes,48,4,36,88
Comal,407,"Justice, Supreme Court, Place 7",,REP,Over Votes,0,0,0,0
Comal,407,"Justice, Supreme Court, Place 8",,REP,Brett Busby,381,11,395,787
Comal,407,"Justice, Supreme Court, Place 8",,REP,Cast Votes:,381,11,395,787
Comal,407,"Justice, Supreme Court, Place 8",,REP,Under Votes,49,4,38,91
Comal,407,"Justice, Supreme Court, Place 8",,REP,Over Votes,0,0,0,0
Comal,407,"Judge, Court of Criminal Appeals, Place 3",,REP,Gina Parker,195,5,176,376
Comal,407,"Judge, Court of Criminal Appeals, Place 3",,REP,Bert Richardson,166,9,207,382
Comal,407,"Judge, Court of Criminal Appeals, Place 3",,REP,Cast Votes:,361,14,383,758
Comal,407,"Judge, Court of Criminal Appeals, Place 3",,REP,Under Votes,69,1,50,120
Comal,407,"Judge, Court of Criminal Appeals, Place 3",,REP,Over Votes,0,0,0,0
Comal,407,"Judge, Court of Criminal Appeals, Place 4",,REP,Kevin Patrick Yeary,376,11,388,775
Comal,407,"Judge, Court of Criminal Appeals, Place 4",,REP,Cast Votes:,376,11,388,775
Comal,407,"Judge, Court of Criminal Appeals, Place 4",,REP,Under Votes,54,4,45,103
Comal,407,"Judge, Court of Criminal Appeals, Place 4",,REP,Over Votes,0,0,0,0
Comal,407,"Judge, Court of Criminal Appeals, Place 9",,REP,David Newell,381,11,385,777
Comal,407,"Judge, Court of Criminal Appeals, Place 9",,REP,Cast Votes:,381,11,385,777
Comal,407,"Judge, Court of Criminal Appeals, Place 9",,REP,Under Votes,49,4,48,101
Comal,407,"Judge, Court of Criminal Appeals, Place 9",,REP,Over Votes,0,0,0,0
Comal,407,"Member, State Board of Education, District 5",,REP,Lani Popp,114,4,166,284
Comal,407,"Member, State Board of Education, District 5",,REP,Inga Cotton,85,4,78,167
Comal,407,"Member, State Board of Education, District 5",,REP,Robert Morrow,157,6,133,296
Comal,407,"Member, State Board of Education, District 5",,REP,Cast Votes:,356,14,377,747
Comal,407,"Member, State Board of Education, District 5",,REP,Under Votes,74,1,56,131
Comal,407,"Member, State Board of Education, District 5",,REP,Over Votes,0,0,0,0
Comal,407,State Representative,73,REP,Kyle Biedermann,383,12,406,801
Comal,407,State Representative,73,REP,Cast Votes:,383,12,406,801
Comal,407,State Representative,73,REP,Under Votes,47,3,27,77
Comal,407,State Representative,73,REP,Over Votes,0,0,0,0
Comal,407,"Chief Justice, 3rd Court of Appeals District",,REP,Jeff Rose,376,11,391,778
Comal,407,"Chief Justice, 3rd Court of Appeals District",,REP,Cast Votes:,376,11,391,778
Comal,407,"Chief Justice, 3rd Court of Appeals District",,REP,Under Votes,54,4,42,100
Comal,407,"Chief Justice, 3rd Court of Appeals District",,REP,Over Votes,0,0,0,0
Comal,407,"District Judge, 22nd Judicial District",,REP,R. Bruce Boyer,377,11,396,784
Comal,407,"District Judge, 22nd Judicial District",,REP,Cast Votes:,377,11,396,784
Comal,407,"District Judge, 22nd Judicial District",,REP,Under Votes,53,4,37,94
Comal,407,"District Judge, 22nd Judicial District",,REP,Over Votes,0,0,0,0
Comal,407,"District Judge, 433rd Judicial District",,REP,Dib Waldrip,290,10,331,631
Comal,407,"District Judge, 433rd Judicial District",,REP,Charlie Sullivan,102,4,79,185
Comal,407,"District Judge, 433rd Judicial District",,REP,Cast Votes:,392,14,410,816
Comal,407,"District Judge, 433rd Judicial District",,REP,Under Votes,38,1,23,62
Comal,407,"District Judge, 433rd Judicial District",,REP,Over Votes,0,0,0,0
Comal,407,"Judge, County Court at Law No. 2",,REP,"Charles A. Stephens, II",379,10,391,780
Comal,407,"Judge, County Court at Law No. 2",,REP,Cast Votes:,379,10,391,780
Comal,407,"Judge, County Court at Law No. 2",,REP,Under Votes,51,5,42,98
Comal,407,"Judge, County Court at Law No. 2",,REP,Over Votes,0,0,0,0
Comal,407,"Judge, County Court at Law No. 3",,REP,Deborah Linnartz Wigington,380,11,394,785
Comal,407,"Judge, County Court at Law No. 3",,REP,Cast Votes:,380,11,394,785
Comal,407,"Judge, County Court at Law No. 3",,REP,Under Votes,50,4,39,93
Comal,407,"Judge, County Court at Law No. 3",,REP,Over Votes,0,0,0,0
Comal,407,Sheriff,,REP,Mark Reynolds,384,11,401,796
Comal,407,Sheriff,,REP,Cast Votes:,384,11,401,796
Comal,407,Sheriff,,REP,Under Votes,46,4,32,82
Comal,407,Sheriff,,REP,Over Votes,0,0,0,0
Comal,407,County Tax Assessor-Collector,,REP,Kristen H. Hoyt,252,9,212,473
Comal,407,County Tax Assessor-Collector,,REP,Patrick Aten,129,5,202,336
Comal,407,County Tax Assessor-Collector,,REP,Cast Votes:,381,14,414,809
Comal,407,County Tax Assessor-Collector,,REP,Under Votes,49,1,19,69
Comal,407,County Tax Assessor-Collector,,REP,Over Votes,0,0,0,0
Comal,407,"Constable, Precinct No. 4",,REP,Shane Rapp,309,9,331,649
Comal,407,"Constable, Precinct No. 4",,REP,Jerry Airola,91,6,89,186
Comal,407,"Constable, Precinct No. 4",,REP,Cast Votes:,400,15,420,835
Comal,407,"Constable, Precinct No. 4",,REP,Under Votes,30,0,13,43
Comal,407,"Constable, Precinct No. 4",,REP,Over Votes,0,0,0,0
Comal,407,County Chairman,,REP,Sue Piner,374,11,389,774
Comal,407,County Chairman,,REP,Cast Votes:,374,11,389,774
Comal,407,County Chairman,,REP,Under Votes,56,4,44,104
Comal,407,County Chairman,,REP,Over Votes,0,0,0,0
Comal,407,Proposition 1,,REP,Yes,388,15,392,795
Comal,407,Proposition 1,,REP,No,38,0,31,69
Comal,407,Proposition 1,,REP,Cast Votes:,426,15,423,864
Comal,407,Proposition 1,,REP,Under Votes,4,0,10,14
Comal,407,Proposition 1,,REP,Over Votes,0,0,0,0
Comal,407,Proposition 2,,REP,Yes,368,14,381,763
Comal,407,Proposition 2,,REP,No,55,1,44,100
Comal,407,Proposition 2,,REP,Cast Votes:,423,15,425,863
Comal,407,Proposition 2,,REP,Under Votes,7,0,8,15
Comal,407,Proposition 2,,REP,Over Votes,0,0,0,0
Comal,407,Proposition 3,,REP,Yes,407,15,410,832
Comal,407,Proposition 3,,REP,No,13,0,12,25
Comal,407,Proposition 3,,REP,Cast Votes:,420,15,422,857
Comal,407,Proposition 3,,REP,Under Votes,10,0,11,21
Comal,407,Proposition 3,,REP,Over Votes,0,0,0,0
Comal,407,Proposition 4,,REP,Yes,404,14,403,821
Comal,407,Proposition 4,,REP,No,20,0,20,40
Comal,407,Proposition 4,,REP,Cast Votes:,424,14,423,861
Comal,407,Proposition 4,,REP,Under Votes,6,1,10,17
Comal,407,Proposition 4,,REP,Over Votes,0,0,0,0
Comal,407,Proposition 5,,REP,Yes,386,13,393,792
Comal,407,Proposition 5,,REP,No,35,2,31,68
Comal,407,Proposition 5,,REP,Cast Votes:,421,15,424,860
Comal,407,Proposition 5,,REP,Under Votes,9,0,9,18
Comal,407,Proposition 5,,REP,Over Votes,0,0,0,0
Comal,407,Proposition 6,,REP,Yes,397,15,399,811
Comal,407,Proposition 6,,REP,No,21,0,22,43
Comal,407,Proposition 6,,REP,Cast Votes:,418,15,421,854
Comal,407,Proposition 6,,REP,Under Votes,12,0,12,24
Comal,407,Proposition 6,,REP,Over Votes,0,0,0,0
Comal,407,Proposition 7,,REP,Yes,408,15,408,831
Comal,407,Proposition 7,,REP,No,13,0,16,29
Comal,407,Proposition 7,,REP,Cast Votes:,421,15,424,860
Comal,407,Proposition 7,,REP,Under Votes,9,0,9,18
Comal,407,Proposition 7,,REP,Over Votes,0,0,0,0
Comal,407,Proposition 8,,REP,Yes,416,15,421,852
Comal,407,Proposition 8,,REP,No,6,0,3,9
Comal,407,Proposition 8,,REP,Cast Votes:,422,15,424,861
Comal,407,Proposition 8,,REP,Under Votes,8,0,9,17
Comal,407,Proposition 8,,REP,Over Votes,0,0,0,0
Comal,407,Proposition 9,,REP,Yes,400,13,406,819
Comal,407,Proposition 9,,REP,No,19,2,18,39
Comal,407,Proposition 9,,REP,Cast Votes:,419,15,424,858
Comal,407,Proposition 9,,REP,Under Votes,11,0,9,20
Comal,407,Proposition 9,,REP,Over Votes,0,0,0,0
Comal,407,Proposition 10,,REP,Yes,394,13,400,807
Comal,407,Proposition 10,,REP,No,21,2,23,46
Comal,407,Proposition 10,,REP,Cast Votes:,415,15,423,853
Comal,407,Proposition 10,,REP,Under Votes,15,0,10,25
Comal,407,Proposition 10,,REP,Over Votes,0,0,0,0
Comal,103,President,,REP,Zoltan G. Istvan,0,0,0,0
Comal,103,President,,REP,Bill Weld,0,0,1,1
Comal,103,President,,REP,"Roque ""Rocky"" De La Fuente Guerra",0,1,1,2
Comal,103,President,,REP,Matthew John Matern,0,0,0,0
Comal,103,President,,REP,Donald J. Trump,368,27,488,883
Comal,103,President,,REP,Joe Walsh,0,0,3,3
Comal,103,President,,REP,Bob Ely,2,0,0,2
Comal,103,President,,REP,Uncommitted,22,1,21,44
Comal,103,Ballots Cast,,REP,,392,29,514,935
Comal,103,President,,REP,Under Votes,0,0,1,1
Comal,103,President,,REP,Over Votes,0,0,0,0
Comal,103,U.S. Senate,,REP,John Anthony Castro,19,0,10,29
Comal,103,U.S. Senate,,REP,Virgil Bierschwale,3,1,3,7
Comal,103,U.S. Senate,,REP,John Cornyn,298,27,440,765
Comal,103,U.S. Senate,,REP,Mark Yancey,14,0,9,23
Comal,103,U.S. Senate,,REP,Dwayne Stovall,23,0,31,54
Comal,103,U.S. Senate,,REP,Cast Votes:,357,28,493,878
Comal,103,U.S. Senate,,REP,Under Votes,35,1,22,58
Comal,103,U.S. Senate,,REP,Over Votes,0,0,0,0
Comal,103,U.S. House,21,REP,Chip Roy,354,26,483,863
Comal,103,U.S. House,21,REP,Cast Votes:,354,26,483,863
Comal,103,U.S. House,21,REP,Under Votes,38,3,32,73
Comal,103,U.S. House,21,REP,Over Votes,0,0,0,0
Comal,103,Railroad Commissioner,,REP,"James ""Jim"" Wright",187,14,235,436
Comal,103,Railroad Commissioner,,REP,Ryan Sitton,137,11,212,360
Comal,103,Railroad Commissioner,,REP,Cast Votes:,324,25,447,796
Comal,103,Railroad Commissioner,,REP,Under Votes,68,4,68,140
Comal,103,Railroad Commissioner,,REP,Over Votes,0,0,0,0
Comal,103,"Chief Justice, Supreme Court",,REP,Nathan Hecht,330,23,449,802
Comal,103,"Chief Justice, Supreme Court",,REP,Cast Votes:,330,23,449,802
Comal,103,"Chief Justice, Supreme Court",,REP,Under Votes,62,6,66,134
Comal,103,"Chief Justice, Supreme Court",,REP,Over Votes,0,0,0,0
Comal,103,"Justice, Supreme Court, Place 6 Unexpired Term",,REP,Jane Bland,328,23,445,796
Comal,103,"Justice, Supreme Court, Place 6 Unexpired Term",,REP,Cast Votes:,328,23,445,796
Comal,103,"Justice, Supreme Court, Place 6 Unexpired Term",,REP,Under Votes,64,6,70,140
Comal,103,"Justice, Supreme Court, Place 6 Unexpired Term",,REP,Over Votes,0,0,0,0
Comal,103,"Justice, Supreme Court, Place 7",,REP,Jeff Boyd,324,22,446,792
Comal,103,"Justice, Supreme Court, Place 7",,REP,Cast Votes:,324,22,446,792
Comal,103,"Justice, Supreme Court, Place 7",,REP,Under Votes,68,7,69,144
Comal,103,"Justice, Supreme Court, Place 7",,REP,Over Votes,0,0,0,0
Comal,103,"Justice, Supreme Court, Place 8",,REP,Brett Busby,325,23,438,786
Comal,103,"Justice, Supreme Court, Place 8",,REP,Cast Votes:,325,23,438,786
Comal,103,"Justice, Supreme Court, Place 8",,REP,Under Votes,67,6,77,150
Comal,103,"Justice, Supreme Court, Place 8",,REP,Over Votes,0,0,0,0
Comal,103,"Judge, Court of Criminal Appeals, Place 3",,REP,Gina Parker,161,15,215,391
Comal,103,"Judge, Court of Criminal Appeals, Place 3",,REP,Bert Richardson,153,11,219,383
Comal,103,"Judge, Court of Criminal Appeals, Place 3",,REP,Cast Votes:,314,26,434,774
Comal,103,"Judge, Court of Criminal Appeals, Place 3",,REP,Under Votes,78,3,81,162
Comal,103,"Judge, Court of Criminal Appeals, Place 3",,REP,Over Votes,0,0,0,0
Comal,103,"Judge, Court of Criminal Appeals, Place 4",,REP,Kevin Patrick Yeary,330,23,437,790
Comal,103,"Judge, Court of Criminal Appeals, Place 4",,REP,Cast Votes:,330,23,437,790
Comal,103,"Judge, Court of Criminal Appeals, Place 4",,REP,Under Votes,62,6,78,146
Comal,103,"Judge, Court of Criminal Appeals, Place 4",,REP,Over Votes,0,0,0,0
Comal,103,"Judge, Court of Criminal Appeals, Place 9",,REP,David Newell,329,23,436,788
Comal,103,"Judge, Court of Criminal Appeals, Place 9",,REP,Cast Votes:,329,23,436,788
Comal,103,"Judge, Court of Criminal Appeals, Place 9",,REP,Under Votes,63,6,79,148
Comal,103,"Judge, Court of Criminal Appeals, Place 9",,REP,Over Votes,0,0,0,0
Comal,103,"Member, State Board of Education, District 5",,REP,Lani Popp,108,4,189,301
Comal,103,"Member, State Board of Education, District 5",,REP,Inga Cotton,79,10,96,185
Comal,103,"Member, State Board of Education, District 5",,REP,Robert Morrow,130,11,152,293
Comal,103,"Member, State Board of Education, District 5",,REP,Cast Votes:,317,25,437,779
Comal,103,"Member, State Board of Education, District 5",,REP,Under Votes,75,4,78,157
Comal,103,"Member, State Board of Education, District 5",,REP,Over Votes,0,0,0,0
Comal,103,State Representative,73,REP,Kyle Biedermann,349,24,453,826
Comal,103,State Representative,73,REP,Cast Votes:,349,24,453,826
Comal,103,State Representative,73,REP,Under Votes,43,5,62,110
Comal,103,State Representative,73,REP,Over Votes,0,0,0,0
Comal,103,"Chief Justice, 3rd Court of Appeals District",,REP,Jeff Rose,333,23,439,795
Comal,103,"Chief Justice, 3rd Court of Appeals District",,REP,Cast Votes:,333,23,439,795
Comal,103,"Chief Justice, 3rd Court of Appeals District",,REP,Under Votes,59,6,76,141
Comal,103,"Chief Justice, 3rd Court of Appeals District",,REP,Over Votes,0,0,0,0
Comal,103,"District Judge, 22nd Judicial District",,REP,R. Bruce Boyer,347,23,459,829
Comal,103,"District Judge, 22nd Judicial District",,REP,Cast Votes:,347,23,459,829
Comal,103,"District Judge, 22nd Judicial District",,REP,Under Votes,45,6,56,107
Comal,103,"District Judge, 22nd Judicial District",,REP,Over Votes,0,0,0,0
Comal,103,"District Judge, 433rd Judicial District",,REP,Dib Waldrip,302,27,389,718
Comal,103,"District Judge, 433rd Judicial District",,REP,Charlie Sullivan,65,1,88,154
Comal,103,"District Judge, 433rd Judicial District",,REP,Cast Votes:,367,28,477,872
Comal,103,"District Judge, 433rd Judicial District",,REP,Under Votes,25,1,38,64
Comal,103,"District Judge, 433rd Judicial District",,REP,Over Votes,0,0,0,0
Comal,103,"Judge, County Court at Law No. 2",,REP,"Charles A. Stephens, II",337,23,451,811
Comal,103,"Judge, County Court at Law No. 2",,REP,Cast Votes:,337,23,451,811
Comal,103,"Judge, County Court at Law No. 2",,REP,Under Votes,55,6,64,125
Comal,103,"Judge, County Court at Law No. 2",,REP,Over Votes,0,0,0,0
Comal,103,"Judge, County Court at Law No. 3",,REP,Deborah Linnartz Wigington,339,24,440,803
Comal,103,"Judge, County Court at Law No. 3",,REP,Cast Votes:,339,24,440,803
Comal,103,"Judge, County Court at Law No. 3",,REP,Under Votes,53,5,75,133
Comal,103,"Judge, County Court at Law No. 3",,REP,Over Votes,0,0,0,0
Comal,103,Sheriff,,REP,Mark Reynolds,352,23,459,834
Comal,103,Sheriff,,REP,Cast Votes:,352,23,459,834
Comal,103,Sheriff,,REP,Under Votes,40,6,56,102
Comal,103,Sheriff,,REP,Over Votes,0,0,0,0
Comal,103,County Tax Assessor-Collector,,REP,Kristen H. Hoyt,186,11,208,405
Comal,103,County Tax Assessor-Collector,,REP,Patrick Aten,171,17,280,468
Comal,103,County Tax Assessor-Collector,,REP,Cast Votes:,357,28,488,873
Comal,103,County Tax Assessor-Collector,,REP,Under Votes,35,1,27,63
Comal,103,County Tax Assessor-Collector,,REP,Over Votes,0,0,0,0
Comal,103,"County Commissioner, Precinct 1",,REP,Richard K. Smith,135,11,172,318
Comal,103,"County Commissioner, Precinct 1",,REP,Donna Eccleston,215,16,309,540
Comal,103,"County Commissioner, Precinct 1",,REP,Cast Votes:,350,27,481,858
Comal,103,"County Commissioner, Precinct 1",,REP,Under Votes,42,2,34,78
Comal,103,"County Commissioner, Precinct 1",,REP,Over Votes,0,0,0,0
Comal,103,"Constable, Precinct No. 1",,REP,Christopher Braun,104,5,135,244
Comal,103,"Constable, Precinct No. 1",,REP,Charlie Motz,222,21,322,565
Comal,103,"Constable, Precinct No. 1",,REP,Cast Votes:,326,26,457,809
Comal,103,"Constable, Precinct No. 1",,REP,Under Votes,66,3,58,127
Comal,103,"Constable, Precinct No. 1",,REP,Over Votes,0,0,0,0
Comal,103,County Chairman,,REP,Sue Piner,324,23,432,779
Comal,103,County Chairman,,REP,Cast Votes:,324,23,432,779
Comal,103,County Chairman,,REP,Under Votes,68,6,83,157
Comal,103,County Chairman,,REP,Over Votes,0,0,0,0
Comal,103,Proposition 1,,REP,Yes,354,27,479,860
Comal,103,Proposition 1,,REP,No,29,2,28,59
Comal,103,Proposition 1,,REP,Cast Votes:,383,29,507,919
Comal,103,Proposition 1,,REP,Under Votes,9,0,8,17
Comal,103,Proposition 1,,REP,Over Votes,0,0,0,0
Comal,103,Proposition 2,,REP,Yes,335,25,449,809
Comal,103,Proposition 2,,REP,No,50,4,57,111
Comal,103,Proposition 2,,REP,Cast Votes:,385,29,506,920
Comal,103,Proposition 2,,REP,Under Votes,7,0,9,16
Comal,103,Proposition 2,,REP,Over Votes,0,0,0,0
Comal,103,Proposition 3,,REP,Yes,365,25,477,867
Comal,103,Proposition 3,,REP,No,16,3,20,39
Comal,103,Proposition 3,,REP,Cast Votes:,381,28,497,906
Comal,103,Proposition 3,,REP,Under Votes,11,1,18,30
Comal,103,Proposition 3,,REP,Over Votes,0,0,0,0
Comal,103,Proposition 4,,REP,Yes,362,27,479,868
Comal,103,Proposition 4,,REP,No,18,1,27,46
Comal,103,Proposition 4,,REP,Cast Votes:,380,28,506,914
Comal,103,Proposition 4,,REP,Under Votes,12,1,9,22
Comal,103,Proposition 4,,REP,Over Votes,0,0,0,0
Comal,103,Proposition 5,,REP,Yes,342,22,449,813
Comal,103,Proposition 5,,REP,No,36,6,48,90
Comal,103,Proposition 5,,REP,Cast Votes:,378,28,497,903
Comal,103,Proposition 5,,REP,Under Votes,14,1,18,33
Comal,103,Proposition 5,,REP,Over Votes,0,0,0,0
Comal,103,Proposition 6,,REP,Yes,364,27,473,864
Comal,103,Proposition 6,,REP,No,19,1,23,43
Comal,103,Proposition 6,,REP,Cast Votes:,383,28,496,907
Comal,103,Proposition 6,,REP,Under Votes,9,1,19,29
Comal,103,Proposition 6,,REP,Over Votes,0,0,0,0
Comal,103,Proposition 7,,REP,Yes,369,26,484,879
Comal,103,Proposition 7,,REP,No,13,2,21,36
Comal,103,Proposition 7,,REP,Cast Votes:,382,28,505,915
Comal,103,Proposition 7,,REP,Under Votes,10,1,10,21
Comal,103,Proposition 7,,REP,Over Votes,0,0,0,0
Comal,103,Proposition 8,,REP,Yes,377,27,501,905
Comal,103,Proposition 8,,REP,No,4,0,5,9
Comal,103,Proposition 8,,REP,Cast Votes:,381,27,506,914
Comal,103,Proposition 8,,REP,Under Votes,11,2,9,22
Comal,103,Proposition 8,,REP,Over Votes,0,0,0,0
Comal,103,Proposition 9,,REP,Yes,367,26,479,872
Comal,103,Proposition 9,,REP,No,13,0,21,34
Comal,103,Proposition 9,,REP,Cast Votes:,380,26,500,906
Comal,103,Proposition 9,,REP,Under Votes,12,3,15,30
Comal,103,Proposition 9,,REP,Over Votes,0,0,0,0
Comal,103,Proposition 10,,REP,Yes,356,26,457,839
Comal,103,Proposition 10,,REP,No,23,1,44,68
Comal,103,Proposition 10,,REP,Cast Votes:,379,27,501,907
Comal,103,Proposition 10,,REP,Under Votes,13,2,14,29
Comal,103,Proposition 10,,REP,Over Votes,0,0,0,0
Comal,104,President,,REP,Zoltan G. Istvan,0,0,0,0
Comal,104,President,,REP,Bill Weld,4,0,1,5
Comal,104,President,,REP,"Roque ""Rocky"" De La Fuente Guerra",0,0,1,1
Comal,104,President,,REP,Matthew John Matern,0,0,0,0
Comal,104,President,,REP,Donald J. Trump,202,19,311,532
Comal,104,President,,REP,Joe Walsh,1,0,2,3
Comal,104,President,,REP,Bob Ely,2,0,0,2
Comal,104,President,,REP,Uncommitted,9,0,12,21
Comal,104,Ballots Cast,,REP,,218,19,327,564
Comal,104,President,,REP,Under Votes,1,2,0,3
Comal,104,President,,REP,Over Votes,0,1,0,1
Comal,104,U.S. Senate,,REP,John Anthony Castro,11,0,11,22
Comal,104,U.S. Senate,,REP,Virgil Bierschwale,2,0,5,7
Comal,104,U.S. Senate,,REP,John Cornyn,146,16,261,423
Comal,104,U.S. Senate,,REP,Mark Yancey,12,1,11,24
Comal,104,U.S. Senate,,REP,Dwayne Stovall,31,2,24,57
Comal,104,U.S. Senate,,REP,Cast Votes:,202,19,312,533
Comal,104,U.S. Senate,,REP,Under Votes,17,3,15,35
Comal,104,U.S. Senate,,REP,Over Votes,0,0,0,0
Comal,104,U.S. House,21,REP,Chip Roy,200,21,305,526
Comal,104,U.S. House,21,REP,Cast Votes:,200,21,305,526
Comal,104,U.S. House,21,REP,Under Votes,19,1,22,42
Comal,104,U.S. House,21,REP,Over Votes,0,0,0,0
Comal,104,Railroad Commissioner,,REP,"James ""Jim"" Wright",107,17,137,261
Comal,104,Railroad Commissioner,,REP,Ryan Sitton,81,5,143,229
Comal,104,Railroad Commissioner,,REP,Cast Votes:,188,22,280,490
Comal,104,Railroad Commissioner,,REP,Under Votes,31,0,47,78
Comal,104,Railroad Commissioner,,REP,Over Votes,0,0,0,0
Comal,104,"Chief Justice, Supreme Court",,REP,Nathan Hecht,184,20,282,486
Comal,104,"Chief Justice, Supreme Court",,REP,Cast Votes:,184,20,282,486
Comal,104,"Chief Justice, Supreme Court",,REP,Under Votes,35,2,45,82
Comal,104,"Chief Justice, Supreme Court",,REP,Over Votes,0,0,0,0
Comal,104,"Justice, Supreme Court, Place 6 Unexpired Term",,REP,Jane Bland,179,20,277,476
Comal,104,"Justice, Supreme Court, Place 6 Unexpired Term",,REP,Cast Votes:,179,20,277,476
Comal,104,"Justice, Supreme Court, Place 6 Unexpired Term",,REP,Under Votes,40,2,50,92
Comal,104,"Justice, Supreme Court, Place 6 Unexpired Term",,REP,Over Votes,0,0,0,0
Comal,104,"Justice, Supreme Court, Place 7",,REP,Jeff Boyd,181,20,280,481
Comal,104,"Justice, Supreme Court, Place 7",,REP,Cast Votes:,181,20,280,481
Comal,104,"Justice, Supreme Court, Place 7",,REP,Under Votes,38,2,47,87
Comal,104,"Justice, Supreme Court, Place 7",,REP,Over Votes,0,0,0,0
Comal,104,"Justice, Supreme Court, Place 8",,REP,Brett Busby,181,19,278,478
Comal,104,"Justice, Supreme Court, Place 8",,REP,Cast Votes:,181,19,278,478
Comal,104,"Justice, Supreme Court, Place 8",,REP,Under Votes,38,3,49,90
Comal,104,"Justice, Supreme Court, Place 8",,REP,Over Votes,0,0,0,0
Comal,104,"Judge, Court of Criminal Appeals, Place 3",,REP,Gina Parker,89,10,132,231
Comal,104,"Judge, Court of Criminal Appeals, Place 3",,REP,Bert Richardson,91,10,151,252
Comal,104,"Judge, Court of Criminal Appeals, Place 3",,REP,Cast Votes:,180,20,283,483
Comal,104,"Judge, Court of Criminal Appeals, Place 3",,REP,Under Votes,39,2,44,85
Comal,104,"Judge, Court of Criminal Appeals, Place 3",,REP,Over Votes,0,0,0,0
Comal,104,"Judge, Court of Criminal Appeals, Place 4",,REP,Kevin Patrick Yeary,182,20,275,477
Comal,104,"Judge, Court of Criminal Appeals, Place 4",,REP,Cast Votes:,182,20,275,477
Comal,104,"Judge, Court of Criminal Appeals, Place 4",,REP,Under Votes,37,2,52,91
Comal,104,"Judge, Court of Criminal Appeals, Place 4",,REP,Over Votes,0,0,0,0
Comal,104,"Judge, Court of Criminal Appeals, Place 9",,REP,David Newell,177,19,278,474
Comal,104,"Judge, Court of Criminal Appeals, Place 9",,REP,Cast Votes:,177,19,278,474
Comal,104,"Judge, Court of Criminal Appeals, Place 9",,REP,Under Votes,42,3,49,94
Comal,104,"Judge, Court of Criminal Appeals, Place 9",,REP,Over Votes,0,0,0,0
Comal,104,"Member, State Board of Education, District 5",,REP,Lani Popp,57,11,119,187
Comal,104,"Member, State Board of Education, District 5",,REP,Inga Cotton,47,2,63,112
Comal,104,"Member, State Board of Education, District 5",,REP,Robert Morrow,77,9,88,174
Comal,104,"Member, State Board of Education, District 5",,REP,Cast Votes:,181,22,270,473
Comal,104,"Member, State Board of Education, District 5",,REP,Under Votes,38,0,57,95
Comal,104,"Member, State Board of Education, District 5",,REP,Over Votes,0,0,0,0
Comal,104,State Representative,73,REP,Kyle Biedermann,186,22,298,506
Comal,104,State Representative,73,REP,Cast Votes:,186,22,298,506
Comal,104,State Representative,73,REP,Under Votes,33,0,29,62
Comal,104,State Representative,73,REP,Over Votes,0,0,0,0
Comal,104,"Chief Justice, 3rd Court of Appeals District",,REP,Jeff Rose,178,20,274,472
Comal,104,"Chief Justice, 3rd Court of Appeals District",,REP,Cast Votes:,178,20,274,472
Comal,104,"Chief Justice, 3rd Court of Appeals District",,REP,Under Votes,41,2,53,96
Comal,104,"Chief Justice, 3rd Court of Appeals District",,REP,Over Votes,0,0,0,0
Comal,104,"District Judge, 22nd Judicial District",,REP,R. Bruce Boyer,177,20,281,478
Comal,104,"District Judge, 22nd Judicial District",,REP,Cast Votes:,177,20,281,478
Comal,104,"District Judge, 22nd Judicial District",,REP,Under Votes,42,2,46,90
Comal,104,"District Judge, 22nd Judicial District",,REP,Over Votes,0,0,0,0
Comal,104,"District Judge, 433rd Judicial District",,REP,Dib Waldrip,124,13,236,373
Comal,104,"District Judge, 433rd Judicial District",,REP,Charlie Sullivan,72,9,77,158
Comal,104,"District Judge, 433rd Judicial District",,REP,Cast Votes:,196,22,313,531
Comal,104,"District Judge, 433rd Judicial District",,REP,Under Votes,23,0,14,37
Comal,104,"District Judge, 433rd Judicial District",,REP,Over Votes,0,0,0,0
Comal,104,"Judge, County Court at Law No. 2",,REP,"Charles A. Stephens, II",185,19,287,491
Comal,104,"Judge, County Court at Law No. 2",,REP,Cast Votes:,185,19,287,491
Comal,104,"Judge, County Court at Law No. 2",,REP,Under Votes,34,3,40,77
Comal,104,"Judge, County Court at Law No. 2",,REP,Over Votes,0,0,0,0
Comal,104,"Judge, County Court at Law No. 3",,REP,Deborah Linnartz Wigington,174,19,273,466
Comal,104,"Judge, County Court at Law No. 3",,REP,Cast Votes:,174,19,273,466
Comal,104,"Judge, County Court at Law No. 3",,REP,Under Votes,45,3,54,102
Comal,104,"Judge, County Court at Law No. 3",,REP,Over Votes,0,0,0,0
Comal,104,Sheriff,,REP,Mark Reynolds,193,20,301,514
Comal,104,Sheriff,,REP,Cast Votes:,193,20,301,514
Comal,104,Sheriff,,REP,Under Votes,26,2,26,54
Comal,104,Sheriff,,REP,Over Votes,0,0,0,0
Comal,104,County Tax Assessor-Collector,,REP,Kristen H. Hoyt,123,10,156,289
Comal,104,County Tax Assessor-Collector,,REP,Patrick Aten,70,12,143,225
Comal,104,County Tax Assessor-Collector,,REP,Cast Votes:,193,22,299,514
Comal,104,County Tax Assessor-Collector,,REP,Under Votes,26,0,28,54
Comal,104,County Tax Assessor-Collector,,REP,Over Votes,0,0,0,0
Comal,104,"County Commissioner, Precinct 1",,REP,Richard K. Smith,80,13,146,239
Comal,104,"County Commissioner, Precinct 1",,REP,Donna Eccleston,116,9,166,291
Comal,104,"County Commissioner, Precinct 1",,REP,Cast Votes:,196,22,312,530
Comal,104,"County Commissioner, Precinct 1",,REP,Under Votes,23,0,15,38
Comal,104,"County Commissioner, Precinct 1",,REP,Over Votes,0,0,0,0
Comal,104,"Constable, Precinct No. 1",,REP,Christopher Braun,70,8,77,155
Comal,104,"Constable, Precinct No. 1",,REP,Charlie Motz,110,13,211,334
Comal,104,"Constable, Precinct No. 1",,REP,Cast Votes:,180,21,288,489
Comal,104,"Constable, Precinct No. 1",,REP,Under Votes,39,1,39,79
Comal,104,"Constable, Precinct No. 1",,REP,Over Votes,0,0,0,0
Comal,104,County Chairman,,REP,Sue Piner,172,21,270,463
Comal,104,County Chairman,,REP,Cast Votes:,172,21,270,463
Comal,104,County Chairman,,REP,Under Votes,47,1,57,105
Comal,104,County Chairman,,REP,Over Votes,0,0,0,0
Comal,104,Proposition 1,,REP,Yes,182,21,298,501
Comal,104,Proposition 1,,REP,No,32,0,23,55
Comal,104,Proposition 1,,REP,Cast Votes:,214,21,321,556
Comal,104,Proposition 1,,REP,Under Votes,5,1,6,12
Comal,104,Proposition 1,,REP,Over Votes,0,0,0,0
Comal,104,Proposition 2,,REP,Yes,182,21,283,486
Comal,104,Proposition 2,,REP,No,35,0,37,72
Comal,104,Proposition 2,,REP,Cast Votes:,217,21,320,558
Comal,104,Proposition 2,,REP,Under Votes,2,1,7,10
Comal,104,Proposition 2,,REP,Over Votes,0,0,0,0
Comal,104,Proposition 3,,REP,Yes,208,21,312,541
Comal,104,Proposition 3,,REP,No,9,0,9,18
Comal,104,Proposition 3,,REP,Cast Votes:,217,21,321,559
Comal,104,Proposition 3,,REP,Under Votes,2,1,6,9
Comal,104,Proposition 3,,REP,Over Votes,0,0,0,0
Comal,104,Proposition 4,,REP,Yes,202,21,295,518
Comal,104,Proposition 4,,REP,No,13,0,20,33
Comal,104,Proposition 4,,REP,Cast Votes:,215,21,315,551
Comal,104,Proposition 4,,REP,Under Votes,4,1,12,17
Comal,104,Proposition 4,,REP,Over Votes,0,0,0,0
Comal,104,Proposition 5,,REP,Yes,198,20,280,498
Comal,104,Proposition 5,,REP,No,17,1,38,56
Comal,104,Proposition 5,,REP,Cast Votes:,215,21,318,554
Comal,104,Proposition 5,,REP,Under Votes,4,1,9,14
Comal,104,Proposition 5,,REP,Over Votes,0,0,0,0
Comal,104,Proposition 6,,REP,Yes,198,21,301,520
Comal,104,Proposition 6,,REP,No,13,0,18,31
Comal,104,Proposition 6,,REP,Cast Votes:,211,21,319,551
Comal,104,Proposition 6,,REP,Under Votes,8,1,8,17
Comal,104,Proposition 6,,REP,Over Votes,0,0,0,0
Comal,104,Proposition 7,,REP,Yes,212,21,304,537
Comal,104,Proposition 7,,REP,No,5,0,16,21
Comal,104,Proposition 7,,REP,Cast Votes:,217,21,320,558
Comal,104,Proposition 7,,REP,Under Votes,2,1,7,10
Comal,104,Proposition 7,,REP,Over Votes,0,0,0,0
Comal,104,Proposition 8,,REP,Yes,213,21,316,550
Comal,104,Proposition 8,,REP,No,2,0,3,5
Comal,104,Proposition 8,,REP,Cast Votes:,215,21,319,555
Comal,104,Proposition 8,,REP,Under Votes,4,1,8,13
Comal,104,Proposition 8,,REP,Over Votes,0,0,0,0
Comal,104,Proposition 9,,REP,Yes,203,21,308,532
Comal,104,Proposition 9,,REP,No,11,0,13,24
Comal,104,Proposition 9,,REP,Cast Votes:,214,21,321,556
Comal,104,Proposition 9,,REP,Under Votes,5,1,6,12
Comal,104,Proposition 9,,REP,Over Votes,0,0,0,0
Comal,104,Proposition 10,,REP,Yes,202,21,299,522
Comal,104,Proposition 10,,REP,No,12,0,24,36
Comal,104,Proposition 10,,REP,Cast Votes:,214,21,323,558
Comal,104,Proposition 10,,REP,Under Votes,5,1,4,10
Comal,104,Proposition 10,,REP,Over Votes,0,0,0,0
Comal,105,President,,REP,Zoltan G. Istvan,0,0,0,0
Comal,105,President,,REP,Bill Weld,5,1,4,10
Comal,105,President,,REP,"Roque ""Rocky"" De La Fuente Guerra",0,0,0,0
Comal,105,President,,REP,Matthew John Matern,0,0,1,1
Comal,105,President,,REP,Donald J. Trump,344,21,411,776
Comal,105,President,,REP,Joe Walsh,2,1,2,5
Comal,105,President,,REP,Bob Ely,0,0,1,1
Comal,105,President,,REP,Uncommitted,14,1,16,31
Comal,105,Ballots Cast,,REP,,365,24,435,824
Comal,105,President,,REP,Under Votes,1,0,1,2
Comal,105,President,,REP,Over Votes,0,0,0,0
Comal,105,U.S. Senate,,REP,John Anthony Castro,24,1,17,42
Comal,105,U.S. Senate,,REP,Virgil Bierschwale,4,0,1,5
Comal,105,U.S. Senate,,REP,John Cornyn,264,20,350,634
Comal,105,U.S. Senate,,REP,Mark Yancey,10,0,21,31
Comal,105,U.S. Senate,,REP,Dwayne Stovall,45,3,39,87
Comal,105,U.S. Senate,,REP,Cast Votes:,347,24,428,799
Comal,105,U.S. Senate,,REP,Under Votes,19,0,8,27
Comal,105,U.S. Senate,,REP,Over Votes,0,0,0,0
Comal,105,U.S. House,21,REP,Chip Roy,340,20,414,774
Comal,105,U.S. House,21,REP,Cast Votes:,340,20,414,774
Comal,105,U.S. House,21,REP,Under Votes,26,4,22,52
Comal,105,U.S. House,21,REP,Over Votes,0,0,0,0
Comal,105,Railroad Commissioner,,REP,"James ""Jim"" Wright",192,8,226,426
Comal,105,Railroad Commissioner,,REP,Ryan Sitton,137,15,178,330
Comal,105,Railroad Commissioner,,REP,Cast Votes:,329,23,404,756
Comal,105,Railroad Commissioner,,REP,Under Votes,37,1,32,70
Comal,105,Railroad Commissioner,,REP,Over Votes,0,0,0,0
Comal,105,"Chief Justice, Supreme Court",,REP,Nathan Hecht,322,20,394,736
Comal,105,"Chief Justice, Supreme Court",,REP,Cast Votes:,322,20,394,736
Comal,105,"Chief Justice, Supreme Court",,REP,Under Votes,44,4,42,90
Comal,105,"Chief Justice, Supreme Court",,REP,Over Votes,0,0,0,0
Comal,105,"Justice, Supreme Court, Place 6 Unexpired Term",,REP,Jane Bland,316,20,392,728
Comal,105,"Justice, Supreme Court, Place 6 Unexpired Term",,REP,Cast Votes:,316,20,392,728
Comal,105,"Justice, Supreme Court, Place 6 Unexpired Term",,REP,Under Votes,50,4,44,98
Comal,105,"Justice, Supreme Court, Place 6 Unexpired Term",,REP,Over Votes,0,0,0,0
Comal,105,"Justice, Supreme Court, Place 7",,REP,Jeff Boyd,320,20,391,731
Comal,105,"Justice, Supreme Court, Place 7",,REP,Cast Votes:,320,20,391,731
Comal,105,"Justice, Supreme Court, Place 7",,REP,Under Votes,46,4,45,95
Comal,105,"Justice, Supreme Court, Place 7",,REP,Over Votes,0,0,0,0
Comal,105,"Justice, Supreme Court, Place 8",,REP,Brett Busby,319,20,388,727
Comal,105,"Justice, Supreme Court, Place 8",,REP,Cast Votes:,319,20,388,727
Comal,105,"Justice, Supreme Court, Place 8",,REP,Under Votes,47,4,48,99
Comal,105,"Justice, Supreme Court, Place 8",,REP,Over Votes,0,0,0,0
Comal,105,"Judge, Court of Criminal Appeals, Place 3",,REP,Gina Parker,157,11,180,348
Comal,105,"Judge, Court of Criminal Appeals, Place 3",,REP,Bert Richardson,164,12,215,391
Comal,105,"Judge, Court of Criminal Appeals, Place 3",,REP,Cast Votes:,321,23,395,739
Comal,105,"Judge, Court of Criminal Appeals, Place 3",,REP,Under Votes,45,1,41,87
Comal,105,"Judge, Court of Criminal Appeals, Place 3",,REP,Over Votes,0,0,0,0
Comal,105,"Judge, Court of Criminal Appeals, Place 4",,REP,Kevin Patrick Yeary,315,20,386,721
Comal,105,"Judge, Court of Criminal Appeals, Place 4",,REP,Cast Votes:,315,20,386,721
Comal,105,"Judge, Court of Criminal Appeals, Place 4",,REP,Under Votes,51,4,50,105
Comal,105,"Judge, Court of Criminal Appeals, Place 4",,REP,Over Votes,0,0,0,0
Comal,105,"Judge, Court of Criminal Appeals, Place 9",,REP,David Newell,313,20,381,714
Comal,105,"Judge, Court of Criminal Appeals, Place 9",,REP,Cast Votes:,313,20,381,714
Comal,105,"Judge, Court of Criminal Appeals, Place 9",,REP,Under Votes,53,4,55,112
Comal,105,"Judge, Court of Criminal Appeals, Place 9",,REP,Over Votes,0,0,0,0
Comal,105,"Member, State Board of Education, District 5",,REP,Lani Popp,83,11,151,245
Comal,105,"Member, State Board of Education, District 5",,REP,Inga Cotton,81,8,98,187
Comal,105,"Member, State Board of Education, District 5",,REP,Robert Morrow,160,4,145,309
Comal,105,"Member, State Board of Education, District 5",,REP,Cast Votes:,324,23,394,741
Comal,105,"Member, State Board of Education, District 5",,REP,Under Votes,42,1,42,85
Comal,105,"Member, State Board of Education, District 5",,REP,Over Votes,0,0,0,0
Comal,105,State Representative,73,REP,Kyle Biedermann,329,19,399,747
Comal,105,State Representative,73,REP,Cast Votes:,329,19,399,747
Comal,105,State Representative,73,REP,Under Votes,37,5,37,79
Comal,105,State Representative,73,REP,Over Votes,0,0,0,0
Comal,105,"Chief Justice, 3rd Court of Appeals District",,REP,Jeff Rose,315,20,387,722
Comal,105,"Chief Justice, 3rd Court of Appeals District",,REP,Cast Votes:,315,20,387,722
Comal,105,"Chief Justice, 3rd Court of Appeals District",,REP,Under Votes,51,4,49,104
Comal,105,"Chief Justice, 3rd Court of Appeals District",,REP,Over Votes,0,0,0,0
Comal,105,"District Judge, 22nd Judicial District",,REP,R. Bruce Boyer,320,20,385,725
Comal,105,"District Judge, 22nd Judicial District",,REP,Cast Votes:,320,20,385,725
Comal,105,"District Judge, 22nd Judicial District",,REP,Under Votes,46,4,51,101
Comal,105,"District Judge, 22nd Judicial District",,REP,Over Votes,0,0,0,0
Comal,105,"District Judge, 433rd Judicial District",,REP,Dib Waldrip,201,19,284,504
Comal,105,"District Judge, 433rd Judicial District",,REP,Charlie Sullivan,148,5,143,296
Comal,105,"District Judge, 433rd Judicial District",,REP,Cast Votes:,349,24,427,800
Comal,105,"District Judge, 433rd Judicial District",,REP,Under Votes,17,0,9,26
Comal,105,"District Judge, 433rd Judicial District",,REP,Over Votes,0,0,0,0
Comal,105,"Judge, County Court at Law No. 2",,REP,"Charles A. Stephens, II",322,20,391,733
Comal,105,"Judge, County Court at Law No. 2",,REP,Cast Votes:,322,20,391,733
Comal,105,"Judge, County Court at Law No. 2",,REP,Under Votes,44,4,45,93
Comal,105,"Judge, County Court at Law No. 2",,REP,Over Votes,0,0,0,0
Comal,105,"Judge, County Court at Law No. 3",,REP,Deborah Linnartz Wigington,313,21,384,718
Comal,105,"Judge, County Court at Law No. 3",,REP,Cast Votes:,313,21,384,718
Comal,105,"Judge, County Court at Law No. 3",,REP,Under Votes,53,3,52,108
Comal,105,"Judge, County Court at Law No. 3",,REP,Over Votes,0,0,0,0
Comal,105,Sheriff,,REP,Mark Reynolds,334,20,408,762
Comal,105,Sheriff,,REP,Cast Votes:,334,20,408,762
Comal,105,Sheriff,,REP,Under Votes,32,4,28,64
Comal,105,Sheriff,,REP,Over Votes,0,0,0,0
Comal,105,County Tax Assessor-Collector,,REP,Kristen H. Hoyt,211,13,251,475
Comal,105,County Tax Assessor-Collector,,REP,Patrick Aten,120,11,166,297
Comal,105,County Tax Assessor-Collector,,REP,Cast Votes:,331,24,417,772
Comal,105,County Tax Assessor-Collector,,REP,Under Votes,35,0,19,54
Comal,105,County Tax Assessor-Collector,,REP,Over Votes,0,0,0,0
Comal,105,"County Commissioner, Precinct 1",,REP,Richard K. Smith,182,9,235,426
Comal,105,"County Commissioner, Precinct 1",,REP,Donna Eccleston,158,14,193,365
Comal,105,"County Commissioner, Precinct 1",,REP,Cast Votes:,340,23,428,791
Comal,105,"County Commissioner, Precinct 1",,REP,Under Votes,26,1,8,35
Comal,105,"County Commissioner, Precinct 1",,REP,Over Votes,0,0,0,0
Comal,105,"Constable, Precinct No. 1",,REP,Christopher Braun,112,7,125,244
Comal,105,"Constable, Precinct No. 1",,REP,Charlie Motz,217,16,281,514
Comal,105,"Constable, Precinct No. 1",,REP,Cast Votes:,329,23,406,758
Comal,105,"Constable, Precinct No. 1",,REP,Under Votes,37,1,30,68
Comal,105,"Constable, Precinct No. 1",,REP,Over Votes,0,0,0,0
Comal,105,County Chairman,,REP,Sue Piner,309,20,385,714
Comal,105,County Chairman,,REP,Cast Votes:,309,20,385,714
Comal,105,County Chairman,,REP,Under Votes,57,4,51,112
Comal,105,County Chairman,,REP,Over Votes,0,0,0,0
Comal,105,Proposition 1,,REP,Yes,309,21,389,719
Comal,105,Proposition 1,,REP,No,50,3,39,92
Comal,105,Proposition 1,,REP,Cast Votes:,359,24,428,811
Comal,105,Proposition 1,,REP,Under Votes,7,0,8,15
Comal,105,Proposition 1,,REP,Over Votes,0,0,0,0
Comal,105,Proposition 2,,REP,Yes,314,18,391,723
Comal,105,Proposition 2,,REP,No,47,6,41,94
Comal,105,Proposition 2,,REP,Cast Votes:,361,24,432,817
Comal,105,Proposition 2,,REP,Under Votes,5,0,4,9
Comal,105,Proposition 2,,REP,Over Votes,0,0,0,0
Comal,105,Proposition 3,,REP,Yes,341,24,419,784
Comal,105,Proposition 3,,REP,No,19,0,13,32
Comal,105,Proposition 3,,REP,Cast Votes:,360,24,432,816
Comal,105,Proposition 3,,REP,Under Votes,6,0,4,10
Comal,105,Proposition 3,,REP,Over Votes,0,0,0,0
Comal,105,Proposition 4,,REP,Yes,337,21,416,774
Comal,105,Proposition 4,,REP,No,21,3,17,41
Comal,105,Proposition 4,,REP,Cast Votes:,358,24,433,815
Comal,105,Proposition 4,,REP,Under Votes,8,0,3,11
Comal,105,Proposition 4,,REP,Over Votes,0,0,0,0
Comal,105,Proposition 5,,REP,Yes,332,20,394,746
Comal,105,Proposition 5,,REP,No,26,4,36,66
Comal,105,Proposition 5,,REP,Cast Votes:,358,24,430,812
Comal,105,Proposition 5,,REP,Under Votes,8,0,6,14
Comal,105,Proposition 5,,REP,Over Votes,0,0,0,0
Comal,105,Proposition 6,,REP,Yes,342,20,408,770
Comal,105,Proposition 6,,REP,No,17,4,22,43
Comal,105,Proposition 6,,REP,Cast Votes:,359,24,430,813
Comal,105,Proposition 6,,REP,Under Votes,7,0,6,13
Comal,105,Proposition 6,,REP,Over Votes,0,0,0,0
Comal,105,Proposition 7,,REP,Yes,352,20,419,791
Comal,105,Proposition 7,,REP,No,11,4,11,26
Comal,105,Proposition 7,,REP,Cast Votes:,363,24,430,817
Comal,105,Proposition 7,,REP,Under Votes,3,0,6,9
Comal,105,Proposition 7,,REP,Over Votes,0,0,0,0
Comal,105,Proposition 8,,REP,Yes,355,22,428,805
Comal,105,Proposition 8,,REP,No,3,2,5,10
Comal,105,Proposition 8,,REP,Cast Votes:,358,24,433,815
Comal,105,Proposition 8,,REP,Under Votes,8,0,3,11
Comal,105,Proposition 8,,REP,Over Votes,0,0,0,0
Comal,105,Proposition 9,,REP,Yes,347,24,413,784
Comal,105,Proposition 9,,REP,No,11,0,18,29
Comal,105,Proposition 9,,REP,Cast Votes:,358,24,431,813
Comal,105,Proposition 9,,REP,Under Votes,8,0,5,13
Comal,105,Proposition 9,,REP,Over Votes,0,0,0,0
Comal,105,Proposition 10,,REP,Yes,346,23,418,787
Comal,105,Proposition 10,,REP,No,16,1,15,32
Comal,105,Proposition 10,,REP,Cast Votes:,362,24,433,819
Comal,105,Proposition 10,,REP,Under Votes,4,0,3,7
Comal,105,Proposition 10,,REP,Over Votes,0,0,0,0
Comal,106,President,,REP,Zoltan G. Istvan,1,0,0,1
Comal,106,President,,REP,Bill Weld,3,0,3,6
Comal,106,President,,REP,"Roque ""Rocky"" De La Fuente Guerra",2,0,1,3
Comal,106,President,,REP,Matthew John Matern,1,0,1,2
Comal,106,President,,REP,Donald J. Trump,393,29,649,1071
Comal,106,President,,REP,Joe Walsh,1,0,6,7
Comal,106,President,,REP,Bob Ely,0,0,1,1
Comal,106,President,,REP,Uncommitted,8,1,14,23
Comal,106,Ballots Cast,,REP,,409,30,675,1114
Comal,106,President,,REP,Under Votes,1,0,3,4
Comal,106,President,,REP,Over Votes,0,0,0,0
Comal,106,U.S. Senate,,REP,John Anthony Castro,22,0,12,34
Comal,106,U.S. Senate,,REP,Virgil Bierschwale,3,0,6,9
Comal,106,U.S. Senate,,REP,John Cornyn,299,27,556,882
Comal,106,U.S. Senate,,REP,Mark Yancey,16,0,26,42
Comal,106,U.S. Senate,,REP,Dwayne Stovall,39,2,58,99
Comal,106,U.S. Senate,,REP,Cast Votes:,379,29,658,1066
Comal,106,U.S. Senate,,REP,Under Votes,31,1,20,52
Comal,106,U.S. Senate,,REP,Over Votes,0,0,0,0
Comal,106,U.S. House,21,REP,Chip Roy,390,29,641,1060
Comal,106,U.S. House,21,REP,Cast Votes:,390,29,641,1060
Comal,106,U.S. House,21,REP,Under Votes,20,1,37,58
Comal,106,U.S. House,21,REP,Over Votes,0,0,0,0
Comal,106,Railroad Commissioner,,REP,"James ""Jim"" Wright",217,15,307,539
Comal,106,Railroad Commissioner,,REP,Ryan Sitton,145,14,309,468
Comal,106,Railroad Commissioner,,REP,Cast Votes:,362,29,616,1007
Comal,106,Railroad Commissioner,,REP,Under Votes,48,1,62,111
Comal,106,Railroad Commissioner,,REP,Over Votes,0,0,0,0
Comal,106,"Chief Justice, Supreme Court",,REP,Nathan Hecht,372,27,606,1005
Comal,106,"Chief Justice, Supreme Court",,REP,Cast Votes:,372,27,606,1005
Comal,106,"Chief Justice, Supreme Court",,REP,Under Votes,38,3,72,113
Comal,106,"Chief Justice, Supreme Court",,REP,Over Votes,0,0,0,0
Comal,106,"Justice, Supreme Court, Place 6 Unexpired Term",,REP,Jane Bland,368,27,597,992
Comal,106,"Justice, Supreme Court, Place 6 Unexpired Term",,REP,Cast Votes:,368,27,597,992
Comal,106,"Justice, Supreme Court, Place 6 Unexpired Term",,REP,Under Votes,42,3,81,126
Comal,106,"Justice, Supreme Court, Place 6 Unexpired Term",,REP,Over Votes,0,0,0,0
Comal,106,"Justice, Supreme Court, Place 7",,REP,Jeff Boyd,367,27,600,994
Comal,106,"Justice, Supreme Court, Place 7",,REP,Cast Votes:,367,27,600,994
Comal,106,"Justice, Supreme Court, Place 7",,REP,Under Votes,43,3,78,124
Comal,106,"Justice, Supreme Court, Place 7",,REP,Over Votes,0,0,0,0
Comal,106,"Justice, Supreme Court, Place 8",,REP,Brett Busby,364,27,596,987
Comal,106,"Justice, Supreme Court, Place 8",,REP,Cast Votes:,364,27,596,987
Comal,106,"Justice, Supreme Court, Place 8",,REP,Under Votes,46,3,82,131
Comal,106,"Justice, Supreme Court, Place 8",,REP,Over Votes,0,0,0,0
Comal,106,"Judge, Court of Criminal Appeals, Place 3",,REP,Gina Parker,169,9,267,445
Comal,106,"Judge, Court of Criminal Appeals, Place 3",,REP,Bert Richardson,176,18,343,537
Comal,106,"Judge, Court of Criminal Appeals, Place 3",,REP,Cast Votes:,345,27,610,982
Comal,106,"Judge, Court of Criminal Appeals, Place 3",,REP,Under Votes,65,3,68,136
Comal,106,"Judge, Court of Criminal Appeals, Place 3",,REP,Over Votes,0,0,0,0
Comal,106,"Judge, Court of Criminal Appeals, Place 4",,REP,Kevin Patrick Yeary,362,27,587,976
Comal,106,"Judge, Court of Criminal Appeals, Place 4",,REP,Cast Votes:,362,27,587,976
Comal,106,"Judge, Court of Criminal Appeals, Place 4",,REP,Under Votes,48,3,91,142
Comal,106,"Judge, Court of Criminal Appeals, Place 4",,REP,Over Votes,0,0,0,0
Comal,106,"Judge, Court of Criminal Appeals, Place 9",,REP,David Newell,358,27,591,976
Comal,106,"Judge, Court of Criminal Appeals, Place 9",,REP,Cast Votes:,358,27,591,976
Comal,106,"Judge, Court of Criminal Appeals, Place 9",,REP,Under Votes,52,3,87,142
Comal,106,"Judge, Court of Criminal Appeals, Place 9",,REP,Over Votes,0,0,0,0
Comal,106,"Member, State Board of Education, District 5",,REP,Lani Popp,110,9,246,365
Comal,106,"Member, State Board of Education, District 5",,REP,Inga Cotton,84,8,124,216
Comal,106,"Member, State Board of Education, District 5",,REP,Robert Morrow,152,9,228,389
Comal,106,"Member, State Board of Education, District 5",,REP,Cast Votes:,346,26,598,970
Comal,106,"Member, State Board of Education, District 5",,REP,Under Votes,64,4,80,148
Comal,106,"Member, State Board of Education, District 5",,REP,Over Votes,0,0,0,0
Comal,106,State Representative,73,REP,Kyle Biedermann,373,28,604,1005
Comal,106,State Representative,73,REP,Cast Votes:,373,28,604,1005
Comal,106,State Representative,73,REP,Under Votes,37,2,74,113
Comal,106,State Representative,73,REP,Over Votes,0,0,0,0
Comal,106,"Chief Justice, 3rd Court of Appeals District",,REP,Jeff Rose,359,27,587,973
Comal,106,"Chief Justice, 3rd Court of Appeals District",,REP,Cast Votes:,359,27,587,973
Comal,106,"Chief Justice, 3rd Court of Appeals District",,REP,Under Votes,51,3,91,145
Comal,106,"Chief Justice, 3rd Court of Appeals District",,REP,Over Votes,0,0,0,0
Comal,106,"District Judge, 22nd Judicial District",,REP,R. Bruce Boyer,362,28,587,977
Comal,106,"District Judge, 22nd Judicial District",,REP,Cast Votes:,362,28,587,977
Comal,106,"District Judge, 22nd Judicial District",,REP,Under Votes,48,2,91,141
Comal,106,"District Judge, 22nd Judicial District",,REP,Over Votes,0,0,0,0
Comal,106,"District Judge, 433rd Judicial District",,REP,Dib Waldrip,257,26,418,701
Comal,106,"District Judge, 433rd Judicial District",,REP,Charlie Sullivan,110,4,198,312
Comal,106,"District Judge, 433rd Judicial District",,REP,Cast Votes:,367,30,616,1013
Comal,106,"District Judge, 433rd Judicial District",,REP,Under Votes,43,0,62,105
Comal,106,"District Judge, 433rd Judicial District",,REP,Over Votes,0,0,0,0
Comal,106,"Judge, County Court at Law No. 2",,REP,"Charles A. Stephens, II",361,28,582,971
Comal,106,"Judge, County Court at Law No. 2",,REP,Cast Votes:,361,28,582,971
Comal,106,"Judge, County Court at Law No. 2",,REP,Under Votes,49,2,96,147
Comal,106,"Judge, County Court at Law No. 2",,REP,Over Votes,0,0,0,0
Comal,106,"Judge, County Court at Law No. 3",,REP,Deborah Linnartz Wigington,361,27,576,964
Comal,106,"Judge, County Court at Law No. 3",,REP,Cast Votes:,361,27,576,964
Comal,106,"Judge, County Court at Law No. 3",,REP,Under Votes,49,3,102,154
Comal,106,"Judge, County Court at Law No. 3",,REP,Over Votes,0,0,0,0
Comal,106,Sheriff,,REP,Mark Reynolds,374,29,604,1007
Comal,106,Sheriff,,REP,Cast Votes:,374,29,604,1007
Comal,106,Sheriff,,REP,Under Votes,36,1,74,111
Comal,106,Sheriff,,REP,Over Votes,0,0,0,0
Comal,106,County Tax Assessor-Collector,,REP,Kristen H. Hoyt,263,16,352,631
Comal,106,County Tax Assessor-Collector,,REP,Patrick Aten,99,14,263,376
Comal,106,County Tax Assessor-Collector,,REP,Cast Votes:,362,30,615,1007
Comal,106,County Tax Assessor-Collector,,REP,Under Votes,48,0,63,111
Comal,106,County Tax Assessor-Collector,,REP,Over Votes,0,0,0,0
Comal,106,"County Commissioner, Precinct 1",,REP,Richard K. Smith,183,19,336,538
Comal,106,"County Commissioner, Precinct 1",,REP,Donna Eccleston,176,11,282,469
Comal,106,"County Commissioner, Precinct 1",,REP,Cast Votes:,359,30,618,1007
Comal,106,"County Commissioner, Precinct 1",,REP,Under Votes,51,0,60,111
Comal,106,"County Commissioner, Precinct 1",,REP,Over Votes,0,0,0,0
Comal,106,"Constable, Precinct No. 1",,REP,Christopher Braun,143,9,195,347
Comal,106,"Constable, Precinct No. 1",,REP,Charlie Motz,192,18,388,598
Comal,106,"Constable, Precinct No. 1",,REP,Cast Votes:,335,27,583,945
Comal,106,"Constable, Precinct No. 1",,REP,Under Votes,75,3,95,173
Comal,106,"Constable, Precinct No. 1",,REP,Over Votes,0,0,0,0
Comal,106,County Chairman,,REP,Sue Piner,359,27,576,962
Comal,106,County Chairman,,REP,Cast Votes:,359,27,576,962
Comal,106,County Chairman,,REP,Under Votes,51,3,102,156
Comal,106,County Chairman,,REP,Over Votes,0,0,0,0
Comal,106,Proposition 1,,REP,Yes,379,30,621,1030
Comal,106,Proposition 1,,REP,No,31,0,47,78
Comal,106,Proposition 1,,REP,Cast Votes:,410,30,668,1108
Comal,106,Proposition 1,,REP,Under Votes,0,0,10,10
Comal,106,Proposition 1,,REP,Over Votes,0,0,0,0
Comal,106,Proposition 2,,REP,Yes,360,29,600,989
Comal,106,Proposition 2,,REP,No,48,1,69,118
Comal,106,Proposition 2,,REP,Cast Votes:,408,30,669,1107
Comal,106,Proposition 2,,REP,Under Votes,2,0,9,11
Comal,106,Proposition 2,,REP,Over Votes,0,0,0,0
Comal,106,Proposition 3,,REP,Yes,391,30,642,1063
Comal,106,Proposition 3,,REP,No,15,0,22,37
Comal,106,Proposition 3,,REP,Cast Votes:,406,30,664,1100
Comal,106,Proposition 3,,REP,Under Votes,4,0,14,18
Comal,106,Proposition 3,,REP,Over Votes,0,0,0,0
Comal,106,Proposition 4,,REP,Yes,389,29,628,1046
Comal,106,Proposition 4,,REP,No,17,1,35,53
Comal,106,Proposition 4,,REP,Cast Votes:,406,30,663,1099
Comal,106,Proposition 4,,REP,Under Votes,4,0,15,19
Comal,106,Proposition 4,,REP,Over Votes,0,0,0,0
Comal,106,Proposition 5,,REP,Yes,373,29,599,1001
Comal,106,Proposition 5,,REP,No,32,1,62,95
Comal,106,Proposition 5,,REP,Cast Votes:,405,30,661,1096
Comal,106,Proposition 5,,REP,Under Votes,5,0,17,22
Comal,106,Proposition 5,,REP,Over Votes,0,0,0,0
Comal,106,Proposition 6,,REP,Yes,395,29,640,1064
Comal,106,Proposition 6,,REP,No,11,1,22,34
Comal,106,Proposition 6,,REP,Cast Votes:,406,30,662,1098
Comal,106,Proposition 6,,REP,Under Votes,4,0,16,20
Comal,106,Proposition 6,,REP,Over Votes,0,0,0,0
Comal,106,Proposition 7,,REP,Yes,392,28,635,1055
Comal,106,Proposition 7,,REP,No,15,1,29,45
Comal,106,Proposition 7,,REP,Cast Votes:,407,29,664,1100
Comal,106,Proposition 7,,REP,Under Votes,3,1,14,18
Comal,106,Proposition 7,,REP,Over Votes,0,0,0,0
Comal,106,Proposition 8,,REP,Yes,406,30,653,1089
Comal,106,Proposition 8,,REP,No,2,0,13,15
Comal,106,Proposition 8,,REP,Cast Votes:,408,30,666,1104
Comal,106,Proposition 8,,REP,Under Votes,2,0,12,14
Comal,106,Proposition 8,,REP,Over Votes,0,0,0,0
Comal,106,Proposition 9,,REP,Yes,378,30,628,1036
Comal,106,Proposition 9,,REP,No,27,0,33,60
Comal,106,Proposition 9,,REP,Cast Votes:,405,30,661,1096
Comal,106,Proposition 9,,REP,Under Votes,5,0,17,22
Comal,106,Proposition 9,,REP,Over Votes,0,0,0,0
Comal,106,Proposition 10,,REP,Yes,376,29,616,1021
Comal,106,Proposition 10,,REP,No,21,1,44,66
Comal,106,Proposition 10,,REP,Cast Votes:,397,30,660,1087
Comal,106,Proposition 10,,REP,Under Votes,13,0,18,31
Comal,106,Proposition 10,,REP,Over Votes,0,0,0,0
Comal,107,President,,REP,Zoltan G. Istvan,1,0,1,2
Comal,107,President,,REP,Bill Weld,2,0,4,6
Comal,107,President,,REP,"Roque ""Rocky"" De La Fuente Guerra",3,0,0,3
Comal,107,President,,REP,Matthew John Matern,1,0,0,1
Comal,107,President,,REP,Donald J. Trump,456,9,255,720
Comal,107,President,,REP,Joe Walsh,0,0,2,2
Comal,107,President,,REP,Bob Ely,1,0,1,2
Comal,107,President,,REP,Uncommitted,14,0,9,23
Comal,107,Ballots Cast,,REP,,478,9,272,759
Comal,107,President,,REP,Under Votes,3,0,0,3
Comal,107,President,,REP,Over Votes,0,0,0,0
Comal,107,U.S. Senate,,REP,John Anthony Castro,21,0,15,36
Comal,107,U.S. Senate,,REP,Virgil Bierschwale,4,0,2,6
Comal,107,U.S. Senate,,REP,John Cornyn,356,7,224,587
Comal,107,U.S. Senate,,REP,Mark Yancey,31,2,13,46
Comal,107,U.S. Senate,,REP,Dwayne Stovall,42,0,16,58
Comal,107,U.S. Senate,,REP,Cast Votes:,454,9,270,733
Comal,107,U.S. Senate,,REP,Under Votes,27,0,2,29
Comal,107,U.S. Senate,,REP,Over Votes,0,0,0,0
Comal,107,U.S. House,21,REP,Chip Roy,454,7,250,711
Comal,107,U.S. House,21,REP,Cast Votes:,454,7,250,711
Comal,107,U.S. House,21,REP,Under Votes,27,2,22,51
Comal,107,U.S. House,21,REP,Over Votes,0,0,0,0
Comal,107,Railroad Commissioner,,REP,"James ""Jim"" Wright",239,3,127,369
Comal,107,Railroad Commissioner,,REP,Ryan Sitton,185,6,117,308
Comal,107,Railroad Commissioner,,REP,Cast Votes:,424,9,244,677
Comal,107,Railroad Commissioner,,REP,Under Votes,57,0,28,85
Comal,107,Railroad Commissioner,,REP,Over Votes,0,0,0,0
Comal,107,"Chief Justice, Supreme Court",,REP,Nathan Hecht,440,7,245,692
Comal,107,"Chief Justice, Supreme Court",,REP,Cast Votes:,440,7,245,692
Comal,107,"Chief Justice, Supreme Court",,REP,Under Votes,41,2,27,70
Comal,107,"Chief Justice, Supreme Court",,REP,Over Votes,0,0,0,0
Comal,107,"Justice, Supreme Court, Place 6 Unexpired Term",,REP,Jane Bland,431,7,246,684
Comal,107,"Justice, Supreme Court, Place 6 Unexpired Term",,REP,Cast Votes:,431,7,246,684
Comal,107,"Justice, Supreme Court, Place 6 Unexpired Term",,REP,Under Votes,50,2,26,78
Comal,107,"Justice, Supreme Court, Place 6 Unexpired Term",,REP,Over Votes,0,0,0,0
Comal,107,"Justice, Supreme Court, Place 7",,REP,Jeff Boyd,431,7,246,684
Comal,107,"Justice, Supreme Court, Place 7",,REP,Cast Votes:,431,7,246,684
Comal,107,"Justice, Supreme Court, Place 7",,REP,Under Votes,50,2,26,78
Comal,107,"Justice, Supreme Court, Place 7",,REP,Over Votes,0,0,0,0
Comal,107,"Justice, Supreme Court, Place 8",,REP,Brett Busby,431,7,244,682
Comal,107,"Justice, Supreme Court, Place 8",,REP,Cast Votes:,431,7,244,682
Comal,107,"Justice, Supreme Court, Place 8",,REP,Under Votes,50,2,28,80
Comal,107,"Justice, Supreme Court, Place 8",,REP,Over Votes,0,0,0,0
Comal,107,"Judge, Court of Criminal Appeals, Place 3",,REP,Gina Parker,201,3,107,311
Comal,107,"Judge, Court of Criminal Appeals, Place 3",,REP,Bert Richardson,222,6,130,358
Comal,107,"Judge, Court of Criminal Appeals, Place 3",,REP,Cast Votes:,423,9,237,669
Comal,107,"Judge, Court of Criminal Appeals, Place 3",,REP,Under Votes,58,0,35,93
Comal,107,"Judge, Court of Criminal Appeals, Place 3",,REP,Over Votes,0,0,0,0
Comal,107,"Judge, Court of Criminal Appeals, Place 4",,REP,Kevin Patrick Yeary,428,7,246,681
Comal,107,"Judge, Court of Criminal Appeals, Place 4",,REP,Cast Votes:,428,7,246,681
Comal,107,"Judge, Court of Criminal Appeals, Place 4",,REP,Under Votes,53,2,26,81
Comal,107,"Judge, Court of Criminal Appeals, Place 4",,REP,Over Votes,0,0,0,0
Comal,107,"Judge, Court of Criminal Appeals, Place 9",,REP,David Newell,429,7,240,676
Comal,107,"Judge, Court of Criminal Appeals, Place 9",,REP,Cast Votes:,429,7,240,676
Comal,107,"Judge, Court of Criminal Appeals, Place 9",,REP,Under Votes,52,2,32,86
Comal,107,"Judge, Court of Criminal Appeals, Place 9",,REP,Over Votes,0,0,0,0
Comal,107,"Member, State Board of Education, District 5",,REP,Lani Popp,152,2,98,252
Comal,107,"Member, State Board of Education, District 5",,REP,Inga Cotton,88,2,64,154
Comal,107,"Member, State Board of Education, District 5",,REP,Robert Morrow,169,5,69,243
Comal,107,"Member, State Board of Education, District 5",,REP,Cast Votes:,409,9,231,649
Comal,107,"Member, State Board of Education, District 5",,REP,Under Votes,72,0,41,113
Comal,107,"Member, State Board of Education, District 5",,REP,Over Votes,0,0,0,0
Comal,107,State Representative,73,REP,Kyle Biedermann,439,7,246,692
Comal,107,State Representative,73,REP,Cast Votes:,439,7,246,692
Comal,107,State Representative,73,REP,Under Votes,42,2,26,70
Comal,107,State Representative,73,REP,Over Votes,0,0,0,0
Comal,107,"Chief Justice, 3rd Court of Appeals District",,REP,Jeff Rose,429,7,240,676
Comal,107,"Chief Justice, 3rd Court of Appeals District",,REP,Cast Votes:,429,7,240,676
Comal,107,"Chief Justice, 3rd Court of Appeals District",,REP,Under Votes,52,2,32,86
Comal,107,"Chief Justice, 3rd Court of Appeals District",,REP,Over Votes,0,0,0,0
Comal,107,"District Judge, 22nd Judicial District",,REP,R. Bruce Boyer,431,7,239,677
Comal,107,"District Judge, 22nd Judicial District",,REP,Cast Votes:,431,7,239,677
Comal,107,"District Judge, 22nd Judicial District",,REP,Under Votes,50,2,33,85
Comal,107,"District Judge, 22nd Judicial District",,REP,Over Votes,0,0,0,0
Comal,107,"District Judge, 433rd Judicial District",,REP,Dib Waldrip,330,5,177,512
Comal,107,"District Judge, 433rd Judicial District",,REP,Charlie Sullivan,118,4,69,191
Comal,107,"District Judge, 433rd Judicial District",,REP,Cast Votes:,448,9,246,703
Comal,107,"District Judge, 433rd Judicial District",,REP,Under Votes,33,0,26,59
Comal,107,"District Judge, 433rd Judicial District",,REP,Over Votes,0,0,0,0
Comal,107,"Judge, County Court at Law No. 2",,REP,"Charles A. Stephens, II",431,7,241,679
Comal,107,"Judge, County Court at Law No. 2",,REP,Cast Votes:,431,7,241,679
Comal,107,"Judge, County Court at Law No. 2",,REP,Under Votes,50,2,31,83
Comal,107,"Judge, County Court at Law No. 2",,REP,Over Votes,0,0,0,0
Comal,107,"Judge, County Court at Law No. 3",,REP,Deborah Linnartz Wigington,420,7,239,666
Comal,107,"Judge, County Court at Law No. 3",,REP,Cast Votes:,420,7,239,666
Comal,107,"Judge, County Court at Law No. 3",,REP,Under Votes,61,2,33,96
Comal,107,"Judge, County Court at Law No. 3",,REP,Over Votes,0,0,0,0
Comal,107,Sheriff,,REP,Mark Reynolds,440,7,248,695
Comal,107,Sheriff,,REP,Cast Votes:,440,7,248,695
Comal,107,Sheriff,,REP,Under Votes,41,2,24,67
Comal,107,Sheriff,,REP,Over Votes,0,0,0,0
Comal,107,County Tax Assessor-Collector,,REP,Kristen H. Hoyt,229,7,125,361
Comal,107,County Tax Assessor-Collector,,REP,Patrick Aten,203,2,122,327
Comal,107,County Tax Assessor-Collector,,REP,Cast Votes:,432,9,247,688
Comal,107,County Tax Assessor-Collector,,REP,Under Votes,49,0,25,74
Comal,107,County Tax Assessor-Collector,,REP,Over Votes,0,0,0,0
Comal,107,"County Commissioner, Precinct 1",,REP,Richard K. Smith,232,5,136,373
Comal,107,"County Commissioner, Precinct 1",,REP,Donna Eccleston,209,4,122,335
Comal,107,"County Commissioner, Precinct 1",,REP,Cast Votes:,441,9,258,708
Comal,107,"County Commissioner, Precinct 1",,REP,Under Votes,40,0,14,54
Comal,107,"County Commissioner, Precinct 1",,REP,Over Votes,0,0,0,0
Comal,107,"Constable, Precinct No. 1",,REP,Christopher Braun,147,6,85,238
Comal,107,"Constable, Precinct No. 1",,REP,Charlie Motz,272,3,153,428
Comal,107,"Constable, Precinct No. 1",,REP,Cast Votes:,419,9,238,666
Comal,107,"Constable, Precinct No. 1",,REP,Under Votes,62,0,34,96
Comal,107,"Constable, Precinct No. 1",,REP,Over Votes,0,0,0,0
Comal,107,County Chairman,,REP,Sue Piner,419,7,236,662
Comal,107,County Chairman,,REP,Cast Votes:,419,7,236,662
Comal,107,County Chairman,,REP,Under Votes,62,2,36,100
Comal,107,County Chairman,,REP,Over Votes,0,0,0,0
Comal,107,Proposition 1,,REP,Yes,441,9,248,698
Comal,107,Proposition 1,,REP,No,29,0,21,50
Comal,107,Proposition 1,,REP,Cast Votes:,470,9,269,748
Comal,107,Proposition 1,,REP,Under Votes,11,0,3,14
Comal,107,Proposition 1,,REP,Over Votes,0,0,0,0
Comal,107,Proposition 2,,REP,Yes,423,9,243,675
Comal,107,Proposition 2,,REP,No,50,0,25,75
Comal,107,Proposition 2,,REP,Cast Votes:,473,9,268,750
Comal,107,Proposition 2,,REP,Under Votes,8,0,4,12
Comal,107,Proposition 2,,REP,Over Votes,0,0,0,0
Comal,107,Proposition 3,,REP,Yes,452,9,264,725
Comal,107,Proposition 3,,REP,No,15,0,4,19
Comal,107,Proposition 3,,REP,Cast Votes:,467,9,268,744
Comal,107,Proposition 3,,REP,Under Votes,14,0,4,18
Comal,107,Proposition 3,,REP,Over Votes,0,0,0,0
Comal,107,Proposition 4,,REP,Yes,445,9,254,708
Comal,107,Proposition 4,,REP,No,28,0,14,42
Comal,107,Proposition 4,,REP,Cast Votes:,473,9,268,750
Comal,107,Proposition 4,,REP,Under Votes,8,0,4,12
Comal,107,Proposition 4,,REP,Over Votes,0,0,0,0
Comal,107,Proposition 5,,REP,Yes,425,9,245,679
Comal,107,Proposition 5,,REP,No,37,0,24,61
Comal,107,Proposition 5,,REP,Cast Votes:,462,9,269,740
Comal,107,Proposition 5,,REP,Under Votes,19,0,3,22
Comal,107,Proposition 5,,REP,Over Votes,0,0,0,0
Comal,107,Proposition 6,,REP,Yes,459,9,257,725
Comal,107,Proposition 6,,REP,No,17,0,12,29
Comal,107,Proposition 6,,REP,Cast Votes:,476,9,269,754
Comal,107,Proposition 6,,REP,Under Votes,5,0,3,8
Comal,107,Proposition 6,,REP,Over Votes,0,0,0,0
Comal,107,Proposition 7,,REP,Yes,443,9,258,710
Comal,107,Proposition 7,,REP,No,21,0,12,33
Comal,107,Proposition 7,,REP,Cast Votes:,464,9,270,743
Comal,107,Proposition 7,,REP,Under Votes,17,0,2,19
Comal,107,Proposition 7,,REP,Over Votes,0,0,0,0
Comal,107,Proposition 8,,REP,Yes,466,9,262,737
Comal,107,Proposition 8,,REP,No,9,0,6,15
Comal,107,Proposition 8,,REP,Cast Votes:,475,9,268,752
Comal,107,Proposition 8,,REP,Under Votes,6,0,4,10
Comal,107,Proposition 8,,REP,Over Votes,0,0,0,0
Comal,107,Proposition 9,,REP,Yes,435,9,253,697
Comal,107,Proposition 9,,REP,No,28,0,16,44
Comal,107,Proposition 9,,REP,Cast Votes:,463,9,269,741
Comal,107,Proposition 9,,REP,Under Votes,18,0,3,21
Comal,107,Proposition 9,,REP,Over Votes,0,0,0,0
Comal,107,Proposition 10,,REP,Yes,429,9,256,694
Comal,107,Proposition 10,,REP,No,38,0,12,50
Comal,107,Proposition 10,,REP,Cast Votes:,467,9,268,744
Comal,107,Proposition 10,,REP,Under Votes,14,0,4,18
Comal,107,Proposition 10,,REP,Over Votes,0,0,0,0
Comal,108,President,,REP,Zoltan G. Istvan,0,0,1,1
Comal,108,President,,REP,Bill Weld,2,0,0,2
Comal,108,President,,REP,"Roque ""Rocky"" De La Fuente Guerra",1,0,1,2
Comal,108,President,,REP,Matthew John Matern,1,0,0,1
Comal,108,President,,REP,Donald J. Trump,185,9,240,434
Comal,108,President,,REP,Joe Walsh,3,0,2,5
Comal,108,President,,REP,Bob Ely,0,0,0,0
Comal,108,President,,REP,Uncommitted,9,0,4,13
Comal,108,Ballots Cast,,REP,,201,9,248,458
Comal,108,President,,REP,Under Votes,2,0,0,2
Comal,108,President,,REP,Over Votes,0,0,0,0
Comal,108,U.S. Senate,,REP,John Anthony Castro,16,0,3,19
Comal,108,U.S. Senate,,REP,Virgil Bierschwale,5,0,3,8
Comal,108,U.S. Senate,,REP,John Cornyn,143,9,211,363
Comal,108,U.S. Senate,,REP,Mark Yancey,11,0,12,23
Comal,108,U.S. Senate,,REP,Dwayne Stovall,16,0,12,28
Comal,108,U.S. Senate,,REP,Cast Votes:,191,9,241,441
Comal,108,U.S. Senate,,REP,Under Votes,12,0,7,19
Comal,108,U.S. Senate,,REP,Over Votes,0,0,0,0
Comal,108,U.S. House,21,REP,Chip Roy,183,8,230,421
Comal,108,U.S. House,21,REP,Cast Votes:,183,8,230,421
Comal,108,U.S. House,21,REP,Under Votes,20,1,18,39
Comal,108,U.S. House,21,REP,Over Votes,0,0,0,0
Comal,108,Railroad Commissioner,,REP,"James ""Jim"" Wright",116,6,134,256
Comal,108,Railroad Commissioner,,REP,Ryan Sitton,69,3,101,173
Comal,108,Railroad Commissioner,,REP,Cast Votes:,185,9,235,429
Comal,108,Railroad Commissioner,,REP,Under Votes,18,0,13,31
Comal,108,Railroad Commissioner,,REP,Over Votes,0,0,0,0
Comal,108,"Chief Justice, Supreme Court",,REP,Nathan Hecht,182,7,230,419
Comal,108,"Chief Justice, Supreme Court",,REP,Cast Votes:,182,7,230,419
Comal,108,"Chief Justice, Supreme Court",,REP,Under Votes,21,2,18,41
Comal,108,"Chief Justice, Supreme Court",,REP,Over Votes,0,0,0,0
Comal,108,"Justice, Supreme Court, Place 6 Unexpired Term",,REP,Jane Bland,178,7,228,413
Comal,108,"Justice, Supreme Court, Place 6 Unexpired Term",,REP,Cast Votes:,178,7,228,413
Comal,108,"Justice, Supreme Court, Place 6 Unexpired Term",,REP,Under Votes,25,2,20,47
Comal,108,"Justice, Supreme Court, Place 6 Unexpired Term",,REP,Over Votes,0,0,0,0
Comal,108,"Justice, Supreme Court, Place 7",,REP,Jeff Boyd,180,7,229,416
Comal,108,"Justice, Supreme Court, Place 7",,REP,Cast Votes:,180,7,229,416
Comal,108,"Justice, Supreme Court, Place 7",,REP,Under Votes,23,2,19,44
Comal,108,"Justice, Supreme Court, Place 7",,REP,Over Votes,0,0,0,0
Comal,108,"Justice, Supreme Court, Place 8",,REP,Brett Busby,179,7,227,413
Comal,108,"Justice, Supreme Court, Place 8",,REP,Cast Votes:,179,7,227,413
Comal,108,"Justice, Supreme Court, Place 8",,REP,Under Votes,24,2,21,47
Comal,108,"Justice, Supreme Court, Place 8",,REP,Over Votes,0,0,0,0
Comal,108,"Judge, Court of Criminal Appeals, Place 3",,REP,Gina Parker,93,3,119,215
Comal,108,"Judge, Court of Criminal Appeals, Place 3",,REP,Bert Richardson,84,6,113,203
Comal,108,"Judge, Court of Criminal Appeals, Place 3",,REP,Cast Votes:,177,9,232,418
Comal,108,"Judge, Court of Criminal Appeals, Place 3",,REP,Under Votes,26,0,16,42
Comal,108,"Judge, Court of Criminal Appeals, Place 3",,REP,Over Votes,0,0,0,0
Comal,108,"Judge, Court of Criminal Appeals, Place 4",,REP,Kevin Patrick Yeary,173,6,227,406
Comal,108,"Judge, Court of Criminal Appeals, Place 4",,REP,Cast Votes:,173,6,227,406
Comal,108,"Judge, Court of Criminal Appeals, Place 4",,REP,Under Votes,30,3,21,54
Comal,108,"Judge, Court of Criminal Appeals, Place 4",,REP,Over Votes,0,0,0,0
Comal,108,"Judge, Court of Criminal Appeals, Place 9",,REP,David Newell,177,7,226,410
Comal,108,"Judge, Court of Criminal Appeals, Place 9",,REP,Cast Votes:,177,7,226,410
Comal,108,"Judge, Court of Criminal Appeals, Place 9",,REP,Under Votes,26,2,22,50
Comal,108,"Judge, Court of Criminal Appeals, Place 9",,REP,Over Votes,0,0,0,0
Comal,108,"Member, State Board of Education, District 5",,REP,Lani Popp,46,2,86,134
Comal,108,"Member, State Board of Education, District 5",,REP,Inga Cotton,51,2,58,111
Comal,108,"Member, State Board of Education, District 5",,REP,Robert Morrow,78,4,84,166
Comal,108,"Member, State Board of Education, District 5",,REP,Cast Votes:,175,8,228,411
Comal,108,"Member, State Board of Education, District 5",,REP,Under Votes,28,1,20,49
Comal,108,"Member, State Board of Education, District 5",,REP,Over Votes,0,0,0,0
Comal,108,State Representative,73,REP,Kyle Biedermann,185,7,231,423
Comal,108,State Representative,73,REP,Cast Votes:,185,7,231,423
Comal,108,State Representative,73,REP,Under Votes,18,2,17,37
Comal,108,State Representative,73,REP,Over Votes,0,0,0,0
Comal,108,"Chief Justice, 3rd Court of Appeals District",,REP,Jeff Rose,179,6,226,411
Comal,108,"Chief Justice, 3rd Court of Appeals District",,REP,Cast Votes:,179,6,226,411
Comal,108,"Chief Justice, 3rd Court of Appeals District",,REP,Under Votes,24,3,22,49
Comal,108,"Chief Justice, 3rd Court of Appeals District",,REP,Over Votes,0,0,0,0
Comal,108,"District Judge, 22nd Judicial District",,REP,R. Bruce Boyer,179,6,223,408
Comal,108,"District Judge, 22nd Judicial District",,REP,Cast Votes:,179,6,223,408
Comal,108,"District Judge, 22nd Judicial District",,REP,Under Votes,24,3,25,52
Comal,108,"District Judge, 22nd Judicial District",,REP,Over Votes,0,0,0,0
Comal,108,"District Judge, 433rd Judicial District",,REP,Dib Waldrip,105,2,149,256
Comal,108,"District Judge, 433rd Judicial District",,REP,Charlie Sullivan,89,7,94,190
Comal,108,"District Judge, 433rd Judicial District",,REP,Cast Votes:,194,9,243,446
Comal,108,"District Judge, 433rd Judicial District",,REP,Under Votes,9,0,5,14
Comal,108,"District Judge, 433rd Judicial District",,REP,Over Votes,0,0,0,0
Comal,108,"Judge, County Court at Law No. 2",,REP,"Charles A. Stephens, II",180,7,226,413
Comal,108,"Judge, County Court at Law No. 2",,REP,Cast Votes:,180,7,226,413
Comal,108,"Judge, County Court at Law No. 2",,REP,Under Votes,23,2,22,47
Comal,108,"Judge, County Court at Law No. 2",,REP,Over Votes,0,0,0,0
Comal,108,"Judge, County Court at Law No. 3",,REP,Deborah Linnartz Wigington,170,6,219,395
Comal,108,"Judge, County Court at Law No. 3",,REP,Cast Votes:,170,6,219,395
Comal,108,"Judge, County Court at Law No. 3",,REP,Under Votes,33,3,29,65
Comal,108,"Judge, County Court at Law No. 3",,REP,Over Votes,0,0,0,0
Comal,108,Sheriff,,REP,Mark Reynolds,186,7,228,421
Comal,108,Sheriff,,REP,Cast Votes:,186,7,228,421
Comal,108,Sheriff,,REP,Under Votes,17,2,20,39
Comal,108,Sheriff,,REP,Over Votes,0,0,0,0
Comal,108,County Tax Assessor-Collector,,REP,Kristen H. Hoyt,119,9,140,268
Comal,108,County Tax Assessor-Collector,,REP,Patrick Aten,66,0,100,166
Comal,108,County Tax Assessor-Collector,,REP,Cast Votes:,185,9,240,434
Comal,108,County Tax Assessor-Collector,,REP,Under Votes,18,0,8,26
Comal,108,County Tax Assessor-Collector,,REP,Over Votes,0,0,0,0
Comal,108,"County Commissioner, Precinct 1",,REP,Richard K. Smith,112,4,118,234
Comal,108,"County Commissioner, Precinct 1",,REP,Donna Eccleston,77,4,122,203
Comal,108,"County Commissioner, Precinct 1",,REP,Cast Votes:,189,8,240,437
Comal,108,"County Commissioner, Precinct 1",,REP,Under Votes,14,1,8,23
Comal,108,"County Commissioner, Precinct 1",,REP,Over Votes,0,0,0,0
Comal,108,"Constable, Precinct No. 1",,REP,Christopher Braun,62,6,69,137
Comal,108,"Constable, Precinct No. 1",,REP,Charlie Motz,118,2,161,281
Comal,108,"Constable, Precinct No. 1",,REP,Cast Votes:,180,8,230,418
Comal,108,"Constable, Precinct No. 1",,REP,Under Votes,23,1,18,42
Comal,108,"Constable, Precinct No. 1",,REP,Over Votes,0,0,0,0
Comal,108,County Chairman,,REP,Sue Piner,172,6,219,397
Comal,108,County Chairman,,REP,Cast Votes:,172,6,219,397
Comal,108,County Chairman,,REP,Under Votes,31,3,29,63
Comal,108,County Chairman,,REP,Over Votes,0,0,0,0
Comal,108,Proposition 1,,REP,Yes,177,8,229,414
Comal,108,Proposition 1,,REP,No,23,1,18,42
Comal,108,Proposition 1,,REP,Cast Votes:,200,9,247,456
Comal,108,Proposition 1,,REP,Under Votes,3,0,1,4
Comal,108,Proposition 1,,REP,Over Votes,0,0,0,0
Comal,108,Proposition 2,,REP,Yes,167,9,211,387
Comal,108,Proposition 2,,REP,No,29,0,32,61
Comal,108,Proposition 2,,REP,Cast Votes:,196,9,243,448
Comal,108,Proposition 2,,REP,Under Votes,7,0,5,12
Comal,108,Proposition 2,,REP,Over Votes,0,0,0,0
Comal,108,Proposition 3,,REP,Yes,181,9,239,429
Comal,108,Proposition 3,,REP,No,12,0,3,15
Comal,108,Proposition 3,,REP,Cast Votes:,193,9,242,444
Comal,108,Proposition 3,,REP,Under Votes,10,0,6,16
Comal,108,Proposition 3,,REP,Over Votes,0,0,0,0
Comal,108,Proposition 4,,REP,Yes,174,9,238,421
Comal,108,Proposition 4,,REP,No,23,0,6,29
Comal,108,Proposition 4,,REP,Cast Votes:,197,9,244,450
Comal,108,Proposition 4,,REP,Under Votes,6,0,4,10
Comal,108,Proposition 4,,REP,Over Votes,0,0,0,0
Comal,108,Proposition 5,,REP,Yes,165,9,221,395
Comal,108,Proposition 5,,REP,No,27,0,23,50
Comal,108,Proposition 5,,REP,Cast Votes:,192,9,244,445
Comal,108,Proposition 5,,REP,Under Votes,11,0,4,15
Comal,108,Proposition 5,,REP,Over Votes,0,0,0,0
Comal,108,Proposition 6,,REP,Yes,183,9,233,425
Comal,108,Proposition 6,,REP,No,13,0,6,19
Comal,108,Proposition 6,,REP,Cast Votes:,196,9,239,444
Comal,108,Proposition 6,,REP,Under Votes,7,0,9,16
Comal,108,Proposition 6,,REP,Over Votes,0,0,0,0
Comal,108,Proposition 7,,REP,Yes,188,9,234,431
Comal,108,Proposition 7,,REP,No,8,0,2,10
Comal,108,Proposition 7,,REP,Cast Votes:,196,9,236,441
Comal,108,Proposition 7,,REP,Under Votes,7,0,12,19
Comal,108,Proposition 7,,REP,Over Votes,0,0,0,0
Comal,108,Proposition 8,,REP,Yes,194,9,240,443
Comal,108,Proposition 8,,REP,No,4,0,1,5
Comal,108,Proposition 8,,REP,Cast Votes:,198,9,241,448
Comal,108,Proposition 8,,REP,Under Votes,5,0,7,12
Comal,108,Proposition 8,,REP,Over Votes,0,0,0,0
Comal,108,Proposition 9,,REP,Yes,184,9,232,425
Comal,108,Proposition 9,,REP,No,10,0,10,20
Comal,108,Proposition 9,,REP,Cast Votes:,194,9,242,445
Comal,108,Proposition 9,,REP,Under Votes,9,0,6,15
Comal,108,Proposition 9,,REP,Over Votes,0,0,0,0
Comal,108,Proposition 10,,REP,Yes,185,9,224,418
Comal,108,Proposition 10,,REP,No,10,0,17,27
Comal,108,Proposition 10,,REP,Cast Votes:,195,9,241,445
Comal,108,Proposition 10,,REP,Under Votes,8,0,7,15
Comal,108,Proposition 10,,REP,Over Votes,0,0,0,0