county,precinct,office,district,party,candidate,mail,early_voting,election_day,votes
Franklin,101,Registered Voters,,REP,,6,194,111,311
Franklin,102,Registered Voters,,REP,,0,47,122,169
Franklin,201,Registered Voters,,REP,,2,102,57,161
Franklin,202,Registered Voters,,REP,,7,99,86,192
Franklin,301,Registered Voters,,REP,,3,107,113,223
Franklin,302,Registered Voters,,REP,,1,34,131,166
Franklin,401,Registered Voters,,REP,,5,163,124,292
Franklin,402,Registered Voters,,REP,,2,49,145,196
Franklin,101,President,,REP,Joe Walsh,0,4,2,6
Franklin,102,President,,REP,Joe Walsh,0,0,0,0
Franklin,201,President,,REP,Joe Walsh,0,0,0,0
Franklin,202,President,,REP,Joe Walsh,0,0,1,1
Franklin,301,President,,REP,Joe Walsh,0,1,0,1
Franklin,302,President,,REP,Joe Walsh,0,0,0,0
Franklin,401,President,,REP,Joe Walsh,1,0,2,3
Franklin,402,President,,REP,Joe Walsh,0,0,0,0
Franklin,101,President,,REP,Donald Trump,6,180,109,295
Franklin,102,President,,REP,Donald Trump,0,47,120,167
Franklin,201,President,,REP,Donald Trump,2,101,56,159
Franklin,202,President,,REP,Donald Trump,7,97,83,187
Franklin,301,President,,REP,Donald Trump,3,106,109,218
Franklin,302,President,,REP,Donald Trump,1,33,128,162
Franklin,401,President,,REP,Donald Trump,4,162,121,287
Franklin,402,President,,REP,Donald Trump,2,46,139,187
Franklin,101,President,,REP,Matthew John Matern,0,0,0,0
Franklin,102,President,,REP,Matthew John Matern,0,0,0,0
Franklin,201,President,,REP,Matthew John Matern,0,0,0,0
Franklin,202,President,,REP,Matthew John Matern,0,0,0,0
Franklin,301,President,,REP,Matthew John Matern,0,0,1,1
Franklin,302,President,,REP,Matthew John Matern,0,0,0,0
Franklin,401,President,,REP,Matthew John Matern,0,0,0,0
Franklin,402,President,,REP,Matthew John Matern,0,0,0,0
Franklin,101,President,,REP,Zoltan G. Istvan,0,0,0,0
Franklin,102,President,,REP,Zoltan G. Istvan,0,0,0,0
Franklin,201,President,,REP,Zoltan G. Istvan,0,0,0,0
Franklin,202,President,,REP,Zoltan G. Istvan,0,0,0,0
Franklin,301,President,,REP,Zoltan G. Istvan,0,0,0,0
Franklin,302,President,,REP,Zoltan G. Istvan,0,0,1,1
Franklin,401,President,,REP,Zoltan G. Istvan,0,0,0,0
Franklin,402,President,,REP,Zoltan G. Istvan,0,0,0,0
Franklin,101,President,,REP,Bill Weld,0,2,0,2
Franklin,102,President,,REP,Bill Weld,0,0,0,0
Franklin,201,President,,REP,Bill Weld,0,0,0,0
Franklin,202,President,,REP,Bill Weld,0,0,0,0
Franklin,301,President,,REP,Bill Weld,0,0,0,0
Franklin,302,President,,REP,Bill Weld,0,0,0,0
Franklin,401,President,,REP,Bill Weld,0,0,0,0
Franklin,402,President,,REP,Bill Weld,0,1,1,2
Franklin,101,President,,REP,Bob Ely,0,0,0,0
Franklin,102,President,,REP,Bob Ely,0,0,0,0
Franklin,201,President,,REP,Bob Ely,0,0,0,0
Franklin,202,President,,REP,Bob Ely,0,0,0,0
Franklin,301,President,,REP,Bob Ely,0,0,0,0
Franklin,302,President,,REP,Bob Ely,0,0,0,0
Franklin,401,President,,REP,Bob Ely,0,0,0,0
Franklin,402,President,,REP,Bob Ely,0,0,1,1
Franklin,101,President,,REP,"Roque ""Rocky"" Dlf Guerra",0,1,0,1
Franklin,102,President,,REP,"Roque ""Rocky"" Dlf Guerra",0,0,0,0
Franklin,201,President,,REP,"Roque ""Rocky"" Dlf Guerra",0,0,1,1
Franklin,202,President,,REP,"Roque ""Rocky"" Dlf Guerra",0,0,0,0
Franklin,301,President,,REP,"Roque ""Rocky"" Dlf Guerra",0,0,0,0
Franklin,302,President,,REP,"Roque ""Rocky"" Dlf Guerra",0,0,0,0
Franklin,401,President,,REP,"Roque ""Rocky"" Dlf Guerra",0,0,0,0
Franklin,402,President,,REP,"Roque ""Rocky"" Dlf Guerra",0,0,0,0
Franklin,101,President,,REP,Uncommitted,0,4,0,4
Franklin,102,President,,REP,Uncommitted,0,0,2,2
Franklin,201,President,,REP,Uncommitted,0,1,0,1
Franklin,202,President,,REP,Uncommitted,0,2,2,4
Franklin,301,President,,REP,Uncommitted,0,0,3,3
Franklin,302,President,,REP,Uncommitted,0,1,2,3
Franklin,401,President,,REP,Uncommitted,0,0,1,1
Franklin,402,President,,REP,Uncommitted,0,2,4,6
Franklin,101,U.S. Senate,,REP,Dwayne Stovall,1,18,15,34
Franklin,102,U.S. Senate,,REP,Dwayne Stovall,0,12,25,37
Franklin,201,U.S. Senate,,REP,Dwayne Stovall,0,16,6,22
Franklin,202,U.S. Senate,,REP,Dwayne Stovall,1,10,16,27
Franklin,301,U.S. Senate,,REP,Dwayne Stovall,0,23,25,48
Franklin,302,U.S. Senate,,REP,Dwayne Stovall,0,4,19,23
Franklin,401,U.S. Senate,,REP,Dwayne Stovall,0,22,13,35
Franklin,402,U.S. Senate,,REP,Dwayne Stovall,0,9,32,41
Franklin,101,U.S. Senate,,REP,Virgil Bierschwale,0,1,1,2
Franklin,102,U.S. Senate,,REP,Virgil Bierschwale,0,0,2,2
Franklin,201,U.S. Senate,,REP,Virgil Bierschwale,0,0,0,0
Franklin,202,U.S. Senate,,REP,Virgil Bierschwale,0,0,0,0
Franklin,301,U.S. Senate,,REP,Virgil Bierschwale,0,1,3,4
Franklin,302,U.S. Senate,,REP,Virgil Bierschwale,0,2,2,4
Franklin,401,U.S. Senate,,REP,Virgil Bierschwale,0,1,1,2
Franklin,402,U.S. Senate,,REP,Virgil Bierschwale,0,2,1,3
Franklin,101,U.S. Senate,,REP,Mark Yancey,0,13,9,22
Franklin,102,U.S. Senate,,REP,Mark Yancey,0,5,17,22
Franklin,201,U.S. Senate,,REP,Mark Yancey,0,5,4,9
Franklin,202,U.S. Senate,,REP,Mark Yancey,0,4,4,8
Franklin,301,U.S. Senate,,REP,Mark Yancey,0,3,5,8
Franklin,302,U.S. Senate,,REP,Mark Yancey,0,1,10,11
Franklin,401,U.S. Senate,,REP,Mark Yancey,0,12,14,26
Franklin,402,U.S. Senate,,REP,Mark Yancey,0,2,6,8
Franklin,101,U.S. Senate,,REP,John Cornyn,5,147,73,225
Franklin,102,U.S. Senate,,REP,John Cornyn,0,26,67,93
Franklin,201,U.S. Senate,,REP,John Cornyn,1,76,40,117
Franklin,202,U.S. Senate,,REP,John Cornyn,6,81,60,147
Franklin,301,U.S. Senate,,REP,John Cornyn,3,75,72,150
Franklin,302,U.S. Senate,,REP,John Cornyn,1,24,91,116
Franklin,401,U.S. Senate,,REP,John Cornyn,4,120,82,206
Franklin,402,U.S. Senate,,REP,John Cornyn,2,33,99,134
Franklin,101,U.S. Senate,,REP,John Anthony Castro,0,5,5,10
Franklin,102,U.S. Senate,,REP,John Anthony Castro,0,0,4,4
Franklin,201,U.S. Senate,,REP,John Anthony Castro,0,0,1,1
Franklin,202,U.S. Senate,,REP,John Anthony Castro,0,2,2,4
Franklin,301,U.S. Senate,,REP,John Anthony Castro,0,2,2,4
Franklin,302,U.S. Senate,,REP,John Anthony Castro,0,0,2,2
Franklin,401,U.S. Senate,,REP,John Anthony Castro,0,1,2,3
Franklin,402,U.S. Senate,,REP,John Anthony Castro,0,0,0,0
Franklin,101,U.S. House,4,REP,John Ratcliffe,6,167,95,268
Franklin,102,U.S. House,4,REP,John Ratcliffe,0,41,109,150
Franklin,201,U.S. House,4,REP,John Ratcliffe,1,95,51,147
Franklin,202,U.S. House,4,REP,John Ratcliffe,7,91,75,173
Franklin,301,U.S. House,4,REP,John Ratcliffe,2,93,110,205
Franklin,302,U.S. House,4,REP,John Ratcliffe,1,30,119,150
Franklin,401,U.S. House,4,REP,John Ratcliffe,4,142,108,254
Franklin,402,U.S. House,4,REP,John Ratcliffe,2,40,124,166
Franklin,101,Railroad Commissioner,,REP,Ryan Sitton,2,55,31,88
Franklin,102,Railroad Commissioner,,REP,Ryan Sitton,0,21,49,70
Franklin,201,Railroad Commissioner,,REP,Ryan Sitton,0,31,18,49
Franklin,202,Railroad Commissioner,,REP,Ryan Sitton,2,32,28,62
Franklin,301,Railroad Commissioner,,REP,Ryan Sitton,2,43,44,89
Franklin,302,Railroad Commissioner,,REP,Ryan Sitton,1,15,49,65
Franklin,401,Railroad Commissioner,,REP,Ryan Sitton,4,60,44,108
Franklin,402,Railroad Commissioner,,REP,Ryan Sitton,2,19,52,73
Franklin,101,Railroad Commissioner,,REP,"James ""Jim"" Wright",4,112,63,179
Franklin,102,Railroad Commissioner,,REP,"James ""Jim"" Wright",0,17,54,71
Franklin,201,Railroad Commissioner,,REP,"James ""Jim"" Wright",0,54,30,84
Franklin,202,Railroad Commissioner,,REP,"James ""Jim"" Wright",5,47,45,97
Franklin,301,Railroad Commissioner,,REP,"James ""Jim"" Wright",0,43,57,100
Franklin,302,Railroad Commissioner,,REP,"James ""Jim"" Wright",0,15,71,86
Franklin,401,Railroad Commissioner,,REP,"James ""Jim"" Wright",1,80,65,146
Franklin,402,Railroad Commissioner,,REP,"James ""Jim"" Wright",0,24,71,95
Franklin,101,State Senate,1,REP,Bryan Hughes,5,156,90,251
Franklin,102,State Senate,1,REP,Bryan Hughes,0,39,106,145
Franklin,201,State Senate,1,REP,Bryan Hughes,1,89,44,134
Franklin,202,State Senate,1,REP,Bryan Hughes,7,86,76,169
Franklin,301,State Senate,1,REP,Bryan Hughes,2,86,106,194
Franklin,302,State Senate,1,REP,Bryan Hughes,1,30,119,150
Franklin,401,State Senate,1,REP,Bryan Hughes,5,132,109,246
Franklin,402,State Senate,1,REP,Bryan Hughes,2,41,120,163
Franklin,101,State Representative,1,REP,Gary Vandeaver,6,169,92,267
Franklin,102,State Representative,1,REP,Gary Vandeaver,0,41,106,147
Franklin,201,State Representative,1,REP,Gary Vandeaver,0,91,45,136
Franklin,202,State Representative,1,REP,Gary Vandeaver,7,86,74,167
Franklin,301,State Representative,1,REP,Gary Vandeaver,3,95,106,204
Franklin,302,State Representative,1,REP,Gary Vandeaver,1,29,114,144
Franklin,401,State Representative,1,REP,Gary Vandeaver,5,134,109,248
Franklin,402,State Representative,1,REP,Gary Vandeaver,2,40,122,164
Franklin,101,Registered Voters,,DEM,,4,34,30,68
Franklin,102,Registered Voters,,DEM,,0,6,11,17
Franklin,201,Registered Voters,,DEM,,2,6,15,23
Franklin,202,Registered Voters,,DEM,,3,14,52,69
Franklin,301,Registered Voters,,DEM,,4,17,25,46
Franklin,302,Registered Voters,,DEM,,3,7,26,36
Franklin,401,Registered Voters,,DEM,,1,30,45,76
Franklin,402,Registered Voters,,DEM,,1,10,28,39
Franklin,101,President,,DEM,Joseph R. Biden,3,17,16,36
Franklin,102,President,,DEM,Joseph R. Biden,0,1,8,9
Franklin,201,President,,DEM,Joseph R. Biden,0,0,10,10
Franklin,202,President,,DEM,Joseph R. Biden,1,5,30,36
Franklin,301,President,,DEM,Joseph R. Biden,2,9,12,23
Franklin,302,President,,DEM,Joseph R. Biden,2,0,14,16
Franklin,401,President,,DEM,Joseph R. Biden,0,5,31,36
Franklin,402,President,,DEM,Joseph R. Biden,0,5,17,22
Franklin,101,President,,DEM,Michael Bennet,0,0,0,0
Franklin,102,President,,DEM,Michael Bennet,0,0,0,0
Franklin,201,President,,DEM,Michael Bennet,0,1,0,1
Franklin,202,President,,DEM,Michael Bennet,0,0,2,2
Franklin,301,President,,DEM,Michael Bennet,0,0,0,0
Franklin,302,President,,DEM,Michael Bennet,0,0,0,0
Franklin,401,President,,DEM,Michael Bennet,0,0,0,0
Franklin,402,President,,DEM,Michael Bennet,0,0,0,0
Franklin,101,President,,DEM,Robby Wells,0,0,0,0
Franklin,102,President,,DEM,Robby Wells,0,0,0,0
Franklin,201,President,,DEM,Robby Wells,0,0,0,0
Franklin,202,President,,DEM,Robby Wells,0,0,1,1
Franklin,301,President,,DEM,Robby Wells,0,0,0,0
Franklin,302,President,,DEM,Robby Wells,0,0,0,0
Franklin,401,President,,DEM,Robby Wells,0,0,0,0
Franklin,402,President,,DEM,Robby Wells,0,0,0,0
Franklin,101,President,,DEM,Elizabeth Warren,1,5,0,6
Franklin,102,President,,DEM,Elizabeth Warren,0,1,0,1
Franklin,201,President,,DEM,Elizabeth Warren,0,0,1,1
Franklin,202,President,,DEM,Elizabeth Warren,0,0,0,0
Franklin,301,President,,DEM,Elizabeth Warren,0,0,2,2
Franklin,302,President,,DEM,Elizabeth Warren,0,2,1,3
Franklin,401,President,,DEM,Elizabeth Warren,1,5,1,7
Franklin,402,President,,DEM,Elizabeth Warren,0,2,0,2
Franklin,101,President,,DEM,Michael R. Bloomberg,0,4,7,11
Franklin,102,President,,DEM,Michael R. Bloomberg,0,2,0,2
Franklin,201,President,,DEM,Michael R. Bloomberg,2,3,2,7
Franklin,202,President,,DEM,Michael R. Bloomberg,0,2,14,16
Franklin,301,President,,DEM,Michael R. Bloomberg,1,4,3,8
Franklin,302,President,,DEM,Michael R. Bloomberg,0,0,3,3
Franklin,401,President,,DEM,Michael R. Bloomberg,0,8,8,16
Franklin,402,President,,DEM,Michael R. Bloomberg,0,0,6,6
Franklin,101,President,,DEM,Amy Klobuchar,0,1,0,1
Franklin,102,President,,DEM,Amy Klobuchar,0,1,0,1
Franklin,201,President,,DEM,Amy Klobuchar,0,0,0,0
Franklin,202,President,,DEM,Amy Klobuchar,1,0,0,1
Franklin,301,President,,DEM,Amy Klobuchar,1,0,0,1
Franklin,302,President,,DEM,Amy Klobuchar,0,2,0,2
Franklin,401,President,,DEM,Amy Klobuchar,0,4,0,4
Franklin,402,President,,DEM,Amy Klobuchar,0,0,0,0
Franklin,101,President,,DEM,Andrew Yang,0,0,0,0
Franklin,102,President,,DEM,Andrew Yang,0,0,0,0
Franklin,201,President,,DEM,Andrew Yang,0,0,0,0
Franklin,202,President,,DEM,Andrew Yang,0,0,0,0
Franklin,301,President,,DEM,Andrew Yang,0,0,0,0
Franklin,302,President,,DEM,Andrew Yang,0,0,0,0
Franklin,401,President,,DEM,Andrew Yang,0,0,0,0
Franklin,402,President,,DEM,Andrew Yang,0,0,0,0
Franklin,101,President,,DEM,Tulsi Gabbard,0,0,0,0
Franklin,102,President,,DEM,Tulsi Gabbard,0,0,0,0
Franklin,201,President,,DEM,Tulsi Gabbard,0,0,0,0
Franklin,202,President,,DEM,Tulsi Gabbard,0,0,0,0
Franklin,301,President,,DEM,Tulsi Gabbard,0,0,0,0
Franklin,302,President,,DEM,Tulsi Gabbard,0,0,0,0
Franklin,401,President,,DEM,Tulsi Gabbard,0,1,0,1
Franklin,402,President,,DEM,Tulsi Gabbard,0,0,0,0
Franklin,101,President,,DEM,Deval Patrick,0,0,0,0
Franklin,102,President,,DEM,Deval Patrick,0,0,0,0
Franklin,201,President,,DEM,Deval Patrick,0,0,0,0
Franklin,202,President,,DEM,Deval Patrick,1,0,0,1
Franklin,301,President,,DEM,Deval Patrick,0,0,0,0
Franklin,302,President,,DEM,Deval Patrick,0,0,0,0
Franklin,401,President,,DEM,Deval Patrick,0,0,0,0
Franklin,402,President,,DEM,Deval Patrick,0,0,0,0
Franklin,101,President,,DEM,Marianne Williamson,0,0,0,0
Franklin,102,President,,DEM,Marianne Williamson,0,0,0,0
Franklin,201,President,,DEM,Marianne Williamson,0,1,0,1
Franklin,202,President,,DEM,Marianne Williamson,0,0,0,0
Franklin,301,President,,DEM,Marianne Williamson,0,0,0,0
Franklin,302,President,,DEM,Marianne Williamson,0,0,1,1
Franklin,401,President,,DEM,Marianne Williamson,0,0,0,0
Franklin,402,President,,DEM,Marianne Williamson,0,0,0,0
Franklin,101,President,,DEM,Julian Castro,0,0,0,0
Franklin,102,President,,DEM,Julian Castro,0,0,0,0
Franklin,201,President,,DEM,Julian Castro,0,0,0,0
Franklin,202,President,,DEM,Julian Castro,0,0,0,0
Franklin,301,President,,DEM,Julian Castro,0,0,0,0
Franklin,302,President,,DEM,Julian Castro,0,0,0,0
Franklin,401,President,,DEM,Julian Castro,0,0,0,0
Franklin,402,President,,DEM,Julian Castro,0,0,0,0
Franklin,101,President,,DEM,John K. Delaney,0,0,0,0
Franklin,102,President,,DEM,John K. Delaney,0,0,0,0
Franklin,201,President,,DEM,John K. Delaney,0,0,0,0
Franklin,202,President,,DEM,John K. Delaney,0,0,0,0
Franklin,301,President,,DEM,John K. Delaney,0,0,0,0
Franklin,302,President,,DEM,John K. Delaney,0,0,0,0
Franklin,401,President,,DEM,John K. Delaney,0,0,0,0
Franklin,402,President,,DEM,John K. Delaney,0,0,0,0
Franklin,101,President,,DEM,Tom Steyer,0,0,0,0
Franklin,102,President,,DEM,Tom Steyer,0,0,0,0
Franklin,201,President,,DEM,Tom Steyer,0,0,0,0
Franklin,202,President,,DEM,Tom Steyer,0,0,0,0
Franklin,301,President,,DEM,Tom Steyer,0,0,0,0
Franklin,302,President,,DEM,Tom Steyer,0,0,0,0
Franklin,401,President,,DEM,Tom Steyer,0,0,0,0
Franklin,402,President,,DEM,Tom Steyer,0,0,0,0
Franklin,101,President,,DEM,Bernie Sanders,0,4,7,11
Franklin,102,President,,DEM,Bernie Sanders,0,0,3,3
Franklin,201,President,,DEM,Bernie Sanders,0,1,2,3
Franklin,202,President,,DEM,Bernie Sanders,0,2,5,7
Franklin,301,President,,DEM,Bernie Sanders,0,3,8,11
Franklin,302,President,,DEM,Bernie Sanders,0,1,7,8
Franklin,401,President,,DEM,Bernie Sanders,0,3,4,7
Franklin,402,President,,DEM,Bernie Sanders,1,3,4,8
Franklin,101,President,,DEM,"Roque ""Rocky"" De La Fuenta",0,0,0,0
Franklin,102,President,,DEM,"Roque ""Rocky"" De La Fuenta",0,0,0,0
Franklin,201,President,,DEM,"Roque ""Rocky"" De La Fuenta",0,0,0,0
Franklin,202,President,,DEM,"Roque ""Rocky"" De La Fuenta",0,0,0,0
Franklin,301,President,,DEM,"Roque ""Rocky"" De La Fuenta",0,0,0,0
Franklin,302,President,,DEM,"Roque ""Rocky"" De La Fuenta",0,0,0,0
Franklin,401,President,,DEM,"Roque ""Rocky"" De La Fuenta",0,0,0,0
Franklin,402,President,,DEM,"Roque ""Rocky"" De La Fuenta",0,0,0,0
Franklin,101,President,,DEM,Cory Booker,0,0,0,0
Franklin,102,President,,DEM,Cory Booker,0,0,0,0
Franklin,201,President,,DEM,Cory Booker,0,0,0,0
Franklin,202,President,,DEM,Cory Booker,0,0,0,0
Franklin,301,President,,DEM,Cory Booker,0,0,0,0
Franklin,302,President,,DEM,Cory Booker,0,0,0,0
Franklin,401,President,,DEM,Cory Booker,0,0,0,0
Franklin,402,President,,DEM,Cory Booker,0,0,0,0
Franklin,101,President,,DEM,Pete Buttigieg,0,3,0,3
Franklin,102,President,,DEM,Pete Buttigieg,0,1,0,1
Franklin,201,President,,DEM,Pete Buttigieg,0,0,0,0
Franklin,202,President,,DEM,Pete Buttigieg,0,4,0,4
Franklin,301,President,,DEM,Pete Buttigieg,0,1,0,1
Franklin,302,President,,DEM,Pete Buttigieg,1,2,0,3
Franklin,401,President,,DEM,Pete Buttigieg,0,4,1,5
Franklin,402,President,,DEM,Pete Buttigieg,0,0,0,0
Franklin,101,U.S. Senate,,DEM,D. R. Hunter,0,2,4,6
Franklin,102,U.S. Senate,,DEM,D. R. Hunter,0,0,2,2
Franklin,201,U.S. Senate,,DEM,D. R. Hunter,0,0,0,0
Franklin,202,U.S. Senate,,DEM,D. R. Hunter,0,0,5,5
Franklin,301,U.S. Senate,,DEM,D. R. Hunter,0,2,1,3
Franklin,302,U.S. Senate,,DEM,D. R. Hunter,0,0,1,1
Franklin,401,U.S. Senate,,DEM,D. R. Hunter,0,2,5,7
Franklin,402,U.S. Senate,,DEM,D. R. Hunter,0,0,1,1
Franklin,101,U.S. Senate,,DEM,Cristina Tzintzun Ramirez,0,2,3,5
Franklin,102,U.S. Senate,,DEM,Cristina Tzintzun Ramirez,0,2,2,4
Franklin,201,U.S. Senate,,DEM,Cristina Tzintzun Ramirez,0,2,0,2
Franklin,202,U.S. Senate,,DEM,Cristina Tzintzun Ramirez,0,3,2,5
Franklin,301,U.S. Senate,,DEM,Cristina Tzintzun Ramirez,2,0,2,4
Franklin,302,U.S. Senate,,DEM,Cristina Tzintzun Ramirez,0,0,1,1
Franklin,401,U.S. Senate,,DEM,Cristina Tzintzun Ramirez,0,6,3,9
Franklin,402,U.S. Senate,,DEM,Cristina Tzintzun Ramirez,0,3,3,6
Franklin,101,U.S. Senate,,DEM,Royce West,1,4,2,7
Franklin,102,U.S. Senate,,DEM,Royce West,0,1,1,2
Franklin,201,U.S. Senate,,DEM,Royce West,0,1,0,1
Franklin,202,U.S. Senate,,DEM,Royce West,2,2,11,15
Franklin,301,U.S. Senate,,DEM,Royce West,1,5,7,13
Franklin,302,U.S. Senate,,DEM,Royce West,0,0,4,4
Franklin,401,U.S. Senate,,DEM,Royce West,0,4,5,9
Franklin,402,U.S. Senate,,DEM,Royce West,0,2,4,6
Franklin,101,U.S. Senate,,DEM,Mary (MJ) Hegar,0,14,6,20
Franklin,102,U.S. Senate,,DEM,Mary (MJ) Hegar,0,2,0,2
Franklin,201,U.S. Senate,,DEM,Mary (MJ) Hegar,2,1,1,4
Franklin,202,U.S. Senate,,DEM,Mary (MJ) Hegar,0,4,4,8
Franklin,301,U.S. Senate,,DEM,Mary (MJ) Hegar,0,3,6,9
Franklin,302,U.S. Senate,,DEM,Mary (MJ) Hegar,2,2,8,12
Franklin,401,U.S. Senate,,DEM,Mary (MJ) Hegar,0,5,13,18
Franklin,402,U.S. Senate,,DEM,Mary (MJ) Hegar,0,5,11,16
Franklin,101,U.S. Senate,,DEM,Amanda K. Edwards,1,4,1,6
Franklin,102,U.S. Senate,,DEM,Amanda K. Edwards,0,0,0,0
Franklin,201,U.S. Senate,,DEM,Amanda K. Edwards,0,0,2,2
Franklin,202,U.S. Senate,,DEM,Amanda K. Edwards,0,0,4,4
Franklin,301,U.S. Senate,,DEM,Amanda K. Edwards,0,1,2,3
Franklin,302,U.S. Senate,,DEM,Amanda K. Edwards,1,1,3,5
Franklin,401,U.S. Senate,,DEM,Amanda K. Edwards,0,2,7,9
Franklin,402,U.S. Senate,,DEM,Amanda K. Edwards,1,0,3,4
Franklin,101,U.S. Senate,,DEM,Victor Hugo Harris,0,2,0,2
Franklin,102,U.S. Senate,,DEM,Victor Hugo Harris,0,0,1,1
Franklin,201,U.S. Senate,,DEM,Victor Hugo Harris,0,1,2,3
Franklin,202,U.S. Senate,,DEM,Victor Hugo Harris,0,0,0,0
Franklin,301,U.S. Senate,,DEM,Victor Hugo Harris,0,0,0,0
Franklin,302,U.S. Senate,,DEM,Victor Hugo Harris,0,1,1,2
Franklin,401,U.S. Senate,,DEM,Victor Hugo Harris,0,0,1,1
Franklin,402,U.S. Senate,,DEM,Victor Hugo Harris,0,0,0,0
Franklin,101,U.S. Senate,,DEM,"Annie ""Mama"" Garcia",1,1,4,6
Franklin,102,U.S. Senate,,DEM,"Annie ""Mama"" Garcia",0,0,0,0
Franklin,201,U.S. Senate,,DEM,"Annie ""Mama"" Garcia",0,0,0,0
Franklin,202,U.S. Senate,,DEM,"Annie ""Mama"" Garcia",0,0,11,11
Franklin,301,U.S. Senate,,DEM,"Annie ""Mama"" Garcia",0,0,2,2
Franklin,302,U.S. Senate,,DEM,"Annie ""Mama"" Garcia",0,0,2,2
Franklin,401,U.S. Senate,,DEM,"Annie ""Mama"" Garcia",1,1,3,5
Franklin,402,U.S. Senate,,DEM,"Annie ""Mama"" Garcia",0,0,3,3
Franklin,101,U.S. Senate,,DEM,Sema Hernandez,0,0,0,0
Franklin,102,U.S. Senate,,DEM,Sema Hernandez,0,0,0,0
Franklin,201,U.S. Senate,,DEM,Sema Hernandez,0,0,1,1
Franklin,202,U.S. Senate,,DEM,Sema Hernandez,0,0,0,0
Franklin,301,U.S. Senate,,DEM,Sema Hernandez,0,2,1,3
Franklin,302,U.S. Senate,,DEM,Sema Hernandez,0,1,0,1
Franklin,401,U.S. Senate,,DEM,Sema Hernandez,0,1,0,1
Franklin,402,U.S. Senate,,DEM,Sema Hernandez,0,0,0,0
Franklin,101,U.S. Senate,,DEM,Adrian Ocegueda,0,0,0,0
Franklin,102,U.S. Senate,,DEM,Adrian Ocegueda,0,0,0,0
Franklin,201,U.S. Senate,,DEM,Adrian Ocegueda,0,0,0,0
Franklin,202,U.S. Senate,,DEM,Adrian Ocegueda,0,0,1,1
Franklin,301,U.S. Senate,,DEM,Adrian Ocegueda,0,0,0,0
Franklin,302,U.S. Senate,,DEM,Adrian Ocegueda,0,0,0,0
Franklin,401,U.S. Senate,,DEM,Adrian Ocegueda,0,0,0,0
Franklin,402,U.S. Senate,,DEM,Adrian Ocegueda,0,0,0,0
Franklin,101,U.S. Senate,,DEM,"Jack Daniel Foster, Jr.",0,0,2,2
Franklin,102,U.S. Senate,,DEM,"Jack Daniel Foster, Jr.",0,0,0,0
Franklin,201,U.S. Senate,,DEM,"Jack Daniel Foster, Jr.",0,0,1,1
Franklin,202,U.S. Senate,,DEM,"Jack Daniel Foster, Jr.",0,0,1,1
Franklin,301,U.S. Senate,,DEM,"Jack Daniel Foster, Jr.",0,1,0,1
Franklin,302,U.S. Senate,,DEM,"Jack Daniel Foster, Jr.",0,0,0,0
Franklin,401,U.S. Senate,,DEM,"Jack Daniel Foster, Jr.",0,1,0,1
Franklin,402,U.S. Senate,,DEM,"Jack Daniel Foster, Jr.",0,0,0,0
Franklin,101,U.S. Senate,,DEM,Chris Bell,0,0,2,2
Franklin,102,U.S. Senate,,DEM,Chris Bell,0,0,1,1
Franklin,201,U.S. Senate,,DEM,Chris Bell,0,1,1,2
Franklin,202,U.S. Senate,,DEM,Chris Bell,0,0,4,4
Franklin,301,U.S. Senate,,DEM,Chris Bell,0,1,1,2
Franklin,302,U.S. Senate,,DEM,Chris Bell,0,0,0,0
Franklin,401,U.S. Senate,,DEM,Chris Bell,0,4,1,5
Franklin,402,U.S. Senate,,DEM,Chris Bell,0,0,0,0
Franklin,101,U.S. Senate,,DEM,Michael Cooper,0,0,2,2
Franklin,102,U.S. Senate,,DEM,Michael Cooper,0,0,0,0
Franklin,201,U.S. Senate,,DEM,Michael Cooper,0,0,3,3
Franklin,202,U.S. Senate,,DEM,Michael Cooper,1,3,4,8
Franklin,301,U.S. Senate,,DEM,Michael Cooper,0,0,1,1
Franklin,302,U.S. Senate,,DEM,Michael Cooper,0,0,2,2
Franklin,401,U.S. Senate,,DEM,Michael Cooper,0,0,2,2
Franklin,402,U.S. Senate,,DEM,Michael Cooper,0,0,0,0
Franklin,101,U.S. House,4,DEM,Russell Foster,4,25,25,54
Franklin,102,U.S. House,4,DEM,Russell Foster,0,5,2,7
Franklin,201,U.S. House,4,DEM,Russell Foster,2,2,9,13
Franklin,202,U.S. House,4,DEM,Russell Foster,3,8,39,50
Franklin,301,U.S. House,4,DEM,Russell Foster,3,11,19,33
Franklin,302,U.S. House,4,DEM,Russell Foster,3,4,19,26
Franklin,401,U.S. House,4,DEM,Russell Foster,1,22,35,58
Franklin,402,U.S. House,4,DEM,Russell Foster,1,8,20,29
Franklin,101,Railroad Commissioner,,DEM,Mark Watson,2,8,13,23
Franklin,102,Railroad Commissioner,,DEM,Mark Watson,0,1,5,6
Franklin,201,Railroad Commissioner,,DEM,Mark Watson,0,1,3,4
Franklin,202,Railroad Commissioner,,DEM,Mark Watson,2,2,16,20
Franklin,301,Railroad Commissioner,,DEM,Mark Watson,0,4,9,13
Franklin,302,Railroad Commissioner,,DEM,Mark Watson,1,0,6,7
Franklin,401,Railroad Commissioner,,DEM,Mark Watson,0,5,11,16
Franklin,402,Railroad Commissioner,,DEM,Mark Watson,0,4,2,6
Franklin,101,Railroad Commissioner,,DEM,Chrysta Castaneda,1,13,2,16
Franklin,102,Railroad Commissioner,,DEM,Chrysta Castaneda,0,0,1,1
Franklin,201,Railroad Commissioner,,DEM,Chrysta Castaneda,2,3,1,6
Franklin,202,Railroad Commissioner,,DEM,Chrysta Castaneda,1,4,14,19
Franklin,301,Railroad Commissioner,,DEM,Chrysta Castaneda,3,3,6,12
Franklin,302,Railroad Commissioner,,DEM,Chrysta Castaneda,1,2,10,13
Franklin,401,Railroad Commissioner,,DEM,Chrysta Castaneda,1,7,14,22
Franklin,402,Railroad Commissioner,,DEM,Chrysta Castaneda,0,4,10,14
Franklin,101,Railroad Commissioner,,DEM,Kelly Stone,0,3,8,11
Franklin,102,Railroad Commissioner,,DEM,Kelly Stone,0,2,1,3
Franklin,201,Railroad Commissioner,,DEM,Kelly Stone,0,1,4,5
Franklin,202,Railroad Commissioner,,DEM,Kelly Stone,0,4,11,15
Franklin,301,Railroad Commissioner,,DEM,Kelly Stone,0,7,6,13
Franklin,302,Railroad Commissioner,,DEM,Kelly Stone,0,1,2,3
Franklin,401,Railroad Commissioner,,DEM,Kelly Stone,0,6,10,16
Franklin,402,Railroad Commissioner,,DEM,Kelly Stone,1,1,5,7
Franklin,101,Railroad Commissioner,,DEM,"Roberto R. ""Beto"" Alonzo",1,4,5,10
Franklin,102,Railroad Commissioner,,DEM,"Roberto R. ""Beto"" Alonzo",0,1,0,1
Franklin,201,Railroad Commissioner,,DEM,"Roberto R. ""Beto"" Alonzo",0,0,3,3
Franklin,202,Railroad Commissioner,,DEM,"Roberto R. ""Beto"" Alonzo",0,1,8,9
Franklin,301,Railroad Commissioner,,DEM,"Roberto R. ""Beto"" Alonzo",0,0,1,1
Franklin,302,Railroad Commissioner,,DEM,"Roberto R. ""Beto"" Alonzo",1,1,4,6
Franklin,401,Railroad Commissioner,,DEM,"Roberto R. ""Beto"" Alonzo",0,6,3,9
Franklin,402,Railroad Commissioner,,DEM,"Roberto R. ""Beto"" Alonzo",0,1,6,7
Franklin,101,State Senate,1,DEM,Audrey Spanko,3,27,25,55
Franklin,102,State Senate,1,DEM,Audrey Spanko,0,4,3,7
Franklin,201,State Senate,1,DEM,Audrey Spanko,2,3,11,16
Franklin,202,State Senate,1,DEM,Audrey Spanko,1,7,43,51
Franklin,301,State Senate,1,DEM,Audrey Spanko,3,12,20,35
Franklin,302,State Senate,1,DEM,Audrey Spanko,3,5,21,29
Franklin,401,State Senate,1,DEM,Audrey Spanko,1,20,35,56
Franklin,402,State Senate,1,DEM,Audrey Spanko,1,10,21,32