county,precinct,office,district,candidate,party,election_day,absentee,early_voting,votes
Gaines,2,Straight Party,,Republican Party REP,REP,76,9,177,262
Gaines,2,Straight Party,,Democratic Party DEM,DEM,3,1,6,10
Gaines,2,Straight Party,,Libertarian Party LIB,LIB,0,0,0,0
Gaines,2,U.S. Senate,,Ted Cruz,REP,88,12,211,311
Gaines,2,U.S. Senate,,Beto O'Rourke,DEM,9,2,9,20
Gaines,2,U.S. Senate,,Neal M. Dikeman,LIB,0,0,1,1
Gaines,2,U.S. House,19,Jodey Arrington,REP,87,12,210,309
Gaines,2,U.S. House,19,Miguel Levario,DEM,9,2,7,18
Gaines,2,Governor,,Greg Abbott,REP,89,12,209,310
Gaines,2,Governor,,Lupe Valdez,DEM,7,2,7,16
Gaines,2,Governor,,Mark Jay Tippetts,LIB,2,0,3,5
Gaines,2,Lieutenant Governor,,Dan Patrick,REP,84,12,202,298
Gaines,2,Lieutenant Governor,,Mike Collier,DEM,10,2,12,24
Gaines,2,Lieutenant Governor,,Kerry Douglas McKennon,LIB,0,0,3,3
Gaines,2,Attorney General,,Ken Paxton,REP,84,12,204,300
Gaines,2,Attorney General,,Justin Nelson,DEM,10,2,11,23
Gaines,2,Attorney General,,Michael Ray Harris,LIB,0,0,2,2
Gaines,2,Comptroller of Public Accounts,,Glenn Hegar,REP,86,12,207,305
Gaines,2,Comptroller of Public Accounts,,Joi Chevalier,DEM,9,2,6,17
Gaines,2,Comptroller of Public Accounts,,Ben Sanders,LIB,0,0,4,4
Gaines,2,Commissioner of the General Land Office,,George P. Bush,REP,85,10,200,295
Gaines,2,Commissioner of the General Land Office,,Miguel Suazo,DEM,10,2,9,21
Gaines,2,Commissioner of the General Land Office,,Matt PiÒa,LIB,1,2,4,7
Gaines,2,Commissioner of Agriculture,,Sid Miller,REP,84,12,204,300
Gaines,2,Commissioner of Agriculture,,Kim Olson,DEM,11,2,10,23
Gaines,2,Commissioner of Agriculture,,Richard Carpenter,LIB,0,0,4,4
Gaines,2,Railroad Commissioner,,Christi Craddick,REP,86,12,206,304
Gaines,2,Railroad Commissioner,,Roman McAllen,DEM,8,2,7,17
Gaines,2,Railroad Commissioner,,Mike Wright,LIB,0,0,5,5
Gaines,2,"Justice, Supreme Court, Place 2",,Jimmy Blacklock,REP,88,12,204,304
Gaines,2,"Justice, Supreme Court, Place 2",,Steven Kirkland,DEM,8,2,11,21
Gaines,2,"Justice, Supreme Court, Place 4",,John Devine,REP,89,12,208,309
Gaines,2,"Justice, Supreme Court, Place 4",,R.K. Sandill,DEM,7,2,7,16
Gaines,2,"Justice, Supreme Court, Place 6",,Jeff Brown,REP,87,12,208,307
Gaines,2,"Justice, Supreme Court, Place 6",,Kathy Cheng,DEM,8,2,7,17
Gaines,2,"Presiding Judge, Court of Criminal Appeals",,Sharon Keller,REP,85,12,202,299
Gaines,2,"Presiding Judge, Court of Criminal Appeals",,Maria T. (Terri) Jackson,DEM,8,2,11,21
Gaines,2,"Presiding Judge, Court of Criminal Appeals",,William Bryan Strange III,LIB,2,0,4,6
Gaines,2,"Judge, Court of Criminal Appeals, Place 7",,Barbara Parker Hervey,REP,86,12,208,306
Gaines,2,"Judge, Court of Criminal Appeals, Place 7",,Ramona Franklin,DEM,9,2,7,18
Gaines,2,"Judge, Court of Criminal Appeals, Place 8",,Michelle Slaughter,REP,90,13,207,310
Gaines,2,"Judge, Court of Criminal Appeals, Place 8",,Mark Ash,LIB,3,0,2,5
Gaines,2,State Senate,31,Kel Seliger,REP,88,13,205,306
Gaines,2,State Senate,31,Jack B. Westbrook,LIB,3,0,7,10
Gaines,2,State Representative,83,Dustin Burrows,REP,86,12,207,305
Gaines,2,State Representative,83,Drew Landry,DEM,9,2,10,21
Gaines,2,"Chief Justice, 11th Court of Appeals District",,John Bailey,REP,90,13,210,313
Gaines,2,"District Judge, 106th Judicial District",,Reed Filley,REP,90,13,212,315
Gaines,2 - Seminole,Straight Party,,Republican Party REP,REP,98,20,219,337
Gaines,2 - Seminole,Straight Party,,Democratic Party DEM,DEM,14,10,31,55
Gaines,2 - Seminole,Straight Party,,Libertarian Party LIB,LIB,0,0,1,1
Gaines,2 - Seminole,U.S. Senate,,Ted Cruz,REP,130,29,294,453
Gaines,2 - Seminole,U.S. Senate,,Beto O'Rourke,DEM,20,12,50,82
Gaines,2 - Seminole,U.S. Senate,,Neal M. Dikeman,LIB,2,0,2,4
Gaines,2 - Seminole,U.S. House,19,Jodey Arrington,REP,132,30,300,462
Gaines,2 - Seminole,U.S. House,19,Miguel Levario,DEM,20,11,46,77
Gaines,2 - Seminole,Governor,,Greg Abbott,REP,128,28,301,457
Gaines,2 - Seminole,Governor,,Lupe Valdez,DEM,21,12,47,80
Gaines,2 - Seminole,Governor,,Mark Jay Tippetts,LIB,3,0,1,4
Gaines,2 - Seminole,Lieutenant Governor,,Dan Patrick,REP,119,27,280,426
Gaines,2 - Seminole,Lieutenant Governor,,Mike Collier,DEM,26,13,63,102
Gaines,2 - Seminole,Lieutenant Governor,,Kerry Douglas McKennon,LIB,7,1,4,12
Gaines,2 - Seminole,Attorney General,,Ken Paxton,REP,125,27,283,435
Gaines,2 - Seminole,Attorney General,,Justin Nelson,DEM,22,12,58,92
Gaines,2 - Seminole,Attorney General,,Michael Ray Harris,LIB,5,0,8,13
Gaines,2 - Seminole,Comptroller of Public Accounts,,Glenn Hegar,REP,127,27,295,449
Gaines,2 - Seminole,Comptroller of Public Accounts,,Joi Chevalier,DEM,18,12,45,75
Gaines,2 - Seminole,Comptroller of Public Accounts,,Ben Sanders,LIB,6,0,7,13
Gaines,2 - Seminole,Commissioner of the General Land Office,,George P. Bush,REP,129,29,288,446
Gaines,2 - Seminole,Commissioner of the General Land Office,,Miguel Suazo,DEM,17,12,48,77
Gaines,2 - Seminole,Commissioner of the General Land Office,,Matt PiÒa,LIB,4,0,11,15
Gaines,2 - Seminole,Commissioner of Agriculture,,Sid Miller,REP,124,29,292,445
Gaines,2 - Seminole,Commissioner of Agriculture,,Kim Olson,DEM,23,11,51,85
Gaines,2 - Seminole,Commissioner of Agriculture,,Richard Carpenter,LIB,3,1,5,9
Gaines,2 - Seminole,Railroad Commissioner,,Christi Craddick,REP,128,29,292,449
Gaines,2 - Seminole,Railroad Commissioner,,Roman McAllen,DEM,18,11,48,77
Gaines,2 - Seminole,Railroad Commissioner,,Mike Wright,LIB,5,0,7,12
Gaines,2 - Seminole,"Justice, Supreme Court, Place 2",,Jimmy Blacklock,REP,128,27,299,454
Gaines,2 - Seminole,"Justice, Supreme Court, Place 2",,Steven Kirkland,DEM,23,12,48,83
Gaines,2 - Seminole,"Justice, Supreme Court, Place 4",,John Devine,REP,130,27,296,453
Gaines,2 - Seminole,"Justice, Supreme Court, Place 4",,R.K. Sandill,DEM,22,13,50,85
Gaines,2 - Seminole,"Justice, Supreme Court, Place 6",,Jeff Brown,REP,130,27,297,454
Gaines,2 - Seminole,"Justice, Supreme Court, Place 6",,Kathy Cheng,DEM,22,13,49,84
Gaines,2 - Seminole,"Presiding Judge, Court of Criminal Appeals",,Sharon Keller,REP,128,28,295,451
Gaines,2 - Seminole,"Presiding Judge, Court of Criminal Appeals",,Maria T. (Terri) Jackson,DEM,20,12,44,76
Gaines,2 - Seminole,"Presiding Judge, Court of Criminal Appeals",,William Bryan Strange III,LIB,4,0,8,12
Gaines,2 - Seminole,"Judge, Court of Criminal Appeals, Place 7",,Barbara Parker Hervey,REP,128,27,300,455
Gaines,2 - Seminole,"Judge, Court of Criminal Appeals, Place 7",,Ramona Franklin,DEM,24,13,46,83
Gaines,2 - Seminole,"Judge, Court of Criminal Appeals, Place 8",,Michelle Slaughter,REP,132,28,305,465
Gaines,2 - Seminole,"Judge, Court of Criminal Appeals, Place 8",,Mark Ash,LIB,15,3,21,39
Gaines,2 - Seminole,State Senate,31,Kel Seliger,REP,132,29,303,464
Gaines,2 - Seminole,State Senate,31,Jack B. Westbrook,LIB,16,1,26,43
Gaines,2 - Seminole,State Representative,83,Dustin Burrows,REP,126,29,296,451
Gaines,2 - Seminole,State Representative,83,Drew Landry,DEM,26,12,52,90
Gaines,2 - Seminole,"Chief Justice, 11th Court of Appeals District",,John Bailey,REP,143,29,316,488
Gaines,2 - Seminole,"District Judge, 106th Judicial District",,Reed Filley,REP,142,29,320,491
Gaines,3,Straight Party,,Republican Party REP,REP,109,10,372,491
Gaines,3,Straight Party,,Democratic Party DEM,DEM,13,3,13,29
Gaines,3,Straight Party,,Libertarian Party LIB,LIB,4,0,0,4
Gaines,3,U.S. Senate,,Ted Cruz,REP,132,17,447,596
Gaines,3,U.S. Senate,,Beto O'Rourke,DEM,20,4,22,46
Gaines,3,U.S. Senate,,Neal M. Dikeman,LIB,5,0,0,5
Gaines,3,U.S. House,19,Jodey Arrington,REP,136,17,453,606
Gaines,3,U.S. House,19,Miguel Levario,DEM,19,4,16,39
Gaines,3,Governor,,Greg Abbott,REP,134,17,442,593
Gaines,3,Governor,,Lupe Valdez,DEM,16,4,21,41
Gaines,3,Governor,,Mark Jay Tippetts,LIB,7,0,5,12
Gaines,3,Lieutenant Governor,,Dan Patrick,REP,118,15,421,554
Gaines,3,Lieutenant Governor,,Mike Collier,DEM,27,5,40,72
Gaines,3,Lieutenant Governor,,Kerry Douglas McKennon,LIB,11,0,4,15
Gaines,3,Attorney General,,Ken Paxton,REP,127,16,444,587
Gaines,3,Attorney General,,Justin Nelson,DEM,21,4,24,49
Gaines,3,Attorney General,,Michael Ray Harris,LIB,8,0,1,9
Gaines,3,Comptroller of Public Accounts,,Glenn Hegar,REP,129,16,449,594
Gaines,3,Comptroller of Public Accounts,,Joi Chevalier,DEM,18,4,16,38
Gaines,3,Comptroller of Public Accounts,,Ben Sanders,LIB,8,1,1,10
Gaines,3,Commissioner of the General Land Office,,George P. Bush,REP,127,14,436,577
Gaines,3,Commissioner of the General Land Office,,Miguel Suazo,DEM,16,5,16,37
Gaines,3,Commissioner of the General Land Office,,Matt PiÒa,LIB,13,0,10,23
Gaines,3,Commissioner of Agriculture,,Sid Miller,REP,130,16,448,594
Gaines,3,Commissioner of Agriculture,,Kim Olson,DEM,19,5,17,41
Gaines,3,Commissioner of Agriculture,,Richard Carpenter,LIB,6,0,2,8
Gaines,3,Railroad Commissioner,,Christi Craddick,REP,130,15,448,593
Gaines,3,Railroad Commissioner,,Roman McAllen,DEM,19,6,17,42
Gaines,3,Railroad Commissioner,,Mike Wright,LIB,7,0,1,8
Gaines,3,"Justice, Supreme Court, Place 2",,Jimmy Blacklock,REP,132,15,448,595
Gaines,3,"Justice, Supreme Court, Place 2",,Steven Kirkland,DEM,22,5,17,44
Gaines,3,"Justice, Supreme Court, Place 4",,John Devine,REP,132,15,446,593
Gaines,3,"Justice, Supreme Court, Place 4",,R.K. Sandill,DEM,22,5,17,44
Gaines,3,"Justice, Supreme Court, Place 6",,Jeff Brown,REP,133,16,448,597
Gaines,3,"Justice, Supreme Court, Place 6",,Kathy Cheng,DEM,22,4,17,43
Gaines,3,"Presiding Judge, Court of Criminal Appeals",,Sharon Keller,REP,129,14,445,588
Gaines,3,"Presiding Judge, Court of Criminal Appeals",,Maria T. (Terri) Jackson,DEM,19,4,17,40
Gaines,3,"Presiding Judge, Court of Criminal Appeals",,William Bryan Strange III,LIB,8,2,3,13
Gaines,3,"Judge, Court of Criminal Appeals, Place 7",,Barbara Parker Hervey,REP,134,14,448,596
Gaines,3,"Judge, Court of Criminal Appeals, Place 7",,Ramona Franklin,DEM,20,6,17,43
Gaines,3,"Judge, Court of Criminal Appeals, Place 8",,Michelle Slaughter,REP,136,17,446,599
Gaines,3,"Judge, Court of Criminal Appeals, Place 8",,Mark Ash,LIB,13,0,7,20
Gaines,3,State Senate,31,Kel Seliger,REP,133,16,448,597
Gaines,3,State Senate,31,Jack B. Westbrook,LIB,17,1,12,30
Gaines,3,State Representative,83,Dustin Burrows,REP,132,17,436,585
Gaines,3,State Representative,83,Drew Landry,DEM,21,4,30,55
Gaines,3,"Chief Justice, 11th Court of Appeals District",,John Bailey,REP,137,17,451,605
Gaines,3,"District Judge, 106th Judicial District",,Reed Filley,REP,137,17,451,605
Gaines,3 - Seminole,Straight Party,,Republican Party REP,REP,91,17,279,387
Gaines,3 - Seminole,Straight Party,,Democratic Party DEM,DEM,4,4,15,23
Gaines,3 - Seminole,Straight Party,,Libertarian Party LIB,LIB,1,0,2,3
Gaines,3 - Seminole,U.S. Senate,,Ted Cruz,REP,119,28,392,539
Gaines,3 - Seminole,U.S. Senate,,Beto O'Rourke,DEM,20,11,37,68
Gaines,3 - Seminole,U.S. Senate,,Neal M. Dikeman,LIB,2,0,2,4
Gaines,3 - Seminole,U.S. House,19,Jodey Arrington,REP,128,30,398,556
Gaines,3 - Seminole,U.S. House,19,Miguel Levario,DEM,12,9,31,52
Gaines,3 - Seminole,Governor,,Greg Abbott,REP,124,27,385,536
Gaines,3 - Seminole,Governor,,Lupe Valdez,DEM,13,10,31,54
Gaines,3 - Seminole,Governor,,Mark Jay Tippetts,LIB,5,1,10,16
Gaines,3 - Seminole,Lieutenant Governor,,Dan Patrick,REP,111,25,340,476
Gaines,3 - Seminole,Lieutenant Governor,,Mike Collier,DEM,24,12,74,110
Gaines,3 - Seminole,Lieutenant Governor,,Kerry Douglas McKennon,LIB,2,0,11,13
Gaines,3 - Seminole,Attorney General,,Ken Paxton,REP,119,25,379,523
Gaines,3 - Seminole,Attorney General,,Justin Nelson,DEM,15,12,41,68
Gaines,3 - Seminole,Attorney General,,Michael Ray Harris,LIB,3,0,7,10
Gaines,3 - Seminole,Comptroller of Public Accounts,,Glenn Hegar,REP,122,27,386,535
Gaines,3 - Seminole,Comptroller of Public Accounts,,Joi Chevalier,DEM,13,9,29,51
Gaines,3 - Seminole,Comptroller of Public Accounts,,Ben Sanders,LIB,2,0,7,9
Gaines,3 - Seminole,Commissioner of the General Land Office,,George P. Bush,REP,119,28,382,529
Gaines,3 - Seminole,Commissioner of the General Land Office,,Miguel Suazo,DEM,10,10,37,57
Gaines,3 - Seminole,Commissioner of the General Land Office,,Matt PiÒa,LIB,9,0,8,17
Gaines,3 - Seminole,Commissioner of Agriculture,,Sid Miller,REP,121,26,392,539
Gaines,3 - Seminole,Commissioner of Agriculture,,Kim Olson,DEM,14,11,30,55
Gaines,3 - Seminole,Commissioner of Agriculture,,Richard Carpenter,LIB,3,0,5,8
Gaines,3 - Seminole,Railroad Commissioner,,Christi Craddick,REP,121,28,394,543
Gaines,3 - Seminole,Railroad Commissioner,,Roman McAllen,DEM,12,9,27,48
Gaines,3 - Seminole,Railroad Commissioner,,Mike Wright,LIB,4,0,6,10
Gaines,3 - Seminole,"Justice, Supreme Court, Place 2",,Jimmy Blacklock,REP,123,27,393,543
Gaines,3 - Seminole,"Justice, Supreme Court, Place 2",,Steven Kirkland,DEM,14,9,29,52
Gaines,3 - Seminole,"Justice, Supreme Court, Place 4",,John Devine,REP,124,26,394,544
Gaines,3 - Seminole,"Justice, Supreme Court, Place 4",,R.K. Sandill,DEM,12,10,29,51
Gaines,3 - Seminole,"Justice, Supreme Court, Place 6",,Jeff Brown,REP,126,26,393,545
Gaines,3 - Seminole,"Justice, Supreme Court, Place 6",,Kathy Cheng,DEM,10,10,29,49
Gaines,3 - Seminole,"Presiding Judge, Court of Criminal Appeals",,Sharon Keller,REP,122,26,389,537
Gaines,3 - Seminole,"Presiding Judge, Court of Criminal Appeals",,Maria T. (Terri) Jackson,DEM,12,10,28,50
Gaines,3 - Seminole,"Presiding Judge, Court of Criminal Appeals",,William Bryan Strange III,LIB,3,0,6,9
Gaines,3 - Seminole,"Judge, Court of Criminal Appeals, Place 7",,Barbara Parker Hervey,REP,127,28,393,548
Gaines,3 - Seminole,"Judge, Court of Criminal Appeals, Place 7",,Ramona Franklin,DEM,10,8,27,45
Gaines,3 - Seminole,"Judge, Court of Criminal Appeals, Place 8",,Michelle Slaughter,REP,126,29,393,548
Gaines,3 - Seminole,"Judge, Court of Criminal Appeals, Place 8",,Mark Ash,LIB,10,4,21,35
Gaines,3 - Seminole,State Senate,31,Kel Seliger,REP,126,31,395,552
Gaines,3 - Seminole,State Senate,31,Jack B. Westbrook,LIB,13,4,27,44
Gaines,3 - Seminole,State Representative,83,Dustin Burrows,REP,123,27,383,533
Gaines,3 - Seminole,State Representative,83,Drew Landry,DEM,15,10,45,70
Gaines,3 - Seminole,"Chief Justice, 11th Court of Appeals District",,John Bailey,REP,130,28,398,556
Gaines,3 - Seminole,"District Judge, 106th Judicial District",,Reed Filley,REP,131,29,404,564
Gaines,4,Straight Party,,Republican Party REP,REP,24,7,94,125
Gaines,4,Straight Party,,Democratic Party DEM,DEM,3,1,0,4
Gaines,4,Straight Party,,Libertarian Party LIB,LIB,0,0,0,0
Gaines,4,U.S. Senate,,Ted Cruz,REP,28,7,109,144
Gaines,4,U.S. Senate,,Beto O'Rourke,DEM,7,1,2,10
Gaines,4,U.S. Senate,,Neal M. Dikeman,LIB,0,0,0,0
Gaines,4,U.S. House,19,Jodey Arrington,REP,29,7,110,146
Gaines,4,U.S. House,19,Miguel Levario,DEM,6,1,2,9
Gaines,4,Governor,,Greg Abbott,REP,29,7,109,145
Gaines,4,Governor,,Lupe Valdez,DEM,6,1,2,9
Gaines,4,Governor,,Mark Jay Tippetts,LIB,0,0,0,0
Gaines,4,Lieutenant Governor,,Dan Patrick,REP,28,7,102,137
Gaines,4,Lieutenant Governor,,Mike Collier,DEM,6,1,7,14
Gaines,4,Lieutenant Governor,,Kerry Douglas McKennon,LIB,1,0,1,2
Gaines,4,Attorney General,,Ken Paxton,REP,29,7,104,140
Gaines,4,Attorney General,,Justin Nelson,DEM,5,1,3,9
Gaines,4,Attorney General,,Michael Ray Harris,LIB,1,0,1,2
Gaines,4,Comptroller of Public Accounts,,Glenn Hegar,REP,29,7,107,143
Gaines,4,Comptroller of Public Accounts,,Joi Chevalier,DEM,4,1,0,5
Gaines,4,Comptroller of Public Accounts,,Ben Sanders,LIB,1,0,0,1
Gaines,4,Commissioner of the General Land Office,,George P. Bush,REP,29,7,107,143
Gaines,4,Commissioner of the General Land Office,,Miguel Suazo,DEM,5,1,0,6
Gaines,4,Commissioner of the General Land Office,,Matt PiÒa,LIB,1,0,2,3
Gaines,4,Commissioner of Agriculture,,Sid Miller,REP,29,7,110,146
Gaines,4,Commissioner of Agriculture,,Kim Olson,DEM,5,1,0,6
Gaines,4,Commissioner of Agriculture,,Richard Carpenter,LIB,0,0,0,0
Gaines,4,Railroad Commissioner,,Christi Craddick,REP,29,7,109,145
Gaines,4,Railroad Commissioner,,Roman McAllen,DEM,4,1,1,6
Gaines,4,Railroad Commissioner,,Mike Wright,LIB,1,0,0,1
Gaines,4,"Justice, Supreme Court, Place 2",,Jimmy Blacklock,REP,30,7,110,147
Gaines,4,"Justice, Supreme Court, Place 2",,Steven Kirkland,DEM,5,1,0,6
Gaines,4,"Justice, Supreme Court, Place 4",,John Devine,REP,29,7,110,146
Gaines,4,"Justice, Supreme Court, Place 4",,R.K. Sandill,DEM,5,1,0,6
Gaines,4,"Justice, Supreme Court, Place 6",,Jeff Brown,REP,29,7,109,145
Gaines,4,"Justice, Supreme Court, Place 6",,Kathy Cheng,DEM,5,1,0,6
Gaines,4,"Presiding Judge, Court of Criminal Appeals",,Sharon Keller,REP,30,7,108,145
Gaines,4,"Presiding Judge, Court of Criminal Appeals",,Maria T. (Terri) Jackson,DEM,4,1,1,6
Gaines,4,"Presiding Judge, Court of Criminal Appeals",,William Bryan Strange III,LIB,1,0,0,1
Gaines,4,"Judge, Court of Criminal Appeals, Place 7",,Barbara Parker Hervey,REP,29,7,108,144
Gaines,4,"Judge, Court of Criminal Appeals, Place 7",,Ramona Franklin,DEM,5,1,1,7
Gaines,4,"Judge, Court of Criminal Appeals, Place 8",,Michelle Slaughter,REP,30,7,109,146
Gaines,4,"Judge, Court of Criminal Appeals, Place 8",,Mark Ash,LIB,3,0,0,3
Gaines,4,State Senate,31,Kel Seliger,REP,29,7,110,146
Gaines,4,State Senate,31,Jack B. Westbrook,LIB,5,0,0,5
Gaines,4,State Representative,83,Dustin Burrows,REP,29,7,109,145
Gaines,4,State Representative,83,Drew Landry,DEM,5,1,3,9
Gaines,4,"Chief Justice, 11th Court of Appeals District",,John Bailey,REP,29,7,110,146
Gaines,4,"District Judge, 106th Judicial District",,Reed Filley,REP,30,7,109,146
Gaines,4 - Seminole,Straight Party,,Republican Party REP,REP,75,13,151,239
Gaines,4 - Seminole,Straight Party,,Democratic Party DEM,DEM,26,5,32,63
Gaines,4 - Seminole,Straight Party,,Libertarian Party LIB,LIB,1,0,0,1
Gaines,4 - Seminole,U.S. Senate,,Ted Cruz,REP,85,18,208,311
Gaines,4 - Seminole,U.S. Senate,,Beto O'Rourke,DEM,33,7,40,80
Gaines,4 - Seminole,U.S. Senate,,Neal M. Dikeman,LIB,2,0,1,3
Gaines,4 - Seminole,U.S. House,19,Jodey Arrington,REP,85,17,204,306
Gaines,4 - Seminole,U.S. House,19,Miguel Levario,DEM,32,7,42,81
Gaines,4 - Seminole,Governor,,Greg Abbott,REP,85,18,201,304
Gaines,4 - Seminole,Governor,,Lupe Valdez,DEM,31,6,42,79
Gaines,4 - Seminole,Governor,,Mark Jay Tippetts,LIB,2,1,4,7
Gaines,4 - Seminole,Lieutenant Governor,,Dan Patrick,REP,82,18,192,292
Gaines,4 - Seminole,Lieutenant Governor,,Mike Collier,DEM,31,7,49,87
Gaines,4 - Seminole,Lieutenant Governor,,Kerry Douglas McKennon,LIB,6,0,5,11
Gaines,4 - Seminole,Attorney General,,Ken Paxton,REP,85,18,200,303
Gaines,4 - Seminole,Attorney General,,Justin Nelson,DEM,30,7,43,80
Gaines,4 - Seminole,Attorney General,,Michael Ray Harris,LIB,4,0,2,6
Gaines,4 - Seminole,Comptroller of Public Accounts,,Glenn Hegar,REP,86,18,200,304
Gaines,4 - Seminole,Comptroller of Public Accounts,,Joi Chevalier,DEM,28,7,40,75
Gaines,4 - Seminole,Comptroller of Public Accounts,,Ben Sanders,LIB,5,0,2,7
Gaines,4 - Seminole,Commissioner of the General Land Office,,George P. Bush,REP,82,16,200,298
Gaines,4 - Seminole,Commissioner of the General Land Office,,Miguel Suazo,DEM,29,6,41,76
Gaines,4 - Seminole,Commissioner of the General Land Office,,Matt PiÒa,LIB,7,3,4,14
Gaines,4 - Seminole,Commissioner of Agriculture,,Sid Miller,REP,88,18,203,309
Gaines,4 - Seminole,Commissioner of Agriculture,,Kim Olson,DEM,29,7,40,76
Gaines,4 - Seminole,Commissioner of Agriculture,,Richard Carpenter,LIB,2,0,1,3
Gaines,4 - Seminole,Railroad Commissioner,,Christi Craddick,REP,86,16,204,306
Gaines,4 - Seminole,Railroad Commissioner,,Roman McAllen,DEM,27,7,38,72
Gaines,4 - Seminole,Railroad Commissioner,,Mike Wright,LIB,6,2,3,11
Gaines,4 - Seminole,"Justice, Supreme Court, Place 2",,Jimmy Blacklock,REP,86,17,202,305
Gaines,4 - Seminole,"Justice, Supreme Court, Place 2",,Steven Kirkland,DEM,31,6,41,78
Gaines,4 - Seminole,"Justice, Supreme Court, Place 4",,John Devine,REP,88,17,202,307
Gaines,4 - Seminole,"Justice, Supreme Court, Place 4",,R.K. Sandill,DEM,30,6,41,77
Gaines,4 - Seminole,"Justice, Supreme Court, Place 6",,Jeff Brown,REP,86,17,200,303
Gaines,4 - Seminole,"Justice, Supreme Court, Place 6",,Kathy Cheng,DEM,33,6,41,80
Gaines,4 - Seminole,"Presiding Judge, Court of Criminal Appeals",,Sharon Keller,REP,88,17,202,307
Gaines,4 - Seminole,"Presiding Judge, Court of Criminal Appeals",,Maria T. (Terri) Jackson,DEM,29,5,40,74
Gaines,4 - Seminole,"Presiding Judge, Court of Criminal Appeals",,William Bryan Strange III,LIB,2,1,1,4
Gaines,4 - Seminole,"Judge, Court of Criminal Appeals, Place 7",,Barbara Parker Hervey,REP,87,18,202,307
Gaines,4 - Seminole,"Judge, Court of Criminal Appeals, Place 7",,Ramona Franklin,DEM,32,5,41,78
Gaines,4 - Seminole,"Judge, Court of Criminal Appeals, Place 8",,Michelle Slaughter,REP,94,15,208,317
Gaines,4 - Seminole,"Judge, Court of Criminal Appeals, Place 8",,Mark Ash,LIB,14,4,24,42
Gaines,4 - Seminole,State Senate,31,Kel Seliger,REP,90,16,207,313
Gaines,4 - Seminole,State Senate,31,Jack B. Westbrook,LIB,17,3,28,48
Gaines,4 - Seminole,State Representative,83,Dustin Burrows,REP,86,17,197,300
Gaines,4 - Seminole,State Representative,83,Drew Landry,DEM,33,6,45,84
Gaines,4 - Seminole,"Chief Justice, 11th Court of Appeals District",,John Bailey,REP,99,17,215,331
Gaines,4 - Seminole,"District Judge, 106th Judicial District",,Reed Filley,REP,98,18,215,331
Gaines,5,Straight Party,,Republican Party REP,REP,1,0,0,1
Gaines,5,Straight Party,,Democratic Party DEM,DEM,0,0,0,0
Gaines,5,Straight Party,,Libertarian Party LIB,LIB,0,0,0,0
Gaines,5,U.S. Senate,,Ted Cruz,REP,1,0,0,1
Gaines,5,U.S. Senate,,Beto O'Rourke,DEM,0,0,0,0
Gaines,5,U.S. Senate,,Neal M. Dikeman,LIB,0,0,0,0
Gaines,5,U.S. House,19,Jodey Arrington,REP,1,0,0,1
Gaines,5,U.S. House,19,Miguel Levario,DEM,0,0,0,0
Gaines,5,Governor,,Greg Abbott,REP,1,0,0,1
Gaines,5,Governor,,Lupe Valdez,DEM,0,0,0,0
Gaines,5,Governor,,Mark Jay Tippetts,LIB,0,0,0,0
Gaines,5,Lieutenant Governor,,Dan Patrick,REP,1,0,0,1
Gaines,5,Lieutenant Governor,,Mike Collier,DEM,0,0,0,0
Gaines,5,Lieutenant Governor,,Kerry Douglas McKennon,LIB,0,0,0,0
Gaines,5,Attorney General,,Ken Paxton,REP,1,0,0,1
Gaines,5,Attorney General,,Justin Nelson,DEM,0,0,0,0
Gaines,5,Attorney General,,Michael Ray Harris,LIB,0,0,0,0
Gaines,5,Comptroller of Public Accounts,,Glenn Hegar,REP,1,0,0,1
Gaines,5,Comptroller of Public Accounts,,Joi Chevalier,DEM,0,0,0,0
Gaines,5,Comptroller of Public Accounts,,Ben Sanders,LIB,0,0,0,0
Gaines,5,Commissioner of the General Land Office,,George P. Bush,REP,1,0,0,1
Gaines,5,Commissioner of the General Land Office,,Miguel Suazo,DEM,0,0,0,0
Gaines,5,Commissioner of the General Land Office,,Matt PiÒa,LIB,0,0,0,0
Gaines,5,Commissioner of Agriculture,,Sid Miller,REP,1,0,0,1
Gaines,5,Commissioner of Agriculture,,Kim Olson,DEM,0,0,0,0
Gaines,5,Commissioner of Agriculture,,Richard Carpenter,LIB,0,0,0,0
Gaines,5,Railroad Commissioner,,Christi Craddick,REP,1,0,0,1
Gaines,5,Railroad Commissioner,,Roman McAllen,DEM,0,0,0,0
Gaines,5,Railroad Commissioner,,Mike Wright,LIB,0,0,0,0
Gaines,5,"Justice, Supreme Court, Place 2",,Jimmy Blacklock,REP,1,0,0,1
Gaines,5,"Justice, Supreme Court, Place 2",,Steven Kirkland,DEM,0,0,0,0
Gaines,5,"Justice, Supreme Court, Place 4",,John Devine,REP,1,0,0,1
Gaines,5,"Justice, Supreme Court, Place 4",,R.K. Sandill,DEM,0,0,0,0
Gaines,5,"Justice, Supreme Court, Place 6",,Jeff Brown,REP,1,0,0,1
Gaines,5,"Justice, Supreme Court, Place 6",,Kathy Cheng,DEM,0,0,0,0
Gaines,5,"Presiding Judge, Court of Criminal Appeals",,Sharon Keller,REP,1,0,0,1
Gaines,5,"Presiding Judge, Court of Criminal Appeals",,Maria T. (Terri) Jackson,DEM,0,0,0,0
Gaines,5,"Presiding Judge, Court of Criminal Appeals",,William Bryan Strange III,LIB,0,0,0,0
Gaines,5,"Judge, Court of Criminal Appeals, Place 7",,Barbara Parker Hervey,REP,1,0,0,1
Gaines,5,"Judge, Court of Criminal Appeals, Place 7",,Ramona Franklin,DEM,0,0,0,0
Gaines,5,"Judge, Court of Criminal Appeals, Place 8",,Michelle Slaughter,REP,1,0,0,1
Gaines,5,"Judge, Court of Criminal Appeals, Place 8",,Mark Ash,LIB,0,0,0,0
Gaines,5,State Senate,31,Kel Seliger,REP,1,0,0,1
Gaines,5,State Senate,31,Jack B. Westbrook,LIB,0,0,0,0
Gaines,5,State Representative,83,Dustin Burrows,REP,1,0,0,1
Gaines,5,State Representative,83,Drew Landry,DEM,0,0,0,0
Gaines,5,"Chief Justice, 11th Court of Appeals District",,John Bailey,REP,1,0,0,1
Gaines,5,"District Judge, 106th Judicial District",,Reed Filley,REP,1,0,0,1
Gaines,5 - Loop,Straight Party,,Republican Party REP,REP,36,3,36,75
Gaines,5 - Loop,Straight Party,,Democratic Party DEM,DEM,4,0,2,6
Gaines,5 - Loop,Straight Party,,Libertarian Party LIB,LIB,0,0,1,1
Gaines,5 - Loop,U.S. Senate,,Ted Cruz,REP,71,4,53,128
Gaines,5 - Loop,U.S. Senate,,Beto O'Rourke,DEM,8,0,3,11
Gaines,5 - Loop,U.S. Senate,,Neal M. Dikeman,LIB,0,0,0,0
Gaines,5 - Loop,U.S. House,19,Jodey Arrington,REP,72,4,52,128
Gaines,5 - Loop,U.S. House,19,Miguel Levario,DEM,7,0,2,9
Gaines,5 - Loop,Governor,,Greg Abbott,REP,68,4,52,124
Gaines,5 - Loop,Governor,,Lupe Valdez,DEM,8,0,3,11
Gaines,5 - Loop,Governor,,Mark Jay Tippetts,LIB,1,0,0,1
Gaines,5 - Loop,Lieutenant Governor,,Dan Patrick,REP,56,4,54,114
Gaines,5 - Loop,Lieutenant Governor,,Mike Collier,DEM,18,0,2,20
Gaines,5 - Loop,Lieutenant Governor,,Kerry Douglas McKennon,LIB,3,0,0,3
Gaines,5 - Loop,Attorney General,,Ken Paxton,REP,65,4,52,121
Gaines,5 - Loop,Attorney General,,Justin Nelson,DEM,9,0,3,12
Gaines,5 - Loop,Attorney General,,Michael Ray Harris,LIB,2,0,0,2
Gaines,5 - Loop,Comptroller of Public Accounts,,Glenn Hegar,REP,66,4,52,122
Gaines,5 - Loop,Comptroller of Public Accounts,,Joi Chevalier,DEM,10,0,3,13
Gaines,5 - Loop,Comptroller of Public Accounts,,Ben Sanders,LIB,0,0,0,0
Gaines,5 - Loop,Commissioner of the General Land Office,,George P. Bush,REP,69,4,48,121
Gaines,5 - Loop,Commissioner of the General Land Office,,Miguel Suazo,DEM,7,0,4,11
Gaines,5 - Loop,Commissioner of the General Land Office,,Matt PiÒa,LIB,0,0,3,3
Gaines,5 - Loop,Commissioner of Agriculture,,Sid Miller,REP,65,4,51,120
Gaines,5 - Loop,Commissioner of Agriculture,,Kim Olson,DEM,11,0,3,14
Gaines,5 - Loop,Commissioner of Agriculture,,Richard Carpenter,LIB,0,0,0,0
Gaines,5 - Loop,Railroad Commissioner,,Christi Craddick,REP,66,4,51,121
Gaines,5 - Loop,Railroad Commissioner,,Roman McAllen,DEM,9,0,2,11
Gaines,5 - Loop,Railroad Commissioner,,Mike Wright,LIB,1,0,1,2
Gaines,5 - Loop,"Justice, Supreme Court, Place 2",,Jimmy Blacklock,REP,63,4,51,118
Gaines,5 - Loop,"Justice, Supreme Court, Place 2",,Steven Kirkland,DEM,11,0,3,14
Gaines,5 - Loop,"Justice, Supreme Court, Place 4",,John Devine,REP,66,4,52,122
Gaines,5 - Loop,"Justice, Supreme Court, Place 4",,R.K. Sandill,DEM,9,0,2,11
Gaines,5 - Loop,"Justice, Supreme Court, Place 6",,Jeff Brown,REP,66,4,51,121
Gaines,5 - Loop,"Justice, Supreme Court, Place 6",,Kathy Cheng,DEM,9,0,3,12
Gaines,5 - Loop,"Presiding Judge, Court of Criminal Appeals",,Sharon Keller,REP,68,4,52,124
Gaines,5 - Loop,"Presiding Judge, Court of Criminal Appeals",,Maria T. (Terri) Jackson,DEM,8,0,2,10
Gaines,5 - Loop,"Presiding Judge, Court of Criminal Appeals",,William Bryan Strange III,LIB,0,0,0,0
Gaines,5 - Loop,"Judge, Court of Criminal Appeals, Place 7",,Barbara Parker Hervey,REP,66,4,52,122
Gaines,5 - Loop,"Judge, Court of Criminal Appeals, Place 7",,Ramona Franklin,DEM,8,0,2,10
Gaines,5 - Loop,"Judge, Court of Criminal Appeals, Place 8",,Michelle Slaughter,REP,68,4,52,124
Gaines,5 - Loop,"Judge, Court of Criminal Appeals, Place 8",,Mark Ash,LIB,3,0,1,4
Gaines,5 - Loop,State Senate,31,Kel Seliger,REP,68,4,53,125
Gaines,5 - Loop,State Senate,31,Jack B. Westbrook,LIB,5,0,2,7
Gaines,5 - Loop,State Representative,83,Dustin Burrows,REP,67,4,53,124
Gaines,5 - Loop,State Representative,83,Drew Landry,DEM,10,0,3,13
Gaines,5 - Loop,"Chief Justice, 11th Court of Appeals District",,John Bailey,REP,69,4,53,126
Gaines,5 - Loop,"District Judge, 106th Judicial District",,Reed Filley,REP,69,4,53,126
Gaines,6,Straight Party,,Republican Party REP,REP,39,0,25,64
Gaines,6,Straight Party,,Democratic Party DEM,DEM,15,0,5,20
Gaines,6,Straight Party,,Libertarian Party LIB,LIB,1,0,0,1
Gaines,6,U.S. Senate,,Ted Cruz,REP,45,2,33,80
Gaines,6,U.S. Senate,,Beto O'Rourke,DEM,19,0,6,25
Gaines,6,U.S. Senate,,Neal M. Dikeman,LIB,0,0,0,0
Gaines,6,U.S. House,19,Jodey Arrington,REP,47,2,34,83
Gaines,6,U.S. House,19,Miguel Levario,DEM,16,0,5,21
Gaines,6,Governor,,Greg Abbott,REP,45,2,34,81
Gaines,6,Governor,,Lupe Valdez,DEM,16,0,5,21
Gaines,6,Governor,,Mark Jay Tippetts,LIB,2,0,0,2
Gaines,6,Lieutenant Governor,,Dan Patrick,REP,44,2,31,77
Gaines,6,Lieutenant Governor,,Mike Collier,DEM,19,0,8,27
Gaines,6,Lieutenant Governor,,Kerry Douglas McKennon,LIB,1,0,0,1
Gaines,6,Attorney General,,Ken Paxton,REP,45,2,31,78
Gaines,6,Attorney General,,Justin Nelson,DEM,18,0,7,25
Gaines,6,Attorney General,,Michael Ray Harris,LIB,1,0,0,1
Gaines,6,Comptroller of Public Accounts,,Glenn Hegar,REP,47,2,34,83
Gaines,6,Comptroller of Public Accounts,,Joi Chevalier,DEM,16,0,5,21
Gaines,6,Comptroller of Public Accounts,,Ben Sanders,LIB,1,0,0,1
Gaines,6,Commissioner of the General Land Office,,George P. Bush,REP,48,0,33,81
Gaines,6,Commissioner of the General Land Office,,Miguel Suazo,DEM,16,0,5,21
Gaines,6,Commissioner of the General Land Office,,Matt PiÒa,LIB,0,2,1,3
Gaines,6,Commissioner of Agriculture,,Sid Miller,REP,45,2,33,80
Gaines,6,Commissioner of Agriculture,,Kim Olson,DEM,17,0,5,22
Gaines,6,Commissioner of Agriculture,,Richard Carpenter,LIB,2,0,0,2
Gaines,6,Railroad Commissioner,,Christi Craddick,REP,45,2,34,81
Gaines,6,Railroad Commissioner,,Roman McAllen,DEM,18,0,4,22
Gaines,6,Railroad Commissioner,,Mike Wright,LIB,1,0,0,1
Gaines,6,"Justice, Supreme Court, Place 2",,Jimmy Blacklock,REP,46,2,34,82
Gaines,6,"Justice, Supreme Court, Place 2",,Steven Kirkland,DEM,18,0,4,22
Gaines,6,"Justice, Supreme Court, Place 4",,John Devine,REP,48,2,34,84
Gaines,6,"Justice, Supreme Court, Place 4",,R.K. Sandill,DEM,16,0,4,20
Gaines,6,"Justice, Supreme Court, Place 6",,Jeff Brown,REP,47,2,33,82
Gaines,6,"Justice, Supreme Court, Place 6",,Kathy Cheng,DEM,17,0,5,22
Gaines,6,"Presiding Judge, Court of Criminal Appeals",,Sharon Keller,REP,47,2,34,83
Gaines,6,"Presiding Judge, Court of Criminal Appeals",,Maria T. (Terri) Jackson,DEM,16,0,4,20
Gaines,6,"Presiding Judge, Court of Criminal Appeals",,William Bryan Strange III,LIB,1,0,0,1
Gaines,6,"Judge, Court of Criminal Appeals, Place 7",,Barbara Parker Hervey,REP,48,2,34,84
Gaines,6,"Judge, Court of Criminal Appeals, Place 7",,Ramona Franklin,DEM,16,0,5,21
Gaines,6,"Judge, Court of Criminal Appeals, Place 8",,Michelle Slaughter,REP,49,2,34,85
Gaines,6,"Judge, Court of Criminal Appeals, Place 8",,Mark Ash,LIB,8,0,1,9
Gaines,6,State Senate,31,Kel Seliger,REP,50,2,34,86
Gaines,6,State Senate,31,Jack B. Westbrook,LIB,7,0,3,10
Gaines,6,State Representative,83,Dustin Burrows,REP,46,2,34,82
Gaines,6,State Representative,83,Drew Landry,DEM,18,0,5,23
Gaines,6,"Chief Justice, 11th Court of Appeals District",,John Bailey,REP,53,2,35,90
Gaines,6,"District Judge, 106th Judicial District",,Reed Filley,REP,53,2,35,90
Gaines,7 - Seagraves,Straight Party,,Republican Party REP,REP,30,3,48,81
Gaines,7 - Seagraves,Straight Party,,Democratic Party DEM,DEM,41,0,20,61
Gaines,7 - Seagraves,Straight Party,,Libertarian Party LIB,LIB,0,0,0,0
Gaines,7 - Seagraves,U.S. Senate,,Ted Cruz,REP,36,3,63,102
Gaines,7 - Seagraves,U.S. Senate,,Beto O'Rourke,DEM,46,0,24,70
Gaines,7 - Seagraves,U.S. Senate,,Neal M. Dikeman,LIB,0,0,0,0
Gaines,7 - Seagraves,U.S. House,19,Jodey Arrington,REP,37,3,63,103
Gaines,7 - Seagraves,U.S. House,19,Miguel Levario,DEM,45,0,25,70
Gaines,7 - Seagraves,Governor,,Greg Abbott,REP,37,3,61,101
Gaines,7 - Seagraves,Governor,,Lupe Valdez,DEM,44,0,25,69
Gaines,7 - Seagraves,Governor,,Mark Jay Tippetts,LIB,1,0,0,1
Gaines,7 - Seagraves,Lieutenant Governor,,Dan Patrick,REP,32,3,59,94
Gaines,7 - Seagraves,Lieutenant Governor,,Mike Collier,DEM,47,0,28,75
Gaines,7 - Seagraves,Lieutenant Governor,,Kerry Douglas McKennon,LIB,3,0,0,3
Gaines,7 - Seagraves,Attorney General,,Ken Paxton,REP,37,3,59,99
Gaines,7 - Seagraves,Attorney General,,Justin Nelson,DEM,44,0,28,72
Gaines,7 - Seagraves,Attorney General,,Michael Ray Harris,LIB,1,0,1,2
Gaines,7 - Seagraves,Comptroller of Public Accounts,,Glenn Hegar,REP,36,3,61,100
Gaines,7 - Seagraves,Comptroller of Public Accounts,,Joi Chevalier,DEM,41,0,25,66
Gaines,7 - Seagraves,Comptroller of Public Accounts,,Ben Sanders,LIB,4,0,1,5
Gaines,7 - Seagraves,Commissioner of the General Land Office,,George P. Bush,REP,37,3,59,99
Gaines,7 - Seagraves,Commissioner of the General Land Office,,Miguel Suazo,DEM,44,0,26,70
Gaines,7 - Seagraves,Commissioner of the General Land Office,,Matt PiÒa,LIB,1,0,1,2
Gaines,7 - Seagraves,Commissioner of Agriculture,,Sid Miller,REP,38,3,59,100
Gaines,7 - Seagraves,Commissioner of Agriculture,,Kim Olson,DEM,43,0,27,70
Gaines,7 - Seagraves,Commissioner of Agriculture,,Richard Carpenter,LIB,1,0,0,1
Gaines,7 - Seagraves,Railroad Commissioner,,Christi Craddick,REP,36,3,60,99
Gaines,7 - Seagraves,Railroad Commissioner,,Roman McAllen,DEM,43,0,23,66
Gaines,7 - Seagraves,Railroad Commissioner,,Mike Wright,LIB,3,0,2,5
Gaines,7 - Seagraves,"Justice, Supreme Court, Place 2",,Jimmy Blacklock,REP,35,3,59,97
Gaines,7 - Seagraves,"Justice, Supreme Court, Place 2",,Steven Kirkland,DEM,47,0,26,73
Gaines,7 - Seagraves,"Justice, Supreme Court, Place 4",,John Devine,REP,36,3,58,97
Gaines,7 - Seagraves,"Justice, Supreme Court, Place 4",,R.K. Sandill,DEM,46,0,26,72
Gaines,7 - Seagraves,"Justice, Supreme Court, Place 6",,Jeff Brown,REP,36,3,59,98
Gaines,7 - Seagraves,"Justice, Supreme Court, Place 6",,Kathy Cheng,DEM,46,0,26,72
Gaines,7 - Seagraves,"Presiding Judge, Court of Criminal Appeals",,Sharon Keller,REP,35,3,56,94
Gaines,7 - Seagraves,"Presiding Judge, Court of Criminal Appeals",,Maria T. (Terri) Jackson,DEM,47,0,26,73
Gaines,7 - Seagraves,"Presiding Judge, Court of Criminal Appeals",,William Bryan Strange III,LIB,0,0,2,2
Gaines,7 - Seagraves,"Judge, Court of Criminal Appeals, Place 7",,Barbara Parker Hervey,REP,35,3,60,98
Gaines,7 - Seagraves,"Judge, Court of Criminal Appeals, Place 7",,Ramona Franklin,DEM,47,0,25,72
Gaines,7 - Seagraves,"Judge, Court of Criminal Appeals, Place 8",,Michelle Slaughter,REP,42,3,60,105
Gaines,7 - Seagraves,"Judge, Court of Criminal Appeals, Place 8",,Mark Ash,LIB,16,0,14,30
Gaines,7 - Seagraves,State Senate,31,Kel Seliger,REP,40,3,64,107
Gaines,7 - Seagraves,State Senate,31,Jack B. Westbrook,LIB,18,0,13,31
Gaines,7 - Seagraves,State Representative,83,Dustin Burrows,REP,35,3,58,96
Gaines,7 - Seagraves,State Representative,83,Drew Landry,DEM,47,0,29,76
Gaines,7 - Seagraves,"Chief Justice, 11th Court of Appeals District",,John Bailey,REP,48,3,65,116
Gaines,7 - Seagraves,"District Judge, 106th Judicial District",,Reed Filley,REP,47,3,64,114
Gaines,8,Straight Party,,Republican Party REP,REP,32,2,98,132
Gaines,8,Straight Party,,Democratic Party DEM,DEM,1,0,9,10
Gaines,8,Straight Party,,Libertarian Party LIB,LIB,0,0,0,0
Gaines,8,U.S. Senate,,Ted Cruz,REP,37,4,112,153
Gaines,8,U.S. Senate,,Beto O'Rourke,DEM,3,0,9,12
Gaines,8,U.S. Senate,,Neal M. Dikeman,LIB,0,0,0,0
Gaines,8,U.S. House,19,Jodey Arrington,REP,38,4,112,154
Gaines,8,U.S. House,19,Miguel Levario,DEM,2,0,9,11
Gaines,8,Governor,,Greg Abbott,REP,38,4,111,153
Gaines,8,Governor,,Lupe Valdez,DEM,2,0,9,11
Gaines,8,Governor,,Mark Jay Tippetts,LIB,0,0,1,1
Gaines,8,Lieutenant Governor,,Dan Patrick,REP,36,4,109,149
Gaines,8,Lieutenant Governor,,Mike Collier,DEM,3,0,11,14
Gaines,8,Lieutenant Governor,,Kerry Douglas McKennon,LIB,0,0,1,1
Gaines,8,Attorney General,,Ken Paxton,REP,37,4,110,151
Gaines,8,Attorney General,,Justin Nelson,DEM,1,0,10,11
Gaines,8,Attorney General,,Michael Ray Harris,LIB,1,0,0,1
Gaines,8,Comptroller of Public Accounts,,Glenn Hegar,REP,38,4,111,153
Gaines,8,Comptroller of Public Accounts,,Joi Chevalier,DEM,1,0,9,10
Gaines,8,Comptroller of Public Accounts,,Ben Sanders,LIB,1,0,1,2
Gaines,8,Commissioner of the General Land Office,,George P. Bush,REP,36,4,106,146
Gaines,8,Commissioner of the General Land Office,,Miguel Suazo,DEM,2,0,9,11
Gaines,8,Commissioner of the General Land Office,,Matt PiÒa,LIB,0,0,2,2
Gaines,8,Commissioner of Agriculture,,Sid Miller,REP,38,4,112,154
Gaines,8,Commissioner of Agriculture,,Kim Olson,DEM,1,0,8,9
Gaines,8,Commissioner of Agriculture,,Richard Carpenter,LIB,1,0,1,2
Gaines,8,Railroad Commissioner,,Christi Craddick,REP,38,4,112,154
Gaines,8,Railroad Commissioner,,Roman McAllen,DEM,1,0,9,10
Gaines,8,Railroad Commissioner,,Mike Wright,LIB,1,0,0,1
Gaines,8,"Justice, Supreme Court, Place 2",,Jimmy Blacklock,REP,38,4,111,153
Gaines,8,"Justice, Supreme Court, Place 2",,Steven Kirkland,DEM,2,0,9,11
Gaines,8,"Justice, Supreme Court, Place 4",,John Devine,REP,38,4,112,154
Gaines,8,"Justice, Supreme Court, Place 4",,R.K. Sandill,DEM,1,0,9,10
Gaines,8,"Justice, Supreme Court, Place 6",,Jeff Brown,REP,38,4,112,154
Gaines,8,"Justice, Supreme Court, Place 6",,Kathy Cheng,DEM,1,0,9,10
Gaines,8,"Presiding Judge, Court of Criminal Appeals",,Sharon Keller,REP,38,4,111,153
Gaines,8,"Presiding Judge, Court of Criminal Appeals",,Maria T. (Terri) Jackson,DEM,1,0,9,10
Gaines,8,"Presiding Judge, Court of Criminal Appeals",,William Bryan Strange III,LIB,0,0,1,1
Gaines,8,"Judge, Court of Criminal Appeals, Place 7",,Barbara Parker Hervey,REP,38,4,112,154
Gaines,8,"Judge, Court of Criminal Appeals, Place 7",,Ramona Franklin,DEM,1,0,9,10
Gaines,8,"Judge, Court of Criminal Appeals, Place 8",,Michelle Slaughter,REP,38,4,112,154
Gaines,8,"Judge, Court of Criminal Appeals, Place 8",,Mark Ash,LIB,0,0,5,5
Gaines,8,State Senate,31,Kel Seliger,REP,36,4,112,152
Gaines,8,State Senate,31,Jack B. Westbrook,LIB,1,0,5,6
Gaines,8,State Representative,83,Dustin Burrows,REP,38,4,113,155
Gaines,8,State Representative,83,Drew Landry,DEM,2,0,8,10
Gaines,8,"Chief Justice, 11th Court of Appeals District",,John Bailey,REP,38,4,114,156
Gaines,8,"District Judge, 106th Judicial District",,Reed Filley,REP,38,4,114,156
Gaines,8 - Seagraves,Straight Party,,Republican Party REP,REP,37,7,103,147
Gaines,8 - Seagraves,Straight Party,,Democratic Party DEM,DEM,21,1,21,43
Gaines,8 - Seagraves,Straight Party,,Libertarian Party LIB,LIB,1,0,0,1
Gaines,8 - Seagraves,U.S. Senate,,Ted Cruz,REP,57,12,154,223
Gaines,8 - Seagraves,U.S. Senate,,Beto O'Rourke,DEM,29,2,29,60
Gaines,8 - Seagraves,U.S. Senate,,Neal M. Dikeman,LIB,0,1,0,1
Gaines,8 - Seagraves,U.S. House,19,Jodey Arrington,REP,61,12,159,232
Gaines,8 - Seagraves,U.S. House,19,Miguel Levario,DEM,25,2,26,53
Gaines,8 - Seagraves,Governor,,Greg Abbott,REP,56,13,155,224
Gaines,8 - Seagraves,Governor,,Lupe Valdez,DEM,28,2,26,56
Gaines,8 - Seagraves,Governor,,Mark Jay Tippetts,LIB,1,0,1,2
Gaines,8 - Seagraves,Lieutenant Governor,,Dan Patrick,REP,48,13,137,198
Gaines,8 - Seagraves,Lieutenant Governor,,Mike Collier,DEM,34,2,44,80
Gaines,8 - Seagraves,Lieutenant Governor,,Kerry Douglas McKennon,LIB,2,0,2,4
Gaines,8 - Seagraves,Attorney General,,Ken Paxton,REP,57,12,144,213
Gaines,8 - Seagraves,Attorney General,,Justin Nelson,DEM,27,3,38,68
Gaines,8 - Seagraves,Attorney General,,Michael Ray Harris,LIB,1,0,1,2
Gaines,8 - Seagraves,Comptroller of Public Accounts,,Glenn Hegar,REP,55,11,153,219
Gaines,8 - Seagraves,Comptroller of Public Accounts,,Joi Chevalier,DEM,24,2,26,52
Gaines,8 - Seagraves,Comptroller of Public Accounts,,Ben Sanders,LIB,4,2,3,9
Gaines,8 - Seagraves,Commissioner of the General Land Office,,George P. Bush,REP,56,13,154,223
Gaines,8 - Seagraves,Commissioner of the General Land Office,,Miguel Suazo,DEM,25,2,26,53
Gaines,8 - Seagraves,Commissioner of the General Land Office,,Matt PiÒa,LIB,2,0,4,6
Gaines,8 - Seagraves,Commissioner of Agriculture,,Sid Miller,REP,57,12,156,225
Gaines,8 - Seagraves,Commissioner of Agriculture,,Kim Olson,DEM,26,2,28,56
Gaines,8 - Seagraves,Commissioner of Agriculture,,Richard Carpenter,LIB,2,1,1,4
Gaines,8 - Seagraves,Railroad Commissioner,,Christi Craddick,REP,57,11,156,224
Gaines,8 - Seagraves,Railroad Commissioner,,Roman McAllen,DEM,26,2,25,53
Gaines,8 - Seagraves,Railroad Commissioner,,Mike Wright,LIB,1,2,2,5
Gaines,8 - Seagraves,"Justice, Supreme Court, Place 2",,Jimmy Blacklock,REP,57,11,155,223
Gaines,8 - Seagraves,"Justice, Supreme Court, Place 2",,Steven Kirkland,DEM,26,3,29,58
Gaines,8 - Seagraves,"Justice, Supreme Court, Place 4",,John Devine,REP,57,12,158,227
Gaines,8 - Seagraves,"Justice, Supreme Court, Place 4",,R.K. Sandill,DEM,26,2,25,53
Gaines,8 - Seagraves,"Justice, Supreme Court, Place 6",,Jeff Brown,REP,57,12,155,224
Gaines,8 - Seagraves,"Justice, Supreme Court, Place 6",,Kathy Cheng,DEM,25,2,28,55
Gaines,8 - Seagraves,"Presiding Judge, Court of Criminal Appeals",,Sharon Keller,REP,55,11,156,222
Gaines,8 - Seagraves,"Presiding Judge, Court of Criminal Appeals",,Maria T. (Terri) Jackson,DEM,27,2,26,55
Gaines,8 - Seagraves,"Presiding Judge, Court of Criminal Appeals",,William Bryan Strange III,LIB,1,1,1,3
Gaines,8 - Seagraves,"Judge, Court of Criminal Appeals, Place 7",,Barbara Parker Hervey,REP,56,11,154,221
Gaines,8 - Seagraves,"Judge, Court of Criminal Appeals, Place 7",,Ramona Franklin,DEM,27,3,29,59
Gaines,8 - Seagraves,"Judge, Court of Criminal Appeals, Place 8",,Michelle Slaughter,REP,60,12,164,236
Gaines,8 - Seagraves,"Judge, Court of Criminal Appeals, Place 8",,Mark Ash,LIB,13,2,10,25
Gaines,8 - Seagraves,State Senate,31,Kel Seliger,REP,66,12,162,240
Gaines,8 - Seagraves,State Senate,31,Jack B. Westbrook,LIB,13,2,12,27
Gaines,8 - Seagraves,State Representative,83,Dustin Burrows,REP,57,11,151,219
Gaines,8 - Seagraves,State Representative,83,Drew Landry,DEM,29,3,33,65
Gaines,8 - Seagraves,"Chief Justice, 11th Court of Appeals District",,John Bailey,REP,72,10,164,246
Gaines,8 - Seagraves,"District Judge, 106th Judicial District",,Reed Filley,REP,72,10,163,245
Gaines,8 - Loop,Straight Party,,Republican Party REP,REP,0,0,1,1
Gaines,8 - Loop,Straight Party,,Democratic Party DEM,DEM,0,0,0,0
Gaines,8 - Loop,Straight Party,,Libertarian Party LIB,LIB,0,0,0,0
Gaines,8 - Loop,U.S. Senate,,Ted Cruz,REP,0,0,1,1
Gaines,8 - Loop,U.S. Senate,,Beto O'Rourke,DEM,0,0,0,0
Gaines,8 - Loop,U.S. Senate,,Neal M. Dikeman,LIB,0,0,0,0
Gaines,8 - Loop,U.S. House,19,Jodey Arrington,REP,0,0,1,1
Gaines,8 - Loop,U.S. House,19,Miguel Levario,DEM,0,0,0,0
Gaines,8 - Loop,Governor,,Greg Abbott,REP,0,0,1,1
Gaines,8 - Loop,Governor,,Lupe Valdez,DEM,0,0,0,0
Gaines,8 - Loop,Governor,,Mark Jay Tippetts,LIB,0,0,0,0
Gaines,8 - Loop,Lieutenant Governor,,Dan Patrick,REP,0,0,1,1
Gaines,8 - Loop,Lieutenant Governor,,Mike Collier,DEM,0,0,0,0
Gaines,8 - Loop,Lieutenant Governor,,Kerry Douglas McKennon,LIB,0,0,0,0
Gaines,8 - Loop,Attorney General,,Ken Paxton,REP,0,0,1,1
Gaines,8 - Loop,Attorney General,,Justin Nelson,DEM,0,0,0,0
Gaines,8 - Loop,Attorney General,,Michael Ray Harris,LIB,0,0,0,0
Gaines,8 - Loop,Comptroller of Public Accounts,,Glenn Hegar,REP,0,0,1,1
Gaines,8 - Loop,Comptroller of Public Accounts,,Joi Chevalier,DEM,0,0,0,0
Gaines,8 - Loop,Comptroller of Public Accounts,,Ben Sanders,LIB,0,0,0,0
Gaines,8 - Loop,Commissioner of the General Land Office,,George P. Bush,REP,0,0,1,1
Gaines,8 - Loop,Commissioner of the General Land Office,,Miguel Suazo,DEM,0,0,0,0
Gaines,8 - Loop,Commissioner of the General Land Office,,Matt PiÒa,LIB,0,0,0,0
Gaines,8 - Loop,Commissioner of Agriculture,,Sid Miller,REP,0,0,1,1
Gaines,8 - Loop,Commissioner of Agriculture,,Kim Olson,DEM,0,0,0,0
Gaines,8 - Loop,Commissioner of Agriculture,,Richard Carpenter,LIB,0,0,0,0
Gaines,8 - Loop,Railroad Commissioner,,Christi Craddick,REP,0,0,1,1
Gaines,8 - Loop,Railroad Commissioner,,Roman McAllen,DEM,0,0,0,0
Gaines,8 - Loop,Railroad Commissioner,,Mike Wright,LIB,0,0,0,0
Gaines,8 - Loop,"Justice, Supreme Court, Place 2",,Jimmy Blacklock,REP,0,0,1,1
Gaines,8 - Loop,"Justice, Supreme Court, Place 2",,Steven Kirkland,DEM,0,0,0,0
Gaines,8 - Loop,"Justice, Supreme Court, Place 4",,John Devine,REP,0,0,1,1
Gaines,8 - Loop,"Justice, Supreme Court, Place 4",,R.K. Sandill,DEM,0,0,0,0
Gaines,8 - Loop,"Justice, Supreme Court, Place 6",,Jeff Brown,REP,0,0,1,1
Gaines,8 - Loop,"Justice, Supreme Court, Place 6",,Kathy Cheng,DEM,0,0,0,0
Gaines,8 - Loop,"Presiding Judge, Court of Criminal Appeals",,Sharon Keller,REP,0,0,1,1
Gaines,8 - Loop,"Presiding Judge, Court of Criminal Appeals",,Maria T. (Terri) Jackson,DEM,0,0,0,0
Gaines,8 - Loop,"Presiding Judge, Court of Criminal Appeals",,William Bryan Strange III,LIB,0,0,0,0
Gaines,8 - Loop,"Judge, Court of Criminal Appeals, Place 7",,Barbara Parker Hervey,REP,0,0,1,1
Gaines,8 - Loop,"Judge, Court of Criminal Appeals, Place 7",,Ramona Franklin,DEM,0,0,0,0
Gaines,8 - Loop,"Judge, Court of Criminal Appeals, Place 8",,Michelle Slaughter,REP,0,0,1,1
Gaines,8 - Loop,"Judge, Court of Criminal Appeals, Place 8",,Mark Ash,LIB,0,0,0,0
Gaines,8 - Loop,State Senate,31,Kel Seliger,REP,0,0,1,1
Gaines,8 - Loop,State Senate,31,Jack B. Westbrook,LIB,0,0,0,0
Gaines,8 - Loop,State Representative,83,Dustin Burrows,REP,0,0,1,1
Gaines,8 - Loop,State Representative,83,Drew Landry,DEM,0,0,0,0
Gaines,8 - Loop,"Chief Justice, 11th Court of Appeals District",,John Bailey,REP,0,0,1,1
Gaines,8 - Loop,"District Judge, 106th Judicial District",,Reed Filley,REP,0,0,1,1
Gaines,9,Straight Party,,Republican Party REP,REP,52,3,122,177
Gaines,9,Straight Party,,Democratic Party DEM,DEM,2,0,6,8
Gaines,9,Straight Party,,Libertarian Party LIB,LIB,0,0,0,0
Gaines,9,U.S. Senate,,Ted Cruz,REP,56,3,141,200
Gaines,9,U.S. Senate,,Beto O'Rourke,DEM,3,0,10,13
Gaines,9,U.S. Senate,,Neal M. Dikeman,LIB,0,0,0,0
Gaines,9,U.S. House,19,Jodey Arrington,REP,55,3,140,198
Gaines,9,U.S. House,19,Miguel Levario,DEM,4,0,10,14
Gaines,9,Governor,,Greg Abbott,REP,56,3,139,198
Gaines,9,Governor,,Lupe Valdez,DEM,3,0,10,13
Gaines,9,Governor,,Mark Jay Tippetts,LIB,0,0,2,2
Gaines,9,Lieutenant Governor,,Dan Patrick,REP,55,3,136,194
Gaines,9,Lieutenant Governor,,Mike Collier,DEM,4,0,11,15
Gaines,9,Lieutenant Governor,,Kerry Douglas McKennon,LIB,0,0,3,3
Gaines,9,Attorney General,,Ken Paxton,REP,56,3,140,199
Gaines,9,Attorney General,,Justin Nelson,DEM,3,0,10,13
Gaines,9,Attorney General,,Michael Ray Harris,LIB,0,0,1,1
Gaines,9,Comptroller of Public Accounts,,Glenn Hegar,REP,55,3,137,195
Gaines,9,Comptroller of Public Accounts,,Joi Chevalier,DEM,4,0,11,15
Gaines,9,Comptroller of Public Accounts,,Ben Sanders,LIB,0,0,2,2
Gaines,9,Commissioner of the General Land Office,,George P. Bush,REP,55,3,131,189
Gaines,9,Commissioner of the General Land Office,,Miguel Suazo,DEM,4,0,10,14
Gaines,9,Commissioner of the General Land Office,,Matt PiÒa,LIB,0,0,8,8
Gaines,9,Commissioner of Agriculture,,Sid Miller,REP,56,3,138,197
Gaines,9,Commissioner of Agriculture,,Kim Olson,DEM,2,0,11,13
Gaines,9,Commissioner of Agriculture,,Richard Carpenter,LIB,1,0,1,2
Gaines,9,Railroad Commissioner,,Christi Craddick,REP,56,3,138,197
Gaines,9,Railroad Commissioner,,Roman McAllen,DEM,3,0,11,14
Gaines,9,Railroad Commissioner,,Mike Wright,LIB,0,0,1,1
Gaines,9,"Justice, Supreme Court, Place 2",,Jimmy Blacklock,REP,56,3,139,198
Gaines,9,"Justice, Supreme Court, Place 2",,Steven Kirkland,DEM,3,0,11,14
Gaines,9,"Justice, Supreme Court, Place 4",,John Devine,REP,56,3,139,198
Gaines,9,"Justice, Supreme Court, Place 4",,R.K. Sandill,DEM,3,0,11,14
Gaines,9,"Justice, Supreme Court, Place 6",,Jeff Brown,REP,56,3,139,198
Gaines,9,"Justice, Supreme Court, Place 6",,Kathy Cheng,DEM,3,0,11,14
Gaines,9,"Presiding Judge, Court of Criminal Appeals",,Sharon Keller,REP,55,3,137,195
Gaines,9,"Presiding Judge, Court of Criminal Appeals",,Maria T. (Terri) Jackson,DEM,4,0,11,15
Gaines,9,"Presiding Judge, Court of Criminal Appeals",,William Bryan Strange III,LIB,0,0,2,2
Gaines,9,"Judge, Court of Criminal Appeals, Place 7",,Barbara Parker Hervey,REP,56,3,139,198
Gaines,9,"Judge, Court of Criminal Appeals, Place 7",,Ramona Franklin,DEM,3,0,11,14
Gaines,9,"Judge, Court of Criminal Appeals, Place 8",,Michelle Slaughter,REP,56,3,140,199
Gaines,9,"Judge, Court of Criminal Appeals, Place 8",,Mark Ash,LIB,3,0,7,10
Gaines,9,State Senate,31,Kel Seliger,REP,56,3,138,197
Gaines,9,State Senate,31,Jack B. Westbrook,LIB,3,0,9,12
Gaines,9,State Representative,83,Dustin Burrows,REP,56,3,138,197
Gaines,9,State Representative,83,Drew Landry,DEM,3,0,11,14
Gaines,9,"Chief Justice, 11th Court of Appeals District",,John Bailey,REP,57,3,144,204
Gaines,9,"District Judge, 106th Judicial District",,Reed Filley,REP,57,3,144,204
Gaines,9 - Seminole,Straight Party,,Republican Party REP,REP,23,7,39,69
Gaines,9 - Seminole,Straight Party,,Democratic Party DEM,DEM,4,2,6,12
Gaines,9 - Seminole,Straight Party,,Libertarian Party LIB,LIB,0,0,0,0
Gaines,9 - Seminole,U.S. Senate,,Ted Cruz,REP,22,9,44,75
Gaines,9 - Seminole,U.S. Senate,,Beto O'Rourke,DEM,5,3,8,16
Gaines,9 - Seminole,U.S. Senate,,Neal M. Dikeman,LIB,1,0,0,1
Gaines,9 - Seminole,U.S. House,19,Jodey Arrington,REP,24,9,45,78
Gaines,9 - Seminole,U.S. House,19,Miguel Levario,DEM,4,3,7,14
Gaines,9 - Seminole,Governor,,Greg Abbott,REP,23,9,45,77
Gaines,9 - Seminole,Governor,,Lupe Valdez,DEM,5,3,7,15
Gaines,9 - Seminole,Governor,,Mark Jay Tippetts,LIB,0,0,0,0
Gaines,9 - Seminole,Lieutenant Governor,,Dan Patrick,REP,21,9,45,75
Gaines,9 - Seminole,Lieutenant Governor,,Mike Collier,DEM,7,3,7,17
Gaines,9 - Seminole,Lieutenant Governor,,Kerry Douglas McKennon,LIB,0,0,0,0
Gaines,9 - Seminole,Attorney General,,Ken Paxton,REP,21,9,44,74
Gaines,9 - Seminole,Attorney General,,Justin Nelson,DEM,6,3,8,17
Gaines,9 - Seminole,Attorney General,,Michael Ray Harris,LIB,1,0,0,1
Gaines,9 - Seminole,Comptroller of Public Accounts,,Glenn Hegar,REP,24,9,45,78
Gaines,9 - Seminole,Comptroller of Public Accounts,,Joi Chevalier,DEM,4,3,7,14
Gaines,9 - Seminole,Comptroller of Public Accounts,,Ben Sanders,LIB,0,0,0,0
Gaines,9 - Seminole,Commissioner of the General Land Office,,George P. Bush,REP,24,9,44,77
Gaines,9 - Seminole,Commissioner of the General Land Office,,Miguel Suazo,DEM,4,3,7,14
Gaines,9 - Seminole,Commissioner of the General Land Office,,Matt PiÒa,LIB,0,0,0,0
Gaines,9 - Seminole,Commissioner of Agriculture,,Sid Miller,REP,24,9,42,75
Gaines,9 - Seminole,Commissioner of Agriculture,,Kim Olson,DEM,4,3,9,16
Gaines,9 - Seminole,Commissioner of Agriculture,,Richard Carpenter,LIB,0,0,0,0
Gaines,9 - Seminole,Railroad Commissioner,,Christi Craddick,REP,24,9,44,77
Gaines,9 - Seminole,Railroad Commissioner,,Roman McAllen,DEM,4,3,7,14
Gaines,9 - Seminole,Railroad Commissioner,,Mike Wright,LIB,0,0,0,0
Gaines,9 - Seminole,"Justice, Supreme Court, Place 2",,Jimmy Blacklock,REP,24,9,44,77
Gaines,9 - Seminole,"Justice, Supreme Court, Place 2",,Steven Kirkland,DEM,4,3,7,14
Gaines,9 - Seminole,"Justice, Supreme Court, Place 4",,John Devine,REP,24,9,43,76
Gaines,9 - Seminole,"Justice, Supreme Court, Place 4",,R.K. Sandill,DEM,4,3,8,15
Gaines,9 - Seminole,"Justice, Supreme Court, Place 6",,Jeff Brown,REP,24,9,43,76
Gaines,9 - Seminole,"Justice, Supreme Court, Place 6",,Kathy Cheng,DEM,4,3,8,15
Gaines,9 - Seminole,"Presiding Judge, Court of Criminal Appeals",,Sharon Keller,REP,24,9,44,77
Gaines,9 - Seminole,"Presiding Judge, Court of Criminal Appeals",,Maria T. (Terri) Jackson,DEM,4,3,7,14
Gaines,9 - Seminole,"Presiding Judge, Court of Criminal Appeals",,William Bryan Strange III,LIB,0,0,0,0
Gaines,9 - Seminole,"Judge, Court of Criminal Appeals, Place 7",,Barbara Parker Hervey,REP,24,9,44,77
Gaines,9 - Seminole,"Judge, Court of Criminal Appeals, Place 7",,Ramona Franklin,DEM,4,3,7,14
Gaines,9 - Seminole,"Judge, Court of Criminal Appeals, Place 8",,Michelle Slaughter,REP,24,9,45,78
Gaines,9 - Seminole,"Judge, Court of Criminal Appeals, Place 8",,Mark Ash,LIB,2,1,5,8
Gaines,9 - Seminole,State Senate,31,Kel Seliger,REP,25,9,47,81
Gaines,9 - Seminole,State Senate,31,Jack B. Westbrook,LIB,1,1,4,6
Gaines,9 - Seminole,State Representative,83,Dustin Burrows,REP,24,9,43,76
Gaines,9 - Seminole,State Representative,83,Drew Landry,DEM,4,3,9,16
Gaines,9 - Seminole,"Chief Justice, 11th Court of Appeals District",,John Bailey,REP,25,9,47,81
Gaines,9 - Seminole,"District Judge, 106th Judicial District",,Reed Filley,REP,25,9,48,82
